CD_GEOCODI,Sum - ATACADO_MIC,Sum - ATACADO_PEQ,Sum - ATACADO_MED,Sum - ATACADO_GDE,ATACADO,Sum - VAREJO_MIC,Sum - VAREJO_PEQ,Sum - VAREJO_MED,Sum - VAREJO_GDE,VAREJO,Sum - ENSINO_MIC,Sum - ENSINO_PEQ,Sum - ENSINO_MED,Sum - ENSINO_GDE,ENSINO,Sum - FINANC_MIC,Sum - FINANC_PEQ,Sum - FINANC_MED,Sum - FINANC_GDE,FINANC,Sum - SAUDE_MIC,Sum - SAUDE_PEQ,Sum - SAUDE_MED,Sum - SAUDE_GDE,SAUDE,Sum - TRANSP_MIC,Sum - TRANSP_PEQ,Sum - TRANSP_MED,Sum - TRANSP_GDE,TRANSP
355030801000118,141,30,4,0,175,605,98,9,2,714,18,15,3,0,36,32,5,0,0,37,65,2,0,0,67,57,17,4,0,78
355030802000016,29,13,4,2,48,306,83,6,5,400,35,23,3,4,65,35,19,1,1,56,103,4,2,1,110,48,13,2,1,64
355030802000030,29,13,4,2,48,306,83,6,5,400,35,23,3,4,65,35,19,1,1,56,103,4,2,1,110,48,13,2,1,64
355030802000037,29,13,4,2,48,306,83,6,5,400,35,23,3,4,65,35,19,1,1,56,103,4,2,1,110,48,13,2,1,64
355030802000039,29,13,4,2,48,306,83,6,5,400,35,23,3,4,65,35,19,1,1,56,103,4,2,1,110,48,13,2,1,64
355030802000043,232,104,32,16,384,2448,664,48,40,3200,280,184,24,32,520,280,152,8,8,448,824,32,16,8,880,384,104,16,8,512
355030802000059,29,13,4,2,48,306,83,6,5,400,35,23,3,4,65,35,19,1,1,56,103,4,2,1,110,48,13,2,1,64
355030802000060,29,13,4,2,48,306,83,6,5,400,35,23,3,4,65,35,19,1,1,56,103,4,2,1,110,48,13,2,1,64
355030803000017,11,3,1,0,15,101,13,2,2,118,5,6,0,0,11,0,0,0,0,0,12,1,0,0,13,44,5,2,6,57
355030803000050,11,3,1,0,15,101,13,2,2,118,5,6,0,0,11,0,0,0,0,0,12,1,0,0,13,44,5,2,6,57
355030804000072,91,28,0,6,125,502,93,4,3,602,26,9,2,1,38,14,10,0,0,24,30,1,0,0,31,43,6,0,0,49
355030805000012,19,2,0,0,21,200,31,0,0,231,7,7,0,1,15,5,0,0,0,5,16,3,0,0,19,17,4,0,1,22
355030805000081,4,0,0,0,4,122,20,0,2,144,10,5,0,0,15,3,1,0,0,4,26,1,0,0,27,15,0,0,0,15
355030806000001,174,92,32,18,316,928,250,42,34,1254,40,38,16,12,106,84,68,4,6,162,184,16,2,8,210,212,78,18,10,318
355030806000002,87,46,16,9,158,464,125,21,17,627,20,19,8,6,53,42,34,2,3,81,92,8,1,4,105,106,39,9,5,159
355030806000003,783,414,144,81,1422,4176,1125,189,153,5643,180,171,72,54,477,378,306,18,27,729,828,72,9,36,945,954,351,81,45,1431
355030806000004,435,230,80,45,790,2320,625,105,85,3135,100,95,40,30,265,210,170,10,15,405,460,40,5,20,525,530,195,45,25,795
355030806000005,87,46,16,9,158,464,125,21,17,627,20,19,8,6,53,42,34,2,3,81,92,8,1,4,105,106,39,9,5,159
355030806000015,174,92,32,18,316,928,250,42,34,1254,40,38,16,12,106,84,68,4,6,162,184,16,2,8,210,212,78,18,10,318
355030806000018,957,506,176,99,1738,5104,1375,231,187,6897,220,209,88,66,583,462,374,22,33,891,1012,88,11,44,1155,1166,429,99,55,1749
355030806000020,87,46,16,9,158,464,125,21,17,627,20,19,8,6,53,42,34,2,3,81,92,8,1,4,105,106,39,9,5,159
355030806000026,87,46,16,9,158,464,125,21,17,627,20,19,8,6,53,42,34,2,3,81,92,8,1,4,105,106,39,9,5,159
355030807000002,159,42,15,15,231,1191,312,15,6,1524,72,57,6,12,147,99,69,12,12,192,1179,87,15,54,1335,342,78,15,15,450
355030807000012,318,84,30,30,462,2382,624,30,12,3048,144,114,12,24,294,198,138,24,24,384,2358,174,30,108,2670,684,156,30,30,900
355030807000013,56,22,2,2,82,346,69,4,1,420,19,15,3,6,43,37,22,4,15,78,276,13,5,4,298,96,22,4,2,124
355030807000014,106,28,10,10,154,794,208,10,4,1016,48,38,4,8,98,66,46,8,8,128,786,58,10,36,890,228,52,10,10,300
355030807000015,212,56,20,20,308,1588,416,20,8,2032,96,76,8,16,196,132,92,16,16,256,1572,116,20,72,1780,456,104,20,20,600
355030807000033,56,22,2,2,82,346,69,4,1,420,19,15,3,6,43,37,22,4,15,78,276,13,5,4,298,96,22,4,2,124
355030807000036,159,42,15,15,231,1191,312,15,6,1524,72,57,6,12,147,99,69,12,12,192,1179,87,15,54,1335,342,78,15,15,450
355030807000038,53,14,5,5,77,397,104,5,2,508,24,19,2,4,49,33,23,4,4,64,393,29,5,18,445,114,26,5,5,150
355030807000042,106,28,10,10,154,794,208,10,4,1016,48,38,4,8,98,66,46,8,8,128,786,58,10,36,890,228,52,10,10,300
355030807000047,53,14,5,5,77,397,104,5,2,508,24,19,2,4,49,33,23,4,4,64,393,29,5,18,445,114,26,5,5,150
355030807000049,53,14,5,5,77,397,104,5,2,508,24,19,2,4,49,33,23,4,4,64,393,29,5,18,445,114,26,5,5,150
355030807000055,318,84,30,30,462,2382,624,30,12,3048,144,114,12,24,294,198,138,24,24,384,2358,174,30,108,2670,684,156,30,30,900
355030807000067,56,22,2,2,82,346,69,4,1,420,19,15,3,6,43,37,22,4,15,78,276,13,5,4,298,96,22,4,2,124
355030807000068,112,44,4,4,164,692,138,8,2,840,38,30,6,12,86,74,44,8,30,156,552,26,10,8,596,192,44,8,4,248
355030807000069,56,22,2,2,82,346,69,4,1,420,19,15,3,6,43,37,22,4,15,78,276,13,5,4,298,96,22,4,2,124
355030807000070,106,28,10,10,154,794,208,10,4,1016,48,38,4,8,98,66,46,8,8,128,786,58,10,36,890,228,52,10,10,300
355030807000072,53,14,5,5,77,397,104,5,2,508,24,19,2,4,49,33,23,4,4,64,393,29,5,18,445,114,26,5,5,150
355030807000077,212,56,20,20,308,1588,416,20,8,2032,96,76,8,16,196,132,92,16,16,256,1572,116,20,72,1780,456,104,20,20,600
355030807000078,336,132,12,12,492,2076,414,24,6,2520,114,90,18,36,258,222,132,24,90,468,1656,78,30,24,1788,576,132,24,12,744
355030807000080,112,44,4,4,164,692,138,8,2,840,38,30,6,12,86,74,44,8,30,156,552,26,10,8,596,192,44,8,4,248
355030807000089,448,176,16,16,656,2768,552,32,8,3360,152,120,24,48,344,296,176,32,120,624,2208,104,40,32,2384,768,176,32,16,992
355030807000093,159,42,15,15,231,1191,312,15,6,1524,72,57,6,12,147,99,69,12,12,192,1179,87,15,54,1335,342,78,15,15,450
355030807000097,56,22,2,2,82,346,69,4,1,420,19,15,3,6,43,37,22,4,15,78,276,13,5,4,298,96,22,4,2,124
355030807000098,105,25,15,5,150,805,140,5,10,960,50,35,5,0,90,125,70,10,30,235,1460,80,20,20,1580,195,40,20,10,265
355030807000111,21,5,3,1,30,161,28,1,2,192,10,7,1,0,18,25,14,2,6,47,292,16,4,4,316,39,8,4,2,53
355030807000119,53,14,5,5,77,397,104,5,2,508,24,19,2,4,49,33,23,4,4,64,393,29,5,18,445,114,26,5,5,150
355030807000129,273,65,39,13,390,2093,364,13,26,2496,130,91,13,0,234,325,182,26,78,611,3796,208,52,52,4108,507,104,52,26,689
355030808000018,236,56,11,1,304,720,110,8,2,840,18,10,9,2,39,25,17,0,1,43,106,5,1,5,117,100,16,3,2,121
355030808000021,1180,280,55,5,1520,3600,550,40,10,4200,90,50,45,10,195,125,85,0,5,215,530,25,5,25,585,500,80,15,10,605
355030808000031,236,56,11,1,304,720,110,8,2,840,18,10,9,2,39,25,17,0,1,43,106,5,1,5,117,100,16,3,2,121
355030808000039,236,56,11,1,304,720,110,8,2,840,18,10,9,2,39,25,17,0,1,43,106,5,1,5,117,100,16,3,2,121
355030809000001,1623,348,21,12,2004,2895,438,33,12,3378,72,45,12,9,138,90,66,6,0,162,159,12,6,3,180,363,69,15,3,450
355030809000011,541,116,7,4,668,965,146,11,4,1126,24,15,4,3,46,30,22,2,0,54,53,4,2,1,60,121,23,5,1,150
355030809000012,3787,812,49,28,4676,6755,1022,77,28,7882,168,105,28,21,322,210,154,14,0,378,371,28,14,7,420,847,161,35,7,1050
355030809000018,1082,232,14,8,1336,1930,292,22,8,2252,48,30,8,6,92,60,44,4,0,108,106,8,4,2,120,242,46,10,2,300
355030809000023,1623,348,21,12,2004,2895,438,33,12,3378,72,45,12,9,138,90,66,6,0,162,159,12,6,3,180,363,69,15,3,450
355030809000029,541,116,7,4,668,965,146,11,4,1126,24,15,4,3,46,30,22,2,0,54,53,4,2,1,60,121,23,5,1,150
355030809000036,541,116,7,4,668,965,146,11,4,1126,24,15,4,3,46,30,22,2,0,54,53,4,2,1,60,121,23,5,1,150
355030809000039,541,116,7,4,668,965,146,11,4,1126,24,15,4,3,46,30,22,2,0,54,53,4,2,1,60,121,23,5,1,150
355030810000004,1071,174,20,5,1270,1632,217,13,4,1866,8,1,0,2,11,30,16,2,3,51,25,2,1,1,29,142,14,3,1,160
355030811000221,14,2,0,0,16,194,22,0,0,216,6,26,0,0,32,0,0,0,0,0,4,2,0,0,6,60,0,0,2,62
355030812000019,25,5,2,0,32,241,52,2,2,297,23,17,2,0,42,13,5,1,1,20,24,1,2,1,28,32,1,0,0,33
355030812000020,51,14,1,4,70,401,88,8,5,502,32,23,4,26,85,22,24,4,0,50,37,4,0,2,43,58,16,3,0,77
355030812000025,357,98,7,28,490,2807,616,56,35,3514,224,161,28,182,595,154,168,28,0,350,259,28,0,14,301,406,112,21,0,539
355030812000038,714,196,14,56,980,5614,1232,112,70,7028,448,322,56,364,1190,308,336,56,0,700,518,56,0,28,602,812,224,42,0,1078
355030812000052,153,42,3,12,210,1203,264,24,15,1506,96,69,12,78,255,66,72,12,0,150,111,12,0,6,129,174,48,9,0,231
355030812000053,51,14,1,4,70,401,88,8,5,502,32,23,4,26,85,22,24,4,0,50,37,4,0,2,43,58,16,3,0,77
355030812000104,50,10,4,0,64,482,104,4,4,594,46,34,4,0,84,26,10,2,2,40,48,2,4,2,56,64,2,0,0,66
355030812000130,51,14,1,4,70,401,88,8,5,502,32,23,4,26,85,22,24,4,0,50,37,4,0,2,43,58,16,3,0,77
355030812000135,51,14,1,4,70,401,88,8,5,502,32,23,4,26,85,22,24,4,0,50,37,4,0,2,43,58,16,3,0,77
355030813000078,65,15,0,0,80,1220,240,15,5,1480,50,50,10,0,110,40,25,0,0,65,190,10,0,0,200,245,30,0,0,275
355030814000019,102,34,6,3,145,435,87,3,5,530,19,9,2,1,31,21,11,1,1,34,70,3,1,5,79,73,12,2,3,90
355030814000020,102,34,6,3,145,435,87,3,5,530,19,9,2,1,31,21,11,1,1,34,70,3,1,5,79,73,12,2,3,90
355030814000027,102,34,6,3,145,435,87,3,5,530,19,9,2,1,31,21,11,1,1,34,70,3,1,5,79,73,12,2,3,90
355030815000102,121,29,2,3,155,471,90,10,5,576,48,20,2,1,71,33,18,1,1,53,165,7,3,2,177,149,52,6,17,224
355030815000135,121,29,2,3,155,471,90,10,5,576,48,20,2,1,71,33,18,1,1,53,165,7,3,2,177,149,52,6,17,224
355030816000013,21,2,3,0,26,215,45,1,5,266,15,8,2,2,27,12,2,0,0,14,31,2,0,2,35,38,4,0,1,43
355030816000014,140,50,0,10,200,2690,590,80,50,3410,60,110,20,0,190,100,20,0,0,120,180,0,0,40,220,480,50,0,0,530
355030816000026,21,2,3,0,26,215,45,1,5,266,15,8,2,2,27,12,2,0,0,14,31,2,0,2,35,38,4,0,1,43
355030816000039,492,252,36,96,876,4548,1044,144,84,5820,252,228,12,12,504,156,132,0,0,288,552,36,0,12,600,720,108,60,60,948
355030817000050,18,0,0,0,18,412,36,10,2,460,20,20,2,2,44,2,0,0,2,4,18,0,0,0,18,566,0,0,2,568
355030817000135,11,5,0,0,16,136,15,0,0,151,9,4,2,0,15,2,0,0,0,2,9,0,0,0,9,32,1,1,0,34
355030817000183,18,0,0,0,18,412,36,10,2,460,20,20,2,2,44,2,0,0,2,4,18,0,0,0,18,566,0,0,2,568
355030817000190,39,9,0,0,48,768,147,3,9,927,69,36,9,6,120,18,15,0,0,33,93,0,0,0,93,135,12,0,3,150
355030818000023,10,2,1,1,14,109,11,0,0,120,5,3,1,0,9,4,1,0,0,5,8,0,0,0,8,19,0,1,0,20
355030818000112,10,2,1,1,14,109,11,0,0,120,5,3,1,0,9,4,1,0,0,5,8,0,0,0,8,19,0,1,0,20
355030818000142,24,4,0,0,28,176,30,0,0,206,4,4,0,0,8,2,0,0,0,2,4,0,0,0,4,46,8,0,0,54
355030819000181,30,5,0,0,35,1310,265,25,15,1615,35,65,5,0,105,20,15,0,0,35,95,0,5,0,100,195,10,0,10,215
355030819000299,2,2,0,0,4,154,18,2,0,174,8,4,2,0,14,0,0,0,0,0,4,0,0,0,4,46,6,0,0,52
355030820000011,74,18,1,0,93,422,48,3,5,478,18,11,3,0,32,12,6,0,0,18,33,3,0,0,36,33,7,1,0,41
355030820000094,88,23,1,2,114,416,60,2,2,480,28,19,3,1,51,35,10,1,0,46,42,2,1,0,45,51,11,0,1,63
355030820000100,88,23,1,2,114,416,60,2,2,480,28,19,3,1,51,35,10,1,0,46,42,2,1,0,45,51,11,0,1,63
355030821000018,95,25,5,3,128,385,80,9,6,480,25,11,1,1,38,25,15,0,0,40,36,2,1,0,39,58,19,4,4,85
355030821000032,49,17,0,1,67,324,59,0,1,384,19,11,1,1,32,14,1,0,0,15,29,0,0,0,29,68,10,0,0,78
355030821000059,95,25,5,3,128,385,80,9,6,480,25,11,1,1,38,25,15,0,0,40,36,2,1,0,39,58,19,4,4,85
355030823000007,18,5,0,0,23,193,47,3,4,247,19,11,1,2,33,4,3,0,0,7,24,3,0,0,27,51,7,0,0,58
355030823000045,36,10,0,0,46,386,94,6,8,494,38,22,2,4,66,8,6,0,0,14,48,6,0,0,54,102,14,0,0,116
355030823000062,16,5,0,0,21,221,35,0,1,257,14,18,2,1,35,4,1,0,0,5,24,1,2,2,29,47,4,0,3,54
355030823000111,10,0,0,0,10,126,12,0,1,139,6,4,0,0,10,2,0,0,0,2,4,0,0,0,4,36,1,0,0,37
355030823000169,32,10,0,0,42,442,70,0,2,514,28,36,4,2,70,8,2,0,0,10,48,2,4,4,58,94,8,0,6,108
355030824000005,224,56,42,42,364,3934,1036,140,84,5194,112,42,28,0,182,84,84,0,0,168,56,0,14,0,70,322,42,0,0,364
355030824000057,16,4,3,3,26,281,74,10,6,371,8,3,2,0,13,6,6,0,0,12,4,0,1,0,5,23,3,0,0,26
355030824000082,16,4,3,3,26,281,74,10,6,371,8,3,2,0,13,6,6,0,0,12,4,0,1,0,5,23,3,0,0,26
355030825000001,1,0,0,1,2,52,5,0,0,57,2,3,0,0,5,1,0,0,0,1,1,0,0,0,1,0,0,0,0,0
355030825000066,3,0,0,0,3,93,17,0,0,110,4,6,0,0,10,1,1,0,0,2,3,0,0,0,3,7,0,0,0,7
355030825000246,1,0,0,1,2,52,5,0,0,57,2,3,0,0,5,1,0,0,0,1,1,0,0,0,1,0,0,0,0,0
355030825000247,2,0,0,2,4,104,10,0,0,114,4,6,0,0,10,2,0,0,0,2,2,0,0,0,2,0,0,0,0,0
355030825000281,6,2,0,0,8,132,14,0,0,146,16,14,0,0,30,0,0,0,0,0,6,0,0,2,8,8,0,0,0,8
355030825000286,0,0,0,0,0,74,12,0,0,86,2,0,2,0,4,0,0,0,0,0,0,0,0,0,0,4,2,0,0,6
355030826000007,425,65,35,10,535,1930,375,35,15,2355,170,135,25,30,360,345,140,50,10,545,1115,75,25,30,1245,730,180,30,20,960
355030826000009,135,39,0,3,177,1116,342,18,9,1485,51,33,12,12,108,105,69,0,0,174,1086,33,0,21,1140,225,69,3,3,300
355030826000013,45,13,0,1,59,372,114,6,3,495,17,11,4,4,36,35,23,0,0,58,362,11,0,7,380,75,23,1,1,100
355030826000015,85,13,7,2,107,386,75,7,3,471,34,27,5,6,72,69,28,10,2,109,223,15,5,6,249,146,36,6,4,192
355030826000017,340,52,28,8,428,1544,300,28,12,1884,136,108,20,24,288,276,112,40,8,436,892,60,20,24,996,584,144,24,16,768
355030826000022,45,13,0,1,59,372,114,6,3,495,17,11,4,4,36,35,23,0,0,58,362,11,0,7,380,75,23,1,1,100
355030826000023,45,13,0,1,59,372,114,6,3,495,17,11,4,4,36,35,23,0,0,58,362,11,0,7,380,75,23,1,1,100
355030826000031,45,13,0,1,59,372,114,6,3,495,17,11,4,4,36,35,23,0,0,58,362,11,0,7,380,75,23,1,1,100
355030826000034,170,26,14,4,214,772,150,14,6,942,68,54,10,12,144,138,56,20,4,218,446,30,10,12,498,292,72,12,8,384
355030826000037,510,78,42,12,642,2316,450,42,18,2826,204,162,30,36,432,414,168,60,12,654,1338,90,30,36,1494,876,216,36,24,1152
355030826000039,85,13,7,2,107,386,75,7,3,471,34,27,5,6,72,69,28,10,2,109,223,15,5,6,249,146,36,6,4,192
355030826000050,360,104,0,8,472,2976,912,48,24,3960,136,88,32,32,288,280,184,0,0,464,2896,88,0,56,3040,600,184,8,8,800
355030826000057,225,65,0,5,295,1860,570,30,15,2475,85,55,20,20,180,175,115,0,0,290,1810,55,0,35,1900,375,115,5,5,500
355030826000058,270,78,0,6,354,2232,684,36,18,2970,102,66,24,24,216,210,138,0,0,348,2172,66,0,42,2280,450,138,6,6,600
355030826000066,255,39,21,6,321,1158,225,21,9,1413,102,81,15,18,216,207,84,30,6,327,669,45,15,18,747,438,108,18,12,576
355030826000067,85,13,7,2,107,386,75,7,3,471,34,27,5,6,72,69,28,10,2,109,223,15,5,6,249,146,36,6,4,192
355030826000069,170,26,14,4,214,772,150,14,6,942,68,54,10,12,144,138,56,20,4,218,446,30,10,12,498,292,72,12,8,384
355030826000077,90,26,0,2,118,744,228,12,6,990,34,22,8,8,72,70,46,0,0,116,724,22,0,14,760,150,46,2,2,200
355030826000081,135,39,0,3,177,1116,342,18,9,1485,51,33,12,12,108,105,69,0,0,174,1086,33,0,21,1140,225,69,3,3,300
355030826000083,170,26,14,4,214,772,150,14,6,942,68,54,10,12,144,138,56,20,4,218,446,30,10,12,498,292,72,12,8,384
355030826000084,85,13,7,2,107,386,75,7,3,471,34,27,5,6,72,69,28,10,2,109,223,15,5,6,249,146,36,6,4,192
355030826000086,85,13,7,2,107,386,75,7,3,471,34,27,5,6,72,69,28,10,2,109,223,15,5,6,249,146,36,6,4,192
355030826000087,255,39,21,6,321,1158,225,21,9,1413,102,81,15,18,216,207,84,30,6,327,669,45,15,18,747,438,108,18,12,576
355030826000091,170,26,14,4,214,772,150,14,6,942,68,54,10,12,144,138,56,20,4,218,446,30,10,12,498,292,72,12,8,384
355030826000092,425,65,35,10,535,1930,375,35,15,2355,170,135,25,30,360,345,140,50,10,545,1115,75,25,30,1245,730,180,30,20,960
355030826000098,135,39,0,3,177,1116,342,18,9,1485,51,33,12,12,108,105,69,0,0,174,1086,33,0,21,1140,225,69,3,3,300
355030826000102,85,13,7,2,107,386,75,7,3,471,34,27,5,6,72,69,28,10,2,109,223,15,5,6,249,146,36,6,4,192
355030826000107,170,26,14,4,214,772,150,14,6,942,68,54,10,12,144,138,56,20,4,218,446,30,10,12,498,292,72,12,8,384
355030826000108,680,104,56,16,856,3088,600,56,24,3768,272,216,40,48,576,552,224,80,16,872,1784,120,40,48,1992,1168,288,48,32,1536
355030826000123,255,39,21,6,321,1158,225,21,9,1413,102,81,15,18,216,207,84,30,6,327,669,45,15,18,747,438,108,18,12,576
355030827000002,240,54,12,6,312,2616,348,36,24,3024,120,114,6,6,246,90,48,0,0,138,156,18,0,6,180,240,72,6,6,324
355030827000030,40,9,2,1,52,436,58,6,4,504,20,19,1,1,41,15,8,0,0,23,26,3,0,1,30,40,12,1,1,54
355030827000115,26,11,1,1,39,161,28,5,1,195,6,5,2,0,13,8,4,0,0,12,19,0,0,0,19,26,2,0,0,28
355030827000126,26,11,1,1,39,161,28,5,1,195,6,5,2,0,13,8,4,0,0,12,19,0,0,0,19,26,2,0,0,28
355030827000140,36,8,1,0,45,228,35,2,1,266,12,6,2,0,20,10,1,0,0,11,5,1,0,0,6,41,9,1,3,54
355030828000102,14,2,1,0,17,170,27,1,2,200,2,3,0,1,6,4,1,0,0,5,10,0,0,0,10,18,6,0,0,24
355030829000012,25,6,1,0,32,286,40,3,1,330,16,15,0,0,31,8,3,0,0,11,26,1,0,0,27,67,13,3,2,85
355030829000047,50,12,2,0,64,572,80,6,2,660,32,30,0,0,62,16,6,0,0,22,52,2,0,0,54,134,26,6,4,170
355030829000051,25,6,1,0,32,286,40,3,1,330,16,15,0,0,31,8,3,0,0,11,26,1,0,0,27,67,13,3,2,85
355030829000168,6,3,0,0,9,133,28,0,0,161,7,4,0,0,11,3,0,0,0,3,2,0,0,0,2,55,4,0,0,59
355030829000233,12,6,0,0,18,266,56,0,0,322,14,8,0,0,22,6,0,0,0,6,4,0,0,0,4,110,8,0,0,118
355030830000284,12,1,0,0,13,274,47,3,0,324,9,11,2,1,23,3,4,0,0,7,22,0,0,1,23,67,0,0,0,67
355030830000293,0,0,0,0,0,96,4,6,0,106,0,2,0,0,2,2,0,0,0,2,4,0,0,0,4,8,0,0,0,8
355030830000600,20,0,0,0,20,264,44,8,2,318,10,4,4,0,18,0,0,0,0,0,14,0,0,0,14,78,2,2,2,84
355030831000036,3,1,0,0,4,142,26,1,1,170,6,8,1,1,16,0,3,0,0,3,11,0,0,0,11,22,1,0,0,23
355030832000005,92,24,5,4,125,515,139,14,7,675,44,22,7,4,77,66,44,3,2,115,575,51,7,9,642,123,40,3,1,167
355030832000009,92,24,5,4,125,515,139,14,7,675,44,22,7,4,77,66,44,3,2,115,575,51,7,9,642,123,40,3,1,167
355030832000010,92,24,5,4,125,515,139,14,7,675,44,22,7,4,77,66,44,3,2,115,575,51,7,9,642,123,40,3,1,167
355030832000011,1196,312,65,52,1625,6695,1807,182,91,8775,572,286,91,52,1001,858,572,39,26,1495,7475,663,91,117,8346,1599,520,39,13,2171
355030832000012,92,24,5,4,125,515,139,14,7,675,44,22,7,4,77,66,44,3,2,115,575,51,7,9,642,123,40,3,1,167
355030832000017,184,48,10,8,250,1030,278,28,14,1350,88,44,14,8,154,132,88,6,4,230,1150,102,14,18,1284,246,80,6,2,334
355030832000023,47,6,0,1,54,242,65,4,6,317,19,11,1,0,31,23,12,1,1,37,162,5,1,2,170,44,13,2,1,60
355030832000034,92,24,5,4,125,515,139,14,7,675,44,22,7,4,77,66,44,3,2,115,575,51,7,9,642,123,40,3,1,167
355030832000036,92,24,5,4,125,515,139,14,7,675,44,22,7,4,77,66,44,3,2,115,575,51,7,9,642,123,40,3,1,167
355030832000079,47,6,0,1,54,242,65,4,6,317,19,11,1,0,31,23,12,1,1,37,162,5,1,2,170,44,13,2,1,60
355030832000115,378,60,18,6,462,3570,936,66,24,4596,120,78,0,0,198,126,48,0,0,174,972,84,6,12,1074,330,90,18,0,438
355030832000116,126,20,6,2,154,1190,312,22,8,1532,40,26,0,0,66,42,16,0,0,58,324,28,2,4,358,110,30,6,0,146
355030832000118,126,20,6,2,154,1190,312,22,8,1532,40,26,0,0,66,42,16,0,0,58,324,28,2,4,358,110,30,6,0,146
355030832000123,47,6,0,1,54,242,65,4,6,317,19,11,1,0,31,23,12,1,1,37,162,5,1,2,170,44,13,2,1,60
355030832000129,126,20,6,2,154,1190,312,22,8,1532,40,26,0,0,66,42,16,0,0,58,324,28,2,4,358,110,30,6,0,146
355030832000164,92,24,5,4,125,515,139,14,7,675,44,22,7,4,77,66,44,3,2,115,575,51,7,9,642,123,40,3,1,167
355030832000166,92,24,5,4,125,515,139,14,7,675,44,22,7,4,77,66,44,3,2,115,575,51,7,9,642,123,40,3,1,167
355030833000070,2,4,0,0,6,276,20,2,4,302,6,6,2,2,16,4,2,0,0,6,10,0,0,2,12,20,10,2,0,32
355030834000008,148,40,0,0,188,672,96,18,6,792,34,24,8,8,74,28,12,0,2,42,136,14,0,4,154,94,20,2,0,116
355030834000009,340,184,28,16,568,1524,368,40,20,1952,84,52,8,4,148,68,40,0,4,112,248,36,4,0,288,260,88,16,4,368
355030834000013,174,56,6,0,236,830,124,4,8,966,44,38,0,2,84,48,28,2,2,80,150,4,0,2,156,138,46,2,2,188
355030834000025,85,46,7,4,142,381,92,10,5,488,21,13,2,1,37,17,10,0,1,28,62,9,1,0,72,65,22,4,1,92
355030834000080,87,28,3,0,118,415,62,2,4,483,22,19,0,1,42,24,14,1,1,40,75,2,0,1,78,69,23,1,1,94
355030834000095,85,46,7,4,142,381,92,10,5,488,21,13,2,1,37,17,10,0,1,28,62,9,1,0,72,65,22,4,1,92
355030834000144,74,20,0,0,94,336,48,9,3,396,17,12,4,4,37,14,6,0,1,21,68,7,0,2,77,47,10,1,0,58
355030835000001,132,21,8,7,168,547,135,9,5,696,31,13,5,4,53,69,34,12,6,121,300,18,2,8,328,144,33,7,3,187
355030835000002,264,42,16,14,336,1094,270,18,10,1392,62,26,10,8,106,138,68,24,12,242,600,36,4,16,656,288,66,14,6,374
355030835000004,132,21,8,7,168,547,135,9,5,696,31,13,5,4,53,69,34,12,6,121,300,18,2,8,328,144,33,7,3,187
355030835000011,132,21,8,7,168,547,135,9,5,696,31,13,5,4,53,69,34,12,6,121,300,18,2,8,328,144,33,7,3,187
355030835000020,264,42,16,14,336,1094,270,18,10,1392,62,26,10,8,106,138,68,24,12,242,600,36,4,16,656,288,66,14,6,374
355030835000035,1792,960,144,224,3120,5824,1352,216,128,7520,432,144,16,32,624,1872,1184,200,224,3480,2280,112,16,40,2448,2360,720,152,176,3408
355030835000039,264,42,16,14,336,1094,270,18,10,1392,62,26,10,8,106,138,68,24,12,242,600,36,4,16,656,288,66,14,6,374
355030835000040,132,21,8,7,168,547,135,9,5,696,31,13,5,4,53,69,34,12,6,121,300,18,2,8,328,144,33,7,3,187
355030835000041,132,21,8,7,168,547,135,9,5,696,31,13,5,4,53,69,34,12,6,121,300,18,2,8,328,144,33,7,3,187
355030835000055,224,120,18,28,390,728,169,27,16,940,54,18,2,4,78,234,148,25,28,435,285,14,2,5,306,295,90,19,22,426
355030835000059,448,240,36,56,780,1456,338,54,32,1880,108,36,4,8,156,468,296,50,56,870,570,28,4,10,612,590,180,38,44,852
355030835000060,448,240,36,56,780,1456,338,54,32,1880,108,36,4,8,156,468,296,50,56,870,570,28,4,10,612,590,180,38,44,852
355030835000061,89,23,4,2,118,435,84,9,5,533,23,11,2,1,37,137,37,5,2,181,354,10,1,2,367,131,30,5,2,168
355030835000063,660,105,40,35,840,2735,675,45,25,3480,155,65,25,20,265,345,170,60,30,605,1500,90,10,40,1640,720,165,35,15,935
355030835000073,224,120,18,28,390,728,169,27,16,940,54,18,2,4,78,234,148,25,28,435,285,14,2,5,306,295,90,19,22,426
355030835000074,224,120,18,28,390,728,169,27,16,940,54,18,2,4,78,234,148,25,28,435,285,14,2,5,306,295,90,19,22,426
355030835000076,224,120,18,28,390,728,169,27,16,940,54,18,2,4,78,234,148,25,28,435,285,14,2,5,306,295,90,19,22,426
355030835000078,448,240,36,56,780,1456,338,54,32,1880,108,36,4,8,156,468,296,50,56,870,570,28,4,10,612,590,180,38,44,852
355030835000084,178,46,8,4,236,870,168,18,10,1066,46,22,4,2,74,274,74,10,4,362,708,20,2,4,734,262,60,10,4,336
355030835000085,132,21,8,7,168,547,135,9,5,696,31,13,5,4,53,69,34,12,6,121,300,18,2,8,328,144,33,7,3,187
355030835000101,448,240,36,56,780,1456,338,54,32,1880,108,36,4,8,156,468,296,50,56,870,570,28,4,10,612,590,180,38,44,852
355030835000102,224,120,18,28,390,728,169,27,16,940,54,18,2,4,78,234,148,25,28,435,285,14,2,5,306,295,90,19,22,426
355030835000106,178,46,8,4,236,870,168,18,10,1066,46,22,4,2,74,274,74,10,4,362,708,20,2,4,734,262,60,10,4,336
355030835000109,534,138,24,12,708,2610,504,54,30,3198,138,66,12,6,222,822,222,30,12,1086,2124,60,6,12,2202,786,180,30,12,1008
355030835000116,61,20,3,3,87,289,58,4,3,354,30,19,1,0,50,25,12,1,1,39,82,7,0,0,89,63,23,5,1,92
355030835000119,1120,600,90,140,1950,3640,845,135,80,4700,270,90,10,20,390,1170,740,125,140,2175,1425,70,10,25,1530,1475,450,95,110,2130
355030835000123,89,23,4,2,118,435,84,9,5,533,23,11,2,1,37,137,37,5,2,181,354,10,1,2,367,131,30,5,2,168
355030835000129,224,120,18,28,390,728,169,27,16,940,54,18,2,4,78,234,148,25,28,435,285,14,2,5,306,295,90,19,22,426
355030835000131,267,69,12,6,354,1305,252,27,15,1599,69,33,6,3,111,411,111,15,6,543,1062,30,3,6,1101,393,90,15,6,504
355030835000138,224,120,18,28,390,728,169,27,16,940,54,18,2,4,78,234,148,25,28,435,285,14,2,5,306,295,90,19,22,426
355030835000179,672,360,54,84,1170,2184,507,81,48,2820,162,54,6,12,234,702,444,75,84,1305,855,42,6,15,918,885,270,57,66,1278
355030835000184,89,23,4,2,118,435,84,9,5,533,23,11,2,1,37,137,37,5,2,181,354,10,1,2,367,131,30,5,2,168
355030835000186,224,120,18,28,390,728,169,27,16,940,54,18,2,4,78,234,148,25,28,435,285,14,2,5,306,295,90,19,22,426
355030835000187,132,21,8,7,168,547,135,9,5,696,31,13,5,4,53,69,34,12,6,121,300,18,2,8,328,144,33,7,3,187
355030835000191,89,23,4,2,118,435,84,9,5,533,23,11,2,1,37,137,37,5,2,181,354,10,1,2,367,131,30,5,2,168
355030835000207,224,120,18,28,390,728,169,27,16,940,54,18,2,4,78,234,148,25,28,435,285,14,2,5,306,295,90,19,22,426
355030836000105,21,1,0,0,22,356,58,3,2,419,18,18,1,0,37,6,9,0,0,15,42,3,1,0,46,33,1,1,0,35
355030836000235,14,4,0,2,20,290,44,4,6,344,10,12,2,0,24,8,0,0,0,8,14,4,0,2,20,12,2,0,0,14
355030836000285,4,2,0,0,6,102,20,0,0,122,6,2,0,0,8,0,0,0,0,0,0,0,0,0,0,14,0,0,4,18
355030837000015,12,4,0,0,16,207,24,4,0,235,12,12,0,0,24,4,1,0,0,5,15,2,2,0,19,17,1,0,0,18
355030837000019,17,4,1,0,22,291,71,5,2,369,20,18,1,1,40,8,8,0,0,16,64,7,0,2,73,24,8,0,1,33
355030837000040,24,8,0,0,32,414,48,8,0,470,24,24,0,0,48,8,2,0,0,10,30,4,4,0,38,34,2,0,0,36
355030837000061,16,4,0,0,20,254,28,0,2,284,8,6,2,0,16,4,0,0,0,4,10,0,0,0,10,12,0,0,0,12
355030837000138,136,32,8,0,176,2328,568,40,16,2952,160,144,8,8,320,64,64,0,0,128,512,56,0,16,584,192,64,0,8,264
355030838000025,90,12,3,0,105,525,96,3,12,636,54,27,6,0,87,39,6,0,0,45,111,33,3,18,165,138,9,6,3,156
355030838000147,44,19,2,3,68,207,34,1,0,242,27,17,3,1,48,11,7,1,1,20,28,3,0,0,31,66,10,3,0,79
355030838000185,35,13,1,1,50,174,20,1,2,197,9,11,0,0,20,6,3,2,3,14,23,1,0,1,25,40,7,2,1,50
355030838000186,88,38,4,6,136,414,68,2,0,484,54,34,6,2,96,22,14,2,2,40,56,6,0,0,62,132,20,6,0,158
355030839000017,51,7,1,1,60,264,48,4,8,324,10,8,3,1,22,6,7,0,0,13,18,0,0,2,20,68,7,0,0,75
355030839000019,50,16,4,0,70,256,50,2,2,310,8,2,0,0,10,6,0,0,0,6,6,0,0,0,6,62,22,6,2,92
355030839000101,51,7,1,1,60,264,48,4,8,324,10,8,3,1,22,6,7,0,0,13,18,0,0,2,20,68,7,0,0,75
355030841000025,44,18,7,4,73,324,67,7,7,405,15,7,0,1,23,13,7,0,0,20,32,1,0,1,34,74,33,2,9,118
355030841000078,176,72,28,16,292,1296,268,28,28,1620,60,28,0,4,92,52,28,0,0,80,128,4,0,4,136,296,132,8,36,472
355030842000143,5,3,0,0,8,81,14,2,0,97,3,11,1,0,15,0,0,0,0,0,6,0,0,0,6,40,1,0,1,42
355030842000151,24,4,0,0,28,338,54,2,0,394,16,22,2,0,40,6,2,0,0,8,22,0,0,0,22,84,10,0,4,98
355030842000289,5,3,0,0,8,81,14,2,0,97,3,11,1,0,15,0,0,0,0,0,6,0,0,0,6,40,1,0,1,42
355030843000127,3,0,0,0,3,119,18,2,1,140,4,3,0,0,7,1,1,0,0,2,9,0,0,0,9,23,2,1,0,26
355030843000140,4,2,2,0,8,208,20,2,0,230,4,0,0,0,4,2,0,0,0,2,14,0,0,0,14,54,2,0,0,56
355030843000272,12,2,0,0,14,68,14,4,0,86,0,2,0,0,2,2,0,0,0,2,0,0,0,0,0,36,0,0,0,36
355030843000305,0,1,0,0,1,49,5,1,0,55,0,2,0,0,2,0,0,0,0,0,0,0,0,0,0,4,0,0,0,4
355030844000173,8,0,0,0,8,146,16,0,2,164,4,2,0,0,6,0,0,0,0,0,2,0,0,0,2,14,0,0,0,14
355030844000181,3,3,0,0,6,136,10,2,0,148,8,1,1,0,10,3,0,0,0,3,4,0,0,0,4,15,1,0,0,16
355030845000001,136,38,0,0,174,878,220,10,20,1128,52,18,8,4,82,134,100,8,16,258,456,76,8,2,542,168,52,4,2,226
355030845000002,136,38,0,0,174,878,220,10,20,1128,52,18,8,4,82,134,100,8,16,258,456,76,8,2,542,168,52,4,2,226
355030845000008,68,19,0,0,87,439,110,5,10,564,26,9,4,2,41,67,50,4,8,129,228,38,4,1,271,84,26,2,1,113
355030845000009,68,19,0,0,87,439,110,5,10,564,26,9,4,2,41,67,50,4,8,129,228,38,4,1,271,84,26,2,1,113
355030845000010,136,38,0,0,174,878,220,10,20,1128,52,18,8,4,82,134,100,8,16,258,456,76,8,2,542,168,52,4,2,226
355030845000011,189,51,3,6,249,1485,423,36,3,1947,87,33,6,15,141,120,99,9,12,240,741,24,6,18,789,282,54,6,15,357
355030845000012,63,17,1,2,83,495,141,12,1,649,29,11,2,5,47,40,33,3,4,80,247,8,2,6,263,94,18,2,5,119
355030845000013,315,85,5,10,415,2475,705,60,5,3245,145,55,10,25,235,200,165,15,20,400,1235,40,10,30,1315,470,90,10,25,595
355030845000017,68,19,0,0,87,439,110,5,10,564,26,9,4,2,41,67,50,4,8,129,228,38,4,1,271,84,26,2,1,113
355030845000018,136,38,0,0,174,878,220,10,20,1128,52,18,8,4,82,134,100,8,16,258,456,76,8,2,542,168,52,4,2,226
355030845000020,136,38,0,0,174,878,220,10,20,1128,52,18,8,4,82,134,100,8,16,258,456,76,8,2,542,168,52,4,2,226
355030845000023,68,19,0,0,87,439,110,5,10,564,26,9,4,2,41,67,50,4,8,129,228,38,4,1,271,84,26,2,1,113
355030845000024,136,38,0,0,174,878,220,10,20,1128,52,18,8,4,82,134,100,8,16,258,456,76,8,2,542,168,52,4,2,226
355030845000025,272,76,0,0,348,1756,440,20,40,2256,104,36,16,8,164,268,200,16,32,516,912,152,16,4,1084,336,104,8,4,452
355030845000029,189,51,3,6,249,1485,423,36,3,1947,87,33,6,15,141,120,99,9,12,240,741,24,6,18,789,282,54,6,15,357
355030845000033,126,34,2,4,166,990,282,24,2,1298,58,22,4,10,94,80,66,6,8,160,494,16,4,12,526,188,36,4,10,238
355030845000045,68,19,0,0,87,439,110,5,10,564,26,9,4,2,41,67,50,4,8,129,228,38,4,1,271,84,26,2,1,113
355030845000047,204,57,0,0,261,1317,330,15,30,1692,78,27,12,6,123,201,150,12,24,387,684,114,12,3,813,252,78,6,3,339
355030845000050,126,34,2,4,166,990,282,24,2,1298,58,22,4,10,94,80,66,6,8,160,494,16,4,12,526,188,36,4,10,238
355030845000056,441,119,7,14,581,3465,987,84,7,4543,203,77,14,35,329,280,231,21,28,560,1729,56,14,42,1841,658,126,14,35,833
355030845000057,136,38,0,0,174,878,220,10,20,1128,52,18,8,4,82,134,100,8,16,258,456,76,8,2,542,168,52,4,2,226
355030845000064,85,19,3,3,110,296,56,4,2,358,42,18,0,3,63,52,28,0,8,88,213,6,1,3,223,134,28,1,1,164
355030845000072,136,38,0,0,174,878,220,10,20,1128,52,18,8,4,82,134,100,8,16,258,456,76,8,2,542,168,52,4,2,226
355030845000075,68,19,0,0,87,439,110,5,10,564,26,9,4,2,41,67,50,4,8,129,228,38,4,1,271,84,26,2,1,113
355030845000076,136,38,0,0,174,878,220,10,20,1128,52,18,8,4,82,134,100,8,16,258,456,76,8,2,542,168,52,4,2,226
355030845000078,136,38,0,0,174,878,220,10,20,1128,52,18,8,4,82,134,100,8,16,258,456,76,8,2,542,168,52,4,2,226
355030845000079,68,19,0,0,87,439,110,5,10,564,26,9,4,2,41,67,50,4,8,129,228,38,4,1,271,84,26,2,1,113
355030845000082,68,19,0,0,87,439,110,5,10,564,26,9,4,2,41,67,50,4,8,129,228,38,4,1,271,84,26,2,1,113
355030845000084,63,17,1,2,83,495,141,12,1,649,29,11,2,5,47,40,33,3,4,80,247,8,2,6,263,94,18,2,5,119
355030845000086,189,51,3,6,249,1485,423,36,3,1947,87,33,6,15,141,120,99,9,12,240,741,24,6,18,789,282,54,6,15,357
355030845000087,63,17,1,2,83,495,141,12,1,649,29,11,2,5,47,40,33,3,4,80,247,8,2,6,263,94,18,2,5,119
355030845000093,63,17,1,2,83,495,141,12,1,649,29,11,2,5,47,40,33,3,4,80,247,8,2,6,263,94,18,2,5,119
355030845000095,340,95,0,0,435,2195,550,25,50,2820,130,45,20,10,205,335,250,20,40,645,1140,190,20,5,1355,420,130,10,5,565
355030845000098,340,76,12,12,440,1184,224,16,8,1432,168,72,0,12,252,208,112,0,32,352,852,24,4,12,892,536,112,4,4,656
355030845000100,85,19,3,3,110,296,56,4,2,358,42,18,0,3,63,52,28,0,8,88,213,6,1,3,223,134,28,1,1,164
355030845000102,85,19,3,3,110,296,56,4,2,358,42,18,0,3,63,52,28,0,8,88,213,6,1,3,223,134,28,1,1,164
355030845000104,85,19,3,3,110,296,56,4,2,358,42,18,0,3,63,52,28,0,8,88,213,6,1,3,223,134,28,1,1,164
355030845000105,85,19,3,3,110,296,56,4,2,358,42,18,0,3,63,52,28,0,8,88,213,6,1,3,223,134,28,1,1,164
355030845000116,68,19,0,0,87,439,110,5,10,564,26,9,4,2,41,67,50,4,8,129,228,38,4,1,271,84,26,2,1,113
355030845000125,63,17,1,2,83,495,141,12,1,649,29,11,2,5,47,40,33,3,4,80,247,8,2,6,263,94,18,2,5,119
355030845000141,68,19,0,0,87,439,110,5,10,564,26,9,4,2,41,67,50,4,8,129,228,38,4,1,271,84,26,2,1,113
355030845000142,189,51,3,6,249,1485,423,36,3,1947,87,33,6,15,141,120,99,9,12,240,741,24,6,18,789,282,54,6,15,357
355030845000143,63,17,1,2,83,495,141,12,1,649,29,11,2,5,47,40,33,3,4,80,247,8,2,6,263,94,18,2,5,119
355030845000146,63,17,1,2,83,495,141,12,1,649,29,11,2,5,47,40,33,3,4,80,247,8,2,6,263,94,18,2,5,119
355030845000154,170,38,6,6,220,592,112,8,4,716,84,36,0,6,126,104,56,0,16,176,426,12,2,6,446,268,56,2,2,328
355030845000166,63,17,1,2,83,495,141,12,1,649,29,11,2,5,47,40,33,3,4,80,247,8,2,6,263,94,18,2,5,119
355030845000168,126,34,2,4,166,990,282,24,2,1298,58,22,4,10,94,80,66,6,8,160,494,16,4,12,526,188,36,4,10,238
355030845000171,63,17,1,2,83,495,141,12,1,649,29,11,2,5,47,40,33,3,4,80,247,8,2,6,263,94,18,2,5,119
355030845000173,63,17,1,2,83,495,141,12,1,649,29,11,2,5,47,40,33,3,4,80,247,8,2,6,263,94,18,2,5,119
355030845000176,85,19,3,3,110,296,56,4,2,358,42,18,0,3,63,52,28,0,8,88,213,6,1,3,223,134,28,1,1,164
355030845000188,63,17,1,2,83,495,141,12,1,649,29,11,2,5,47,40,33,3,4,80,247,8,2,6,263,94,18,2,5,119
355030845000190,68,19,0,0,87,439,110,5,10,564,26,9,4,2,41,67,50,4,8,129,228,38,4,1,271,84,26,2,1,113
355030845000192,204,57,0,0,261,1317,330,15,30,1692,78,27,12,6,123,201,150,12,24,387,684,114,12,3,813,252,78,6,3,339
355030845000204,85,19,3,3,110,296,56,4,2,358,42,18,0,3,63,52,28,0,8,88,213,6,1,3,223,134,28,1,1,164
355030845000206,63,17,1,2,83,495,141,12,1,649,29,11,2,5,47,40,33,3,4,80,247,8,2,6,263,94,18,2,5,119
355030845000207,170,38,6,6,220,592,112,8,4,716,84,36,0,6,126,104,56,0,16,176,426,12,2,6,446,268,56,2,2,328
355030845000208,68,19,0,0,87,439,110,5,10,564,26,9,4,2,41,67,50,4,8,129,228,38,4,1,271,84,26,2,1,113
355030845000210,63,17,1,2,83,495,141,12,1,649,29,11,2,5,47,40,33,3,4,80,247,8,2,6,263,94,18,2,5,119
355030845000211,63,17,1,2,83,495,141,12,1,649,29,11,2,5,47,40,33,3,4,80,247,8,2,6,263,94,18,2,5,119
355030846000005,4,3,0,0,7,157,28,1,1,187,7,5,0,0,12,4,0,0,0,4,11,2,0,0,13,32,2,0,0,34
355030846000219,5,3,0,2,10,217,26,2,2,247,16,9,1,1,27,2,0,0,0,2,19,2,0,1,22,34,2,1,0,37
355030846000283,20,0,4,0,24,302,60,2,0,364,20,8,2,0,30,6,6,0,0,12,18,0,0,0,18,80,8,2,0,90
355030846000288,20,0,4,0,24,302,60,2,0,364,20,8,2,0,30,6,6,0,0,12,18,0,0,0,18,80,8,2,0,90
355030847000033,3,2,0,0,5,51,6,0,2,59,1,2,1,0,4,0,0,0,0,0,1,0,0,0,1,4,0,0,0,4
355030847000037,3,0,0,0,3,37,5,1,0,43,1,2,1,0,4,0,0,0,0,0,0,0,0,0,0,4,0,0,0,4
355030847000096,3,0,0,0,3,37,5,1,0,43,1,2,1,0,4,0,0,0,0,0,0,0,0,0,0,4,0,0,0,4
355030848000010,501,171,45,45,762,3468,780,75,33,4356,135,81,12,15,243,183,132,6,3,324,696,36,3,6,741,459,126,24,27,636
355030848000011,167,57,15,15,254,1156,260,25,11,1452,45,27,4,5,81,61,44,2,1,108,232,12,1,2,247,153,42,8,9,212
355030848000024,69,17,1,0,87,290,44,7,2,343,27,11,1,2,41,19,4,1,0,24,82,16,2,2,102,42,5,1,0,48
355030848000036,334,114,30,30,508,2312,520,50,22,2904,90,54,8,10,162,122,88,4,2,216,464,24,2,4,494,306,84,16,18,424
355030848000044,69,17,1,0,87,290,44,7,2,343,27,11,1,2,41,19,4,1,0,24,82,16,2,2,102,42,5,1,0,48
355030848000054,69,17,1,0,87,290,44,7,2,343,27,11,1,2,41,19,4,1,0,24,82,16,2,2,102,42,5,1,0,48
355030848000069,138,34,2,0,174,580,88,14,4,686,54,22,2,4,82,38,8,2,0,48,164,32,4,4,204,84,10,2,0,96
355030848000070,69,17,1,0,87,290,44,7,2,343,27,11,1,2,41,19,4,1,0,24,82,16,2,2,102,42,5,1,0,48
355030848000094,167,57,15,15,254,1156,260,25,11,1452,45,27,4,5,81,61,44,2,1,108,232,12,1,2,247,153,42,8,9,212
355030848000104,167,57,15,15,254,1156,260,25,11,1452,45,27,4,5,81,61,44,2,1,108,232,12,1,2,247,153,42,8,9,212
355030848000107,501,171,45,45,762,3468,780,75,33,4356,135,81,12,15,243,183,132,6,3,324,696,36,3,6,741,459,126,24,27,636
355030848000115,167,57,15,15,254,1156,260,25,11,1452,45,27,4,5,81,61,44,2,1,108,232,12,1,2,247,153,42,8,9,212
355030849000003,48,19,2,0,69,186,33,5,2,226,20,14,2,2,38,11,6,0,0,17,45,5,0,1,51,36,7,0,1,44
355030849000008,48,19,2,0,69,186,33,5,2,226,20,14,2,2,38,11,6,0,0,17,45,5,0,1,51,36,7,0,1,44
355030849000023,48,19,2,0,69,186,33,5,2,226,20,14,2,2,38,11,6,0,0,17,45,5,0,1,51,36,7,0,1,44
355030849000087,210,33,0,6,249,828,135,15,12,990,78,69,12,36,195,54,48,0,12,114,315,27,3,30,375,306,39,0,0,345
355030849000091,70,11,0,2,83,276,45,5,4,330,26,23,4,12,65,18,16,0,4,38,105,9,1,10,125,102,13,0,0,115
355030849000095,70,11,0,2,83,276,45,5,4,330,26,23,4,12,65,18,16,0,4,38,105,9,1,10,125,102,13,0,0,115
355030849000100,48,19,2,0,69,186,33,5,2,226,20,14,2,2,38,11,6,0,0,17,45,5,0,1,51,36,7,0,1,44
355030849000103,1050,165,0,30,1245,4140,675,75,60,4950,390,345,60,180,975,270,240,0,60,570,1575,135,15,150,1875,1530,195,0,0,1725
355030849000104,210,33,0,6,249,828,135,15,12,990,78,69,12,36,195,54,48,0,12,114,315,27,3,30,375,306,39,0,0,345
355030849000109,70,11,0,2,83,276,45,5,4,330,26,23,4,12,65,18,16,0,4,38,105,9,1,10,125,102,13,0,0,115
355030850000006,26,6,0,0,32,207,31,1,1,240,9,7,1,2,19,6,1,0,0,7,15,1,0,0,16,34,7,4,0,45
355030851000042,168,56,0,0,224,2288,400,16,24,2728,48,56,8,0,112,80,16,0,8,104,120,0,0,0,120,280,40,0,0,320
355030851000070,20,6,0,0,26,163,20,1,0,184,11,5,0,1,17,12,4,0,0,16,31,0,0,0,31,24,3,1,0,28
355030851000098,20,6,0,0,26,163,20,1,0,184,11,5,0,1,17,12,4,0,0,16,31,0,0,0,31,24,3,1,0,28
355030851000119,15,3,0,0,18,106,17,0,1,124,8,14,1,0,23,8,2,1,0,11,8,1,1,0,10,33,3,0,0,36
355030853000004,109,28,2,1,140,475,82,14,5,576,28,17,5,5,55,43,14,0,1,58,105,11,4,8,128,81,19,2,3,105
355030853000021,116,38,9,5,168,566,114,5,3,688,22,15,3,1,41,24,19,0,0,43,100,14,2,0,116,85,20,4,6,115
355030853000057,109,28,2,1,140,475,82,14,5,576,28,17,5,5,55,43,14,0,1,58,105,11,4,8,128,81,19,2,3,105
355030853000071,218,56,4,2,280,950,164,28,10,1152,56,34,10,10,110,86,28,0,2,116,210,22,8,16,256,162,38,4,6,210
355030853000079,109,28,2,1,140,475,82,14,5,576,28,17,5,5,55,43,14,0,1,58,105,11,4,8,128,81,19,2,3,105
355030854000029,140,72,4,4,220,1464,304,16,40,1824,144,76,16,32,268,108,32,0,20,160,680,36,12,16,744,180,28,16,8,232
355030854000042,35,18,1,1,55,366,76,4,10,456,36,19,4,8,67,27,8,0,5,40,170,9,3,4,186,45,7,4,2,58
355030854000052,35,18,1,1,55,366,76,4,10,456,36,19,4,8,67,27,8,0,5,40,170,9,3,4,186,45,7,4,2,58
355030854000062,35,18,1,1,55,366,76,4,10,456,36,19,4,8,67,27,8,0,5,40,170,9,3,4,186,45,7,4,2,58
355030854000066,35,18,1,1,55,366,76,4,10,456,36,19,4,8,67,27,8,0,5,40,170,9,3,4,186,45,7,4,2,58
355030854000067,70,36,2,2,110,732,152,8,20,912,72,38,8,16,134,54,16,0,10,80,340,18,6,8,372,90,14,8,4,116
355030854000084,35,18,1,1,55,366,76,4,10,456,36,19,4,8,67,27,8,0,5,40,170,9,3,4,186,45,7,4,2,58
355030854000098,70,36,2,2,110,732,152,8,20,912,72,38,8,16,134,54,16,0,10,80,340,18,6,8,372,90,14,8,4,116
355030855000021,4,0,0,0,4,119,12,1,1,133,1,2,1,0,4,0,1,0,0,1,6,0,0,0,6,16,2,0,0,18
355030856000008,4608,1224,168,72,6072,7584,900,24,24,8532,192,48,0,24,264,192,132,0,12,336,324,36,12,12,384,792,204,24,0,1020
355030856000009,384,102,14,6,506,632,75,2,2,711,16,4,0,2,22,16,11,0,1,28,27,3,1,1,32,66,17,2,0,85
355030857000078,26,10,6,0,42,250,48,2,2,302,10,2,4,0,16,2,0,0,0,2,6,2,0,0,8,22,0,2,0,24
355030857000088,26,10,6,0,42,250,48,2,2,302,10,2,4,0,16,2,0,0,0,2,6,2,0,0,8,22,0,2,0,24
355030858000110,34,4,0,0,38,292,30,0,2,324,26,18,0,0,44,2,4,0,0,6,12,0,0,0,12,50,6,0,2,58
355030859000010,17,6,0,0,23,176,31,2,1,210,9,6,0,0,15,9,1,0,0,10,19,0,0,0,19,28,3,0,0,31
355030859000118,118,28,0,0,146,1208,234,22,14,1478,44,36,6,6,92,46,34,2,0,82,202,18,2,4,226,126,38,0,0,164
355030859000120,531,126,0,0,657,5436,1053,99,63,6651,198,162,27,27,414,207,153,9,0,369,909,81,9,18,1017,567,171,0,0,738
355030860000005,36,5,0,0,41,155,28,6,2,191,22,6,4,1,33,9,10,0,1,20,55,2,2,0,59,24,6,0,0,30
355030860000021,42,5,0,2,49,275,37,6,1,319,22,7,0,1,30,26,7,0,1,34,114,9,2,0,125,36,6,0,0,42
355030860000049,70,18,2,2,92,454,108,4,10,576,48,34,4,12,98,56,38,2,2,98,298,26,0,2,326,112,24,0,6,142
355030860000051,35,9,1,1,46,227,54,2,5,288,24,17,2,6,49,28,19,1,1,49,149,13,0,1,163,56,12,0,3,71
355030860000054,35,9,1,1,46,227,54,2,5,288,24,17,2,6,49,28,19,1,1,49,149,13,0,1,163,56,12,0,3,71
355030860000062,42,5,0,2,49,275,37,6,1,319,22,7,0,1,30,26,7,0,1,34,114,9,2,0,125,36,6,0,0,42
355030860000071,35,9,1,1,46,227,54,2,5,288,24,17,2,6,49,28,19,1,1,49,149,13,0,1,163,56,12,0,3,71
355030860000075,140,36,4,4,184,908,216,8,20,1152,96,68,8,24,196,112,76,4,4,196,596,52,0,4,652,224,48,0,12,284
355030860000078,35,9,1,1,46,227,54,2,5,288,24,17,2,6,49,28,19,1,1,49,149,13,0,1,163,56,12,0,3,71
355030860000123,35,9,1,1,46,227,54,2,5,288,24,17,2,6,49,28,19,1,1,49,149,13,0,1,163,56,12,0,3,71
355030860000124,35,9,1,1,46,227,54,2,5,288,24,17,2,6,49,28,19,1,1,49,149,13,0,1,163,56,12,0,3,71
355030860000132,31,9,1,1,42,174,26,0,4,204,18,4,3,1,26,11,6,0,0,17,63,5,1,2,71,25,6,2,0,33
355030860000134,62,18,2,2,84,348,52,0,8,408,36,8,6,2,52,22,12,0,0,34,126,10,2,4,142,50,12,4,0,66
355030860000138,217,63,7,7,294,1218,182,0,28,1428,126,28,21,7,182,77,42,0,0,119,441,35,7,14,497,175,42,14,0,231
355030860000162,36,5,0,0,41,155,28,6,2,191,22,6,4,1,33,9,10,0,1,20,55,2,2,0,59,24,6,0,0,30
355030860000170,42,5,0,2,49,275,37,6,1,319,22,7,0,1,30,26,7,0,1,34,114,9,2,0,125,36,6,0,0,42
355030860000216,35,9,1,1,46,227,54,2,5,288,24,17,2,6,49,28,19,1,1,49,149,13,0,1,163,56,12,0,3,71
355030861000001,20,0,0,0,20,216,36,2,0,254,16,14,0,0,30,0,0,0,0,0,12,0,0,0,12,58,6,0,0,64
355030861000010,2,0,0,0,2,156,44,2,0,202,6,19,0,0,25,1,4,0,0,5,20,0,0,0,20,18,3,0,0,21
355030862000001,72,8,4,2,86,568,110,0,2,680,72,24,2,4,102,34,14,0,0,48,224,10,0,0,234,100,12,0,0,112
355030862000002,108,12,6,3,129,852,165,0,3,1020,108,36,3,6,153,51,21,0,0,72,336,15,0,0,351,150,18,0,0,168
355030862000005,122,24,4,2,152,902,166,6,10,1084,30,12,8,2,52,52,36,0,4,92,274,6,0,6,286,152,20,0,0,172
355030862000006,61,12,2,1,76,451,83,3,5,542,15,6,4,1,26,26,18,0,2,46,137,3,0,3,143,76,10,0,0,86
355030862000007,61,12,2,1,76,451,83,3,5,542,15,6,4,1,26,26,18,0,2,46,137,3,0,3,143,76,10,0,0,86
355030862000008,180,20,10,5,215,1420,275,0,5,1700,180,60,5,10,255,85,35,0,0,120,560,25,0,0,585,250,30,0,0,280
355030862000009,252,28,14,7,301,1988,385,0,7,2380,252,84,7,14,357,119,49,0,0,168,784,35,0,0,819,350,42,0,0,392
355030862000010,108,12,6,3,129,852,165,0,3,1020,108,36,3,6,153,51,21,0,0,72,336,15,0,0,351,150,18,0,0,168
355030862000013,61,12,2,1,76,451,83,3,5,542,15,6,4,1,26,26,18,0,2,46,137,3,0,3,143,76,10,0,0,86
355030862000016,61,12,2,1,76,451,83,3,5,542,15,6,4,1,26,26,18,0,2,46,137,3,0,3,143,76,10,0,0,86
355030862000018,61,12,2,1,76,451,83,3,5,542,15,6,4,1,26,26,18,0,2,46,137,3,0,3,143,76,10,0,0,86
355030862000019,305,60,10,5,380,2255,415,15,25,2710,75,30,20,5,130,130,90,0,10,230,685,15,0,15,715,380,50,0,0,430
355030862000021,576,192,24,24,816,3508,1116,72,28,4724,196,112,28,24,360,600,296,28,56,980,1184,84,12,4,1284,816,188,44,32,1080
355030862000023,36,4,2,1,43,284,55,0,1,340,36,12,1,2,51,17,7,0,0,24,112,5,0,0,117,50,6,0,0,56
355030862000025,216,24,12,6,258,1704,330,0,6,2040,216,72,6,12,306,102,42,0,0,144,672,30,0,0,702,300,36,0,0,336
355030862000026,108,12,6,3,129,852,165,0,3,1020,108,36,3,6,153,51,21,0,0,72,336,15,0,0,351,150,18,0,0,168
355030862000027,216,24,12,6,258,1704,330,0,6,2040,216,72,6,12,306,102,42,0,0,144,672,30,0,0,702,300,36,0,0,336
355030862000028,36,4,2,1,43,284,55,0,1,340,36,12,1,2,51,17,7,0,0,24,112,5,0,0,117,50,6,0,0,56
355030862000033,61,12,2,1,76,451,83,3,5,542,15,6,4,1,26,26,18,0,2,46,137,3,0,3,143,76,10,0,0,86
355030862000034,61,12,2,1,76,451,83,3,5,542,15,6,4,1,26,26,18,0,2,46,137,3,0,3,143,76,10,0,0,86
355030862000038,183,36,6,3,228,1353,249,9,15,1626,45,18,12,3,78,78,54,0,6,138,411,9,0,9,429,228,30,0,0,258
355030862000045,144,48,6,6,204,877,279,18,7,1181,49,28,7,6,90,150,74,7,14,245,296,21,3,1,321,204,47,11,8,270
355030862000048,36,4,2,1,43,284,55,0,1,340,36,12,1,2,51,17,7,0,0,24,112,5,0,0,117,50,6,0,0,56
355030862000049,108,12,6,3,129,852,165,0,3,1020,108,36,3,6,153,51,21,0,0,72,336,15,0,0,351,150,18,0,0,168
355030862000059,61,12,2,1,76,451,83,3,5,542,15,6,4,1,26,26,18,0,2,46,137,3,0,3,143,76,10,0,0,86
355030862000061,61,12,2,1,76,451,83,3,5,542,15,6,4,1,26,26,18,0,2,46,137,3,0,3,143,76,10,0,0,86
355030862000064,122,24,4,2,152,902,166,6,10,1084,30,12,8,2,52,52,36,0,4,92,274,6,0,6,286,152,20,0,0,172
355030862000065,432,144,18,18,612,2631,837,54,21,3543,147,84,21,18,270,450,222,21,42,735,888,63,9,3,963,612,141,33,24,810
355030862000067,61,12,2,1,76,451,83,3,5,542,15,6,4,1,26,26,18,0,2,46,137,3,0,3,143,76,10,0,0,86
355030862000069,432,144,18,18,612,2631,837,54,21,3543,147,84,21,18,270,450,222,21,42,735,888,63,9,3,963,612,141,33,24,810
355030862000070,288,96,12,12,408,1754,558,36,14,2362,98,56,14,12,180,300,148,14,28,490,592,42,6,2,642,408,94,22,16,540
355030862000071,288,96,12,12,408,1754,558,36,14,2362,98,56,14,12,180,300,148,14,28,490,592,42,6,2,642,408,94,22,16,540
355030862000074,432,144,18,18,612,2631,837,54,21,3543,147,84,21,18,270,450,222,21,42,735,888,63,9,3,963,612,141,33,24,810
355030862000084,36,4,2,1,43,284,55,0,1,340,36,12,1,2,51,17,7,0,0,24,112,5,0,0,117,50,6,0,0,56
355030862000093,183,36,6,3,228,1353,249,9,15,1626,45,18,12,3,78,78,54,0,6,138,411,9,0,9,429,228,30,0,0,258
355030862000096,288,96,12,12,408,1754,558,36,14,2362,98,56,14,12,180,300,148,14,28,490,592,42,6,2,642,408,94,22,16,540
355030862000097,144,48,6,6,204,877,279,18,7,1181,49,28,7,6,90,150,74,7,14,245,296,21,3,1,321,204,47,11,8,270
355030862000099,288,96,12,12,408,1754,558,36,14,2362,98,56,14,12,180,300,148,14,28,490,592,42,6,2,642,408,94,22,16,540
355030862000100,1584,528,66,66,2244,9647,3069,198,77,12991,539,308,77,66,990,1650,814,77,154,2695,3256,231,33,11,3531,2244,517,121,88,2970
355030862000103,144,48,6,6,204,877,279,18,7,1181,49,28,7,6,90,150,74,7,14,245,296,21,3,1,321,204,47,11,8,270
355030862000104,1584,528,66,66,2244,9647,3069,198,77,12991,539,308,77,66,990,1650,814,77,154,2695,3256,231,33,11,3531,2244,517,121,88,2970
355030862000105,36,4,2,1,43,284,55,0,1,340,36,12,1,2,51,17,7,0,0,24,112,5,0,0,117,50,6,0,0,56
355030862000110,720,240,30,30,1020,4385,1395,90,35,5905,245,140,35,30,450,750,370,35,70,1225,1480,105,15,5,1605,1020,235,55,40,1350
355030862000113,288,96,12,12,408,1754,558,36,14,2362,98,56,14,12,180,300,148,14,28,490,592,42,6,2,642,408,94,22,16,540
355030862000114,288,96,12,12,408,1754,558,36,14,2362,98,56,14,12,180,300,148,14,28,490,592,42,6,2,642,408,94,22,16,540
355030862000115,144,48,6,6,204,877,279,18,7,1181,49,28,7,6,90,150,74,7,14,245,296,21,3,1,321,204,47,11,8,270
355030862000118,144,48,6,6,204,877,279,18,7,1181,49,28,7,6,90,150,74,7,14,245,296,21,3,1,321,204,47,11,8,270
355030862000123,36,4,2,1,43,284,55,0,1,340,36,12,1,2,51,17,7,0,0,24,112,5,0,0,117,50,6,0,0,56
355030862000124,36,4,2,1,43,284,55,0,1,340,36,12,1,2,51,17,7,0,0,24,112,5,0,0,117,50,6,0,0,56
355030862000127,36,4,2,1,43,284,55,0,1,340,36,12,1,2,51,17,7,0,0,24,112,5,0,0,117,50,6,0,0,56
355030862000129,61,12,2,1,76,451,83,3,5,542,15,6,4,1,26,26,18,0,2,46,137,3,0,3,143,76,10,0,0,86
355030862000133,61,12,2,1,76,451,83,3,5,542,15,6,4,1,26,26,18,0,2,46,137,3,0,3,143,76,10,0,0,86
355030862000138,183,36,6,3,228,1353,249,9,15,1626,45,18,12,3,78,78,54,0,6,138,411,9,0,9,429,228,30,0,0,258
355030862000139,288,96,12,12,408,1754,558,36,14,2362,98,56,14,12,180,300,148,14,28,490,592,42,6,2,642,408,94,22,16,540
355030862000156,36,4,2,1,43,284,55,0,1,340,36,12,1,2,51,17,7,0,0,24,112,5,0,0,117,50,6,0,0,56
355030862000160,288,96,12,12,408,1754,558,36,14,2362,98,56,14,12,180,300,148,14,28,490,592,42,6,2,642,408,94,22,16,540
355030862000161,144,48,6,6,204,877,279,18,7,1181,49,28,7,6,90,150,74,7,14,245,296,21,3,1,321,204,47,11,8,270
355030862000163,432,144,18,18,612,2631,837,54,21,3543,147,84,21,18,270,450,222,21,42,735,888,63,9,3,963,612,141,33,24,810
355030862000166,36,4,2,1,43,284,55,0,1,340,36,12,1,2,51,17,7,0,0,24,112,5,0,0,117,50,6,0,0,56
355030862000170,61,12,2,1,76,451,83,3,5,542,15,6,4,1,26,26,18,0,2,46,137,3,0,3,143,76,10,0,0,86
355030862000174,36,4,2,1,43,284,55,0,1,340,36,12,1,2,51,17,7,0,0,24,112,5,0,0,117,50,6,0,0,56
355030866000001,570,122,8,4,704,3890,520,38,12,4460,76,26,8,10,120,422,192,16,26,656,268,28,4,4,304,770,162,20,22,974
355030866000002,3705,793,52,26,4576,25285,3380,247,78,28990,494,169,52,65,780,2743,1248,104,169,4264,1742,182,26,26,1976,5005,1053,130,143,6331
355030866000003,2565,549,36,18,3168,17505,2340,171,54,20070,342,117,36,45,540,1899,864,72,117,2952,1206,126,18,18,1368,3465,729,90,99,4383
355030866000004,82,22,0,0,104,602,122,2,2,728,36,24,6,2,68,108,34,2,8,152,90,6,0,2,98,254,26,8,4,292
355030866000008,41,11,0,0,52,301,61,1,1,364,18,12,3,1,34,54,17,1,4,76,45,3,0,1,49,127,13,4,2,146
355030866000011,41,11,0,0,52,301,61,1,1,364,18,12,3,1,34,54,17,1,4,76,45,3,0,1,49,127,13,4,2,146
355030866000012,1425,305,20,10,1760,9725,1300,95,30,11150,190,65,20,25,300,1055,480,40,65,1640,670,70,10,10,760,1925,405,50,55,2435
355030866000018,285,61,4,2,352,1945,260,19,6,2230,38,13,4,5,60,211,96,8,13,328,134,14,2,2,152,385,81,10,11,487
355030866000020,285,61,4,2,352,1945,260,19,6,2230,38,13,4,5,60,211,96,8,13,328,134,14,2,2,152,385,81,10,11,487
355030866000022,123,33,0,0,156,903,183,3,3,1092,54,36,9,3,102,162,51,3,12,228,135,9,0,3,147,381,39,12,6,438
355030866000028,41,11,0,0,52,301,61,1,1,364,18,12,3,1,34,54,17,1,4,76,45,3,0,1,49,127,13,4,2,146
355030866000030,451,121,0,0,572,3311,671,11,11,4004,198,132,33,11,374,594,187,11,44,836,495,33,0,11,539,1397,143,44,22,1606
355030866000031,41,11,0,0,52,301,61,1,1,364,18,12,3,1,34,54,17,1,4,76,45,3,0,1,49,127,13,4,2,146
355030866000034,285,61,4,2,352,1945,260,19,6,2230,38,13,4,5,60,211,96,8,13,328,134,14,2,2,152,385,81,10,11,487
355030866000035,285,61,4,2,352,1945,260,19,6,2230,38,13,4,5,60,211,96,8,13,328,134,14,2,2,152,385,81,10,11,487
355030866000037,285,61,4,2,352,1945,260,19,6,2230,38,13,4,5,60,211,96,8,13,328,134,14,2,2,152,385,81,10,11,487
355030866000044,41,11,0,0,52,301,61,1,1,364,18,12,3,1,34,54,17,1,4,76,45,3,0,1,49,127,13,4,2,146
355030866000050,41,11,0,0,52,301,61,1,1,364,18,12,3,1,34,54,17,1,4,76,45,3,0,1,49,127,13,4,2,146
355030866000053,41,11,0,0,52,301,61,1,1,364,18,12,3,1,34,54,17,1,4,76,45,3,0,1,49,127,13,4,2,146
355030866000057,570,122,8,4,704,3890,520,38,12,4460,76,26,8,10,120,422,192,16,26,656,268,28,4,4,304,770,162,20,22,974
355030866000058,855,183,12,6,1056,5835,780,57,18,6690,114,39,12,15,180,633,288,24,39,984,402,42,6,6,456,1155,243,30,33,1461
355030866000060,285,61,4,2,352,1945,260,19,6,2230,38,13,4,5,60,211,96,8,13,328,134,14,2,2,152,385,81,10,11,487
355030866000071,285,61,4,2,352,1945,260,19,6,2230,38,13,4,5,60,211,96,8,13,328,134,14,2,2,152,385,81,10,11,487
355030866000072,570,122,8,4,704,3890,520,38,12,4460,76,26,8,10,120,422,192,16,26,656,268,28,4,4,304,770,162,20,22,974
355030866000084,205,55,0,0,260,1505,305,5,5,1820,90,60,15,5,170,270,85,5,20,380,225,15,0,5,245,635,65,20,10,730
355030866000086,570,122,8,4,704,3890,520,38,12,4460,76,26,8,10,120,422,192,16,26,656,268,28,4,4,304,770,162,20,22,974
355030866000087,285,61,4,2,352,1945,260,19,6,2230,38,13,4,5,60,211,96,8,13,328,134,14,2,2,152,385,81,10,11,487
355030866000098,82,22,0,0,104,602,122,2,2,728,36,24,6,2,68,108,34,2,8,152,90,6,0,2,98,254,26,8,4,292
355030866000099,41,11,0,0,52,301,61,1,1,364,18,12,3,1,34,54,17,1,4,76,45,3,0,1,49,127,13,4,2,146
355030866000102,285,61,4,2,352,1945,260,19,6,2230,38,13,4,5,60,211,96,8,13,328,134,14,2,2,152,385,81,10,11,487
355030866000112,285,61,4,2,352,1945,260,19,6,2230,38,13,4,5,60,211,96,8,13,328,134,14,2,2,152,385,81,10,11,487
355030866000114,570,122,8,4,704,3890,520,38,12,4460,76,26,8,10,120,422,192,16,26,656,268,28,4,4,304,770,162,20,22,974
355030866000134,82,22,0,0,104,602,122,2,2,728,36,24,6,2,68,108,34,2,8,152,90,6,0,2,98,254,26,8,4,292
355030866000135,41,11,0,0,52,301,61,1,1,364,18,12,3,1,34,54,17,1,4,76,45,3,0,1,49,127,13,4,2,146
355030866000136,285,61,4,2,352,1945,260,19,6,2230,38,13,4,5,60,211,96,8,13,328,134,14,2,2,152,385,81,10,11,487
355030867000052,25,4,0,0,29,217,27,0,0,244,7,6,1,0,14,0,3,0,0,3,14,0,0,0,14,18,3,1,1,23
355030867000108,50,8,0,0,58,434,54,0,0,488,14,12,2,0,28,0,6,0,0,6,28,0,0,0,28,36,6,2,2,46
355030868000054,14,7,1,1,23,99,12,0,0,111,4,2,0,0,6,3,0,0,1,4,4,0,0,0,4,23,4,2,0,29
355030868000072,18,3,0,0,21,137,18,3,0,158,8,4,1,1,14,2,2,0,0,4,12,0,0,0,12,16,2,0,0,18
355030868000197,70,24,3,0,97,403,60,3,1,467,23,12,4,0,39,17,7,0,0,24,21,2,0,0,23,44,8,0,0,52
355030868000250,8,2,0,0,10,142,4,0,0,146,2,6,0,0,8,0,0,0,0,0,10,2,0,4,16,20,2,0,0,22
355030868000270,4,1,0,0,5,71,2,0,0,73,1,3,0,0,4,0,0,0,0,0,5,1,0,2,8,10,1,0,0,11
355030869000003,150,72,6,0,228,1188,210,15,15,1428,42,21,18,6,87,87,48,18,6,159,87,12,9,6,114,291,39,6,3,339
355030869000005,50,24,2,0,76,396,70,5,5,476,14,7,6,2,29,29,16,6,2,53,29,4,3,2,38,97,13,2,1,113
355030869000006,65,25,0,1,91,257,60,2,2,321,8,8,0,2,18,46,4,0,0,50,32,3,1,3,39,55,28,2,3,88
355030869000008,65,25,0,1,91,257,60,2,2,321,8,8,0,2,18,46,4,0,0,50,32,3,1,3,39,55,28,2,3,88
355030869000019,50,24,2,0,76,396,70,5,5,476,14,7,6,2,29,29,16,6,2,53,29,4,3,2,38,97,13,2,1,113
355030869000020,150,72,6,0,228,1188,210,15,15,1428,42,21,18,6,87,87,48,18,6,159,87,12,9,6,114,291,39,6,3,339
355030869000021,50,24,2,0,76,396,70,5,5,476,14,7,6,2,29,29,16,6,2,53,29,4,3,2,38,97,13,2,1,113
355030869000035,65,25,0,1,91,257,60,2,2,321,8,8,0,2,18,46,4,0,0,50,32,3,1,3,39,55,28,2,3,88
355030869000036,65,25,0,1,91,257,60,2,2,321,8,8,0,2,18,46,4,0,0,50,32,3,1,3,39,55,28,2,3,88
355030869000038,65,25,0,1,91,257,60,2,2,321,8,8,0,2,18,46,4,0,0,50,32,3,1,3,39,55,28,2,3,88
355030869000043,130,50,0,2,182,514,120,4,4,642,16,16,0,4,36,92,8,0,0,100,64,6,2,6,78,110,56,4,6,176
355030869000044,65,25,0,1,91,257,60,2,2,321,8,8,0,2,18,46,4,0,0,50,32,3,1,3,39,55,28,2,3,88
355030869000047,50,24,2,0,76,396,70,5,5,476,14,7,6,2,29,29,16,6,2,53,29,4,3,2,38,97,13,2,1,113
355030869000055,100,48,4,0,152,792,140,10,10,952,28,14,12,4,58,58,32,12,4,106,58,8,6,4,76,194,26,4,2,226
355030869000061,50,24,2,0,76,396,70,5,5,476,14,7,6,2,29,29,16,6,2,53,29,4,3,2,38,97,13,2,1,113
355030869000065,50,24,2,0,76,396,70,5,5,476,14,7,6,2,29,29,16,6,2,53,29,4,3,2,38,97,13,2,1,113
355030869000069,50,24,2,0,76,396,70,5,5,476,14,7,6,2,29,29,16,6,2,53,29,4,3,2,38,97,13,2,1,113
355030869000076,50,24,2,0,76,396,70,5,5,476,14,7,6,2,29,29,16,6,2,53,29,4,3,2,38,97,13,2,1,113
355030869000079,23,8,0,0,31,137,24,3,2,166,12,11,5,2,30,9,3,0,0,12,131,4,1,1,137,40,7,0,1,48
355030869000094,65,25,0,1,91,257,60,2,2,321,8,8,0,2,18,46,4,0,0,50,32,3,1,3,39,55,28,2,3,88
355030869000095,65,25,0,1,91,257,60,2,2,321,8,8,0,2,18,46,4,0,0,50,32,3,1,3,39,55,28,2,3,88
355030869000096,65,25,0,1,91,257,60,2,2,321,8,8,0,2,18,46,4,0,0,50,32,3,1,3,39,55,28,2,3,88
355030869000098,150,72,6,0,228,1188,210,15,15,1428,42,21,18,6,87,87,48,18,6,159,87,12,9,6,114,291,39,6,3,339
355030869000100,250,120,10,0,380,1980,350,25,25,2380,70,35,30,10,145,145,80,30,10,265,145,20,15,10,190,485,65,10,5,565
355030869000103,50,24,2,0,76,396,70,5,5,476,14,7,6,2,29,29,16,6,2,53,29,4,3,2,38,97,13,2,1,113
355030869000105,50,24,2,0,76,396,70,5,5,476,14,7,6,2,29,29,16,6,2,53,29,4,3,2,38,97,13,2,1,113
355030869000106,50,24,2,0,76,396,70,5,5,476,14,7,6,2,29,29,16,6,2,53,29,4,3,2,38,97,13,2,1,113
355030869000108,100,48,4,0,152,792,140,10,10,952,28,14,12,4,58,58,32,12,4,106,58,8,6,4,76,194,26,4,2,226
355030869000146,65,25,0,1,91,257,60,2,2,321,8,8,0,2,18,46,4,0,0,50,32,3,1,3,39,55,28,2,3,88
355030869000160,50,24,2,0,76,396,70,5,5,476,14,7,6,2,29,29,16,6,2,53,29,4,3,2,38,97,13,2,1,113
355030870000006,98,15,1,0,114,703,157,20,4,884,58,20,5,2,85,82,27,2,1,112,296,14,5,4,319,149,38,5,4,196
355030870000008,48,8,0,0,56,357,52,2,4,415,31,14,3,1,49,26,16,1,0,43,136,6,2,1,145,79,13,1,0,93
355030870000015,48,8,0,0,56,357,52,2,4,415,31,14,3,1,49,26,16,1,0,43,136,6,2,1,145,79,13,1,0,93
355030870000026,98,15,1,0,114,703,157,20,4,884,58,20,5,2,85,82,27,2,1,112,296,14,5,4,319,149,38,5,4,196
355030870000027,98,15,1,0,114,703,157,20,4,884,58,20,5,2,85,82,27,2,1,112,296,14,5,4,319,149,38,5,4,196
355030870000041,98,15,1,0,114,703,157,20,4,884,58,20,5,2,85,82,27,2,1,112,296,14,5,4,319,149,38,5,4,196
355030870000047,98,15,1,0,114,703,157,20,4,884,58,20,5,2,85,82,27,2,1,112,296,14,5,4,319,149,38,5,4,196
355030870000058,392,60,4,0,456,2812,628,80,16,3536,232,80,20,8,340,328,108,8,4,448,1184,56,20,16,1276,596,152,20,16,784
355030870000059,98,15,1,0,114,703,157,20,4,884,58,20,5,2,85,82,27,2,1,112,296,14,5,4,319,149,38,5,4,196
355030870000060,392,60,4,0,456,2812,628,80,16,3536,232,80,20,8,340,328,108,8,4,448,1184,56,20,16,1276,596,152,20,16,784
355030870000083,196,30,2,0,228,1406,314,40,8,1768,116,40,10,4,170,164,54,4,2,224,592,28,10,8,638,298,76,10,8,392
355030870000085,98,15,1,0,114,703,157,20,4,884,58,20,5,2,85,82,27,2,1,112,296,14,5,4,319,149,38,5,4,196
355030870000126,196,30,2,0,228,1406,314,40,8,1768,116,40,10,4,170,164,54,4,2,224,592,28,10,8,638,298,76,10,8,392
355030871000021,62,15,7,4,88,823,199,16,9,1047,47,26,1,8,82,36,41,1,4,82,194,29,3,5,231,117,18,2,4,141
355030871000028,310,75,35,20,440,4115,995,80,45,5235,235,130,5,40,410,180,205,5,20,410,970,145,15,25,1155,585,90,10,20,705
355030871000031,124,30,14,8,176,1646,398,32,18,2094,94,52,2,16,164,72,82,2,8,164,388,58,6,10,462,234,36,4,8,282
355030871000033,348,116,16,26,506,2112,596,26,22,2756,120,64,22,14,220,98,60,4,10,172,382,36,0,4,422,380,104,16,16,516
355030871000035,348,116,16,26,506,2112,596,26,22,2756,120,64,22,14,220,98,60,4,10,172,382,36,0,4,422,380,104,16,16,516
355030871000059,62,15,7,4,88,823,199,16,9,1047,47,26,1,8,82,36,41,1,4,82,194,29,3,5,231,117,18,2,4,141
355030871000063,174,58,8,13,253,1056,298,13,11,1378,60,32,11,7,110,49,30,2,5,86,191,18,0,2,211,190,52,8,8,258
355030871000067,174,58,8,13,253,1056,298,13,11,1378,60,32,11,7,110,49,30,2,5,86,191,18,0,2,211,190,52,8,8,258
355030871000072,174,58,8,13,253,1056,298,13,11,1378,60,32,11,7,110,49,30,2,5,86,191,18,0,2,211,190,52,8,8,258
355030871000073,3480,1160,160,260,5060,21120,5960,260,220,27560,1200,640,220,140,2200,980,600,40,100,1720,3820,360,0,40,4220,3800,1040,160,160,5160
355030871000089,696,232,32,52,1012,4224,1192,52,44,5512,240,128,44,28,440,196,120,8,20,344,764,72,0,8,844,760,208,32,32,1032
355030871000090,174,58,8,13,253,1056,298,13,11,1378,60,32,11,7,110,49,30,2,5,86,191,18,0,2,211,190,52,8,8,258
355030871000092,174,58,8,13,253,1056,298,13,11,1378,60,32,11,7,110,49,30,2,5,86,191,18,0,2,211,190,52,8,8,258
355030871000099,174,58,8,13,253,1056,298,13,11,1378,60,32,11,7,110,49,30,2,5,86,191,18,0,2,211,190,52,8,8,258
355030871000122,186,45,21,12,264,2469,597,48,27,3141,141,78,3,24,246,108,123,3,12,246,582,87,9,15,693,351,54,6,12,423
355030872000014,36,11,0,0,47,251,45,1,0,297,10,3,0,0,13,7,6,0,0,13,26,2,0,0,28,34,6,0,0,40
355030873000136,46,7,2,4,59,239,39,2,2,282,10,8,4,0,22,9,4,0,1,14,21,1,0,0,22,26,3,3,4,36
355030874000094,78,24,3,3,108,1653,312,51,6,2022,90,54,18,0,162,66,42,3,3,114,396,27,3,3,429,123,18,6,3,150
355030874000134,26,8,1,1,36,551,104,17,2,674,30,18,6,0,54,22,14,1,1,38,132,9,1,1,143,41,6,2,1,50
355030875000202,14,0,0,0,14,146,12,2,0,160,8,6,0,0,14,0,2,0,0,2,2,0,0,0,2,8,2,0,0,10
355030876000027,28,8,0,1,37,216,22,1,1,240,10,5,0,0,15,3,2,0,1,6,7,3,0,0,10,24,3,0,0,27
355030876000170,14,2,0,0,16,218,38,4,0,260,12,4,2,0,18,2,2,0,0,4,10,2,0,4,16,8,2,0,0,10
355030876000182,14,2,0,0,16,218,38,4,0,260,12,4,2,0,18,2,2,0,0,4,10,2,0,4,16,8,2,0,0,10
355030877000057,40,19,4,1,64,132,32,3,3,170,11,11,0,1,23,19,3,0,0,22,47,1,0,0,48,39,8,3,1,51
355030877000065,30,11,0,0,41,157,40,4,3,204,7,9,0,1,17,34,17,0,4,55,58,5,1,1,65,39,9,3,1,52
355030877000154,30,11,0,0,41,157,40,4,3,204,7,9,0,1,17,34,17,0,4,55,58,5,1,1,65,39,9,3,1,52
355030878000001,8685,1845,54,27,10611,20151,2880,189,72,23292,477,144,9,54,684,1197,981,90,189,2457,693,36,9,18,756,2322,315,36,36,2709
355030878000002,1930,410,12,6,2358,4478,640,42,16,5176,106,32,2,12,152,266,218,20,42,546,154,8,2,4,168,516,70,8,8,602
355030878000003,2895,615,18,9,3537,6717,960,63,24,7764,159,48,3,18,228,399,327,30,63,819,231,12,3,6,252,774,105,12,12,903
355030878000004,2895,615,18,9,3537,6717,960,63,24,7764,159,48,3,18,228,399,327,30,63,819,231,12,3,6,252,774,105,12,12,903
355030878000005,4825,1025,30,15,5895,11195,1600,105,40,12940,265,80,5,30,380,665,545,50,105,1365,385,20,5,10,420,1290,175,20,20,1505
355030878000006,12545,2665,78,39,15327,29107,4160,273,104,33644,689,208,13,78,988,1729,1417,130,273,3549,1001,52,13,26,1092,3354,455,52,52,3913
355030878000007,5790,1230,36,18,7074,13434,1920,126,48,15528,318,96,6,36,456,798,654,60,126,1638,462,24,6,12,504,1548,210,24,24,1806
355030878000010,965,205,6,3,1179,2239,320,21,8,2588,53,16,1,6,76,133,109,10,21,273,77,4,1,2,84,258,35,4,4,301
355030878000033,1930,410,12,6,2358,4478,640,42,16,5176,106,32,2,12,152,266,218,20,42,546,154,8,2,4,168,516,70,8,8,602
355030878000035,965,205,6,3,1179,2239,320,21,8,2588,53,16,1,6,76,133,109,10,21,273,77,4,1,2,84,258,35,4,4,301
355030879000009,112,42,2,3,159,523,124,9,4,660,24,15,2,1,42,31,16,1,0,48,44,3,0,1,48,126,24,5,4,159
355030879000013,112,42,2,3,159,523,124,9,4,660,24,15,2,1,42,31,16,1,0,48,44,3,0,1,48,126,24,5,4,159
355030879000023,224,84,4,6,318,1046,248,18,8,1320,48,30,4,2,84,62,32,2,0,96,88,6,0,2,96,252,48,10,8,318
355030879000028,448,168,8,12,636,2092,496,36,16,2640,96,60,8,4,168,124,64,4,0,192,176,12,0,4,192,504,96,20,16,636
355030880000020,94,20,3,0,117,783,157,8,6,954,64,24,3,2,93,58,32,0,0,90,277,21,1,2,301,115,15,2,1,133
355030880000021,288,126,9,9,432,1575,327,18,15,1935,123,63,9,12,207,111,48,3,0,162,357,36,6,6,405,297,69,12,3,381
355030880000026,96,42,3,3,144,525,109,6,5,645,41,21,3,4,69,37,16,1,0,54,119,12,2,2,135,99,23,4,1,127
355030880000030,96,42,3,3,144,525,109,6,5,645,41,21,3,4,69,37,16,1,0,54,119,12,2,2,135,99,23,4,1,127
355030880000037,94,20,3,0,117,783,157,8,6,954,64,24,3,2,93,58,32,0,0,90,277,21,1,2,301,115,15,2,1,133
355030880000052,96,42,3,3,144,525,109,6,5,645,41,21,3,4,69,37,16,1,0,54,119,12,2,2,135,99,23,4,1,127
355030880000055,96,42,3,3,144,525,109,6,5,645,41,21,3,4,69,37,16,1,0,54,119,12,2,2,135,99,23,4,1,127
355030880000068,188,40,6,0,234,1566,314,16,12,1908,128,48,6,4,186,116,64,0,0,180,554,42,2,4,602,230,30,4,2,266
355030880000069,282,60,9,0,351,2349,471,24,18,2862,192,72,9,6,279,174,96,0,0,270,831,63,3,6,903,345,45,6,3,399
355030880000072,846,180,27,0,1053,7047,1413,72,54,8586,576,216,27,18,837,522,288,0,0,810,2493,189,9,18,2709,1035,135,18,9,1197
355030880000073,480,210,15,15,720,2625,545,30,25,3225,205,105,15,20,345,185,80,5,0,270,595,60,10,10,675,495,115,20,5,635
355030880000081,96,42,3,3,144,525,109,6,5,645,41,21,3,4,69,37,16,1,0,54,119,12,2,2,135,99,23,4,1,127
355030880000086,46,15,1,0,62,319,42,3,1,365,38,9,0,3,50,31,7,0,0,38,153,13,0,5,171,55,12,2,2,71
355030880000094,94,20,3,0,117,783,157,8,6,954,64,24,3,2,93,58,32,0,0,90,277,21,1,2,301,115,15,2,1,133
355030880000128,96,42,3,3,144,525,109,6,5,645,41,21,3,4,69,37,16,1,0,54,119,12,2,2,135,99,23,4,1,127
355030881000090,23,2,0,0,25,261,48,7,2,318,9,13,1,0,23,15,7,0,0,22,21,1,0,2,24,49,5,0,1,55
355030881000093,23,2,0,0,25,261,48,7,2,318,9,13,1,0,23,15,7,0,0,22,21,1,0,2,24,49,5,0,1,55
355030882000005,32,3,1,0,36,234,45,2,0,281,18,9,2,1,30,12,8,0,0,20,33,4,0,1,38,41,2,0,1,44
355030882000048,24,7,0,0,31,388,83,6,3,480,25,15,2,2,44,27,12,0,0,39,51,5,0,1,57,47,5,1,0,53
355030882000126,24,7,0,0,31,388,83,6,3,480,25,15,2,2,44,27,12,0,0,39,51,5,0,1,57,47,5,1,0,53
355030883000024,308,33,11,0,352,2464,605,22,55,3146,231,165,22,22,440,220,99,11,0,330,495,22,33,22,572,473,55,11,22,561
355030883000193,28,3,1,0,32,224,55,2,5,286,21,15,2,2,40,20,9,1,0,30,45,2,3,2,52,43,5,1,2,51
355030884000107,28,4,0,0,32,302,40,0,2,344,8,8,0,0,16,4,2,0,0,6,4,0,0,0,4,24,6,0,0,30
355030884000142,15,3,1,0,19,202,39,4,6,251,10,10,0,0,20,5,0,0,0,5,10,0,0,0,10,14,3,0,0,17
355030884000193,15,3,1,0,19,202,39,4,6,251,10,10,0,0,20,5,0,0,0,5,10,0,0,0,10,14,3,0,0,17
355030885000015,162,36,0,0,198,1005,159,6,6,1176,24,18,6,0,48,42,18,0,0,60,63,0,0,3,66,111,6,0,0,117
355030885000071,74,11,3,0,88,680,163,15,1,859,36,27,7,0,70,37,23,1,0,61,92,2,2,2,98,61,12,3,2,78
355030885000099,814,121,33,0,968,7480,1793,165,11,9449,396,297,77,0,770,407,253,11,0,671,1012,22,22,22,1078,671,132,33,22,858
355030885000113,74,11,3,0,88,680,163,15,1,859,36,27,7,0,70,37,23,1,0,61,92,2,2,2,98,61,12,3,2,78
355030886000008,98,23,6,6,133,584,182,22,15,803,10,7,1,2,20,19,13,0,0,32,27,2,0,0,29,140,67,11,13,231
355030886000031,1176,276,72,72,1596,7008,2184,264,180,9636,120,84,12,24,240,228,156,0,0,384,324,24,0,0,348,1680,804,132,156,2772
355030886000054,44,2,0,0,46,384,54,4,0,442,14,18,2,0,34,28,0,0,0,28,18,6,2,0,26,46,6,0,0,52
355030887000129,46,4,0,0,50,322,36,0,0,358,6,0,0,0,6,4,0,0,0,4,8,0,0,0,8,30,4,0,2,36
355030888000003,706,200,26,22,954,586,131,24,17,758,37,24,3,4,68,29,24,0,2,55,62,3,1,0,66,115,39,13,16,183
355030888000018,706,200,26,22,954,586,131,24,17,758,37,24,3,4,68,29,24,0,2,55,62,3,1,0,66,115,39,13,16,183
355030888000029,706,200,26,22,954,586,131,24,17,758,37,24,3,4,68,29,24,0,2,55,62,3,1,0,66,115,39,13,16,183
355030889000098,29,6,0,0,35,199,34,0,0,233,9,8,0,1,18,10,3,0,0,13,23,1,0,1,25,42,1,1,0,44
355030890000012,126,40,2,4,172,1054,158,8,4,1224,96,52,12,14,174,68,38,2,0,108,422,54,4,12,492,194,40,8,6,248
355030890000029,126,40,2,4,172,1054,158,8,4,1224,96,52,12,14,174,68,38,2,0,108,422,54,4,12,492,194,40,8,6,248
355030890000034,63,20,1,2,86,527,79,4,2,612,48,26,6,7,87,34,19,1,0,54,211,27,2,6,246,97,20,4,3,124
355030890000056,84,21,1,1,107,389,82,4,5,480,49,32,2,6,89,42,21,2,2,67,490,27,4,21,542,101,15,4,0,120
355030890000058,168,42,2,2,214,778,164,8,10,960,98,64,4,12,178,84,42,4,4,134,980,54,8,42,1084,202,30,8,0,240
355030890000065,63,20,1,2,86,527,79,4,2,612,48,26,6,7,87,34,19,1,0,54,211,27,2,6,246,97,20,4,3,124
355030890000074,63,20,1,2,86,527,79,4,2,612,48,26,6,7,87,34,19,1,0,54,211,27,2,6,246,97,20,4,3,124
355030890000101,126,40,2,4,172,1054,158,8,4,1224,96,52,12,14,174,68,38,2,0,108,422,54,4,12,492,194,40,8,6,248
355030890000120,924,231,11,11,1177,4279,902,44,55,5280,539,352,22,66,979,462,231,22,22,737,5390,297,44,231,5962,1111,165,44,0,1320
355030890000123,168,42,2,2,214,778,164,8,10,960,98,64,4,12,178,84,42,4,4,134,980,54,8,42,1084,202,30,8,0,240
355030890000124,84,21,1,1,107,389,82,4,5,480,49,32,2,6,89,42,21,2,2,67,490,27,4,21,542,101,15,4,0,120
355030890000125,63,20,1,2,86,527,79,4,2,612,48,26,6,7,87,34,19,1,0,54,211,27,2,6,246,97,20,4,3,124
355030890000148,84,21,1,1,107,389,82,4,5,480,49,32,2,6,89,42,21,2,2,67,490,27,4,21,542,101,15,4,0,120
355030890000153,63,20,1,2,86,527,79,4,2,612,48,26,6,7,87,34,19,1,0,54,211,27,2,6,246,97,20,4,3,124
355030890000175,84,21,1,1,107,389,82,4,5,480,49,32,2,6,89,42,21,2,2,67,490,27,4,21,542,101,15,4,0,120
355030890000197,948,360,132,36,1476,2832,480,60,48,3420,384,240,60,0,684,768,456,96,204,1524,2820,216,48,72,3156,1116,396,72,12,1596
355030890000199,79,30,11,3,123,236,40,5,4,285,32,20,5,0,57,64,38,8,17,127,235,18,4,6,263,93,33,6,1,133
355030890000223,84,21,1,1,107,389,82,4,5,480,49,32,2,6,89,42,21,2,2,67,490,27,4,21,542,101,15,4,0,120
355030893000064,81,19,2,0,102,425,80,7,3,515,25,10,2,2,39,42,9,0,0,51,47,3,1,1,52,59,20,1,0,80
355030893000151,81,19,2,0,102,425,80,7,3,515,25,10,2,2,39,42,9,0,0,51,47,3,1,1,52,59,20,1,0,80
355030893000158,810,190,20,0,1020,4250,800,70,30,5150,250,100,20,20,390,420,90,0,0,510,470,30,10,10,520,590,200,10,0,800
355030894000003,51,11,0,0,62,463,82,7,4,556,29,23,6,1,59,13,5,0,0,18,51,1,0,1,53,52,14,2,2,70
355030894000036,64,32,8,16,120,1184,248,16,0,1448,64,32,0,0,96,32,8,0,0,40,32,0,0,0,32,176,16,0,0,192
355030894000048,25,6,0,0,31,207,31,3,2,243,15,3,1,2,21,12,5,0,0,17,39,5,0,0,44,33,6,1,0,40
355030894000096,153,33,0,0,186,1389,246,21,12,1668,87,69,18,3,177,39,15,0,0,54,153,3,0,3,159,156,42,6,6,210
355030895000076,38,30,2,6,76,234,60,4,10,308,12,4,4,0,20,2,2,0,0,4,10,0,0,0,10,96,32,12,14,154
355030895000104,48,16,1,1,66,353,59,3,1,416,20,27,1,0,48,10,5,0,0,15,40,0,0,0,40,59,13,2,2,76
355030896000005,3,0,0,1,4,109,14,0,3,126,3,4,0,1,8,4,0,0,0,4,4,0,0,0,4,14,0,0,0,14
355030896000087,24,2,0,0,26,438,60,4,2,504,14,26,0,2,42,2,0,0,0,2,22,0,0,2,24,26,6,4,2,38
355030896000121,10,2,0,0,12,102,10,0,0,112,0,2,0,0,,0,0,0,0,0,2,0,0,0,2,10,0,0,0,10
