Cod_setor,Situacao_setor,01_15,16_21,22_30,31_45,45_60,target
355030801000001,1,94,74,165,165,186,516
355030801000002,1,155,62,211,211,170,592
355030801000003,1,94,36,140,140,129,409
355030801000004,1,73,57,130,130,109,369
355030801000005,1,99,78,172,172,118,462
355030801000006,1,89,40,132,132,119,383
355030801000007,1,102,54,158,158,137,453
355030801000008,1,120,77,184,184,141,509
355030801000009,1,107,56,138,138,123,399
355030801000010,1,86,45,135,135,141,411
355030801000011,1,101,39,171,171,139,481
355030801000012,1,94,76,168,168,185,521
355030801000013,1,97,39,165,165,115,445
355030801000014,1,158,80,234,234,184,652
355030801000015,1,96,60,124,124,151,399
355030801000016,1,77,42,112,112,87,311
355030801000017,1,81,53,131,131,121,383
355030801000018,1,122,51,162,162,146,470
355030801000019,1,143,71,179,179,162,520
355030801000020,1,113,65,158,158,142,458
355030801000021,1,104,62,194,194,156,544
355030801000022,1,90,56,146,146,153,445
355030801000023,1,83,42,123,123,131,377
355030801000024,1,100,30,140,140,109,389
355030801000025,1,127,73,182,182,167,531
355030801000026,1,60,35,133,133,113,379
355030801000027,1,109,76,229,229,198,656
355030801000028,1,55,29,101,101,96,298
355030801000029,1,107,78,147,147,123,417
355030801000030,1,80,60,139,139,131,409
355030801000031,1,65,63,130,130,181,441
355030801000032,1,77,45,125,125,141,391
355030801000033,1,80,45,129,129,152,410
355030801000034,1,76,49,111,111,145,367
355030801000035,1,108,75,170,170,168,508
355030801000036,1,133,74,157,157,148,462
355030801000037,1,132,82,186,186,202,574
355030801000038,1,104,66,159,159,145,463
355030801000039,1,151,75,176,176,181,533
355030801000040,1,147,69,180,180,148,508
355030801000041,1,105,61,218,218,226,662
355030801000042,1,62,25,92,92,93,277
355030801000043,1,132,64,148,148,135,431
355030801000044,1,148,65,196,196,171,563
355030801000045,1,50,27,79,79,70,228
355030801000046,1,82,54,157,157,161,475
355030801000047,1,86,50,159,159,163,481
355030801000048,1,86,31,100,100,87,287
355030801000049,1,91,38,157,157,116,430
355030801000050,1,81,52,129,129,185,443
355030801000051,1,86,78,170,170,142,482
355030801000052,1,61,39,102,102,105,309
355030801000053,1,72,44,172,172,124,468
355030801000054,1,78,49,132,132,164,428
355030801000055,1,92,61,250,250,187,687
355030801000056,1,66,33,139,139,98,376
355030801000057,1,107,73,180,180,164,524
355030801000058,1,94,49,133,133,135,401
355030801000059,1,109,63,161,161,170,492
355030801000060,1,31,11,32,32,22,86
355030801000061,1,62,28,92,92,82,266
355030801000062,1,206,104,356,356,286,998
355030801000063,1,56,35,94,94,61,249
355030801000064,1,59,34,78,78,84,240
355030801000065,1,78,36,211,211,93,515
355030801000066,1,58,39,110,110,100,320
355030801000067,1,91,59,136,136,131,403
355030801000068,1,94,69,171,171,186,528
355030801000069,1,70,56,126,126,157,409
355030801000070,1,107,56,189,189,192,570
355030801000071,1,160,82,352,352,240,944
355030801000072,1,66,54,119,119,152,390
355030801000073,1,107,59,127,127,116,370
355030801000074,1,86,36,154,154,125,433
355030801000075,1,105,63,175,175,180,530
355030801000076,1,146,66,325,325,212,862
355030801000077,1,128,49,176,176,143,495
355030801000078,1,62,41,93,93,100,286
355030801000079,1,46,37,85,85,93,263
355030801000080,1,137,51,303,303,151,757
355030801000081,1,137,76,264,264,191,719
355030801000082,1,135,58,291,291,200,782
355030801000083,1,159,68,400,400,194,994
355030801000084,1,65,35,82,82,82,246
355030801000085,1,80,47,134,134,125,393
355030801000086,1,92,46,156,156,159,471
355030801000087,1,98,55,190,190,193,573
355030801000088,1,83,37,119,119,121,359
355030801000089,1,37,33,69,69,96,234
355030801000090,1,75,37,96,96,81,273
355030801000091,1,64,36,104,104,111,319
355030801000092,1,77,36,124,124,93,341
355030801000093,1,72,34,106,106,93,305
355030801000094,1,81,45,162,162,153,477
355030801000095,1,76,44,173,173,153,499
355030801000096,1,59,30,93,93,94,280
355030801000097,1,41,27,64,64,79,207
355030801000098,1,84,45,132,132,140,404
355030801000099,1,61,34,101,101,96,298
355030801000100,1,51,41,149,149,125,423
355030801000101,1,115,49,166,166,136,468
355030801000102,1,80,29,156,156,131,443
355030801000103,1,46,22,68,68,91,227
355030801000104,1,115,48,210,210,155,575
355030801000105,1,29,17,43,43,38,124
355030801000106,1,83,39,117,117,123,357
355030801000107,1,33,17,68,68,65,201
355030801000108,1,83,40,149,149,124,422
355030801000109,1,72,44,100,100,112,312
355030801000110,1,72,54,123,123,172,418
355030801000111,1,75,49,154,154,182,490
355030801000112,1,50,35,73,73,99,245
355030801000113,1,100,39,103,103,114,320
355030801000114,1,30,25,66,66,95,227
355030801000115,1,19,10,43,43,41,127
355030801000116,1,41,33,83,83,99,265
355030801000117,1,50,31,100,100,118,318
355030801000118,1,39,34,86,86,107,279
355030801000119,1,131,65,194,194,185,573
355030801000120,1,94,73,169,169,202,540
355030801000121,1,112,66,183,183,181,547
355030801000122,1,82,59,130,130,175,435
355030801000123,1,47,19,67,67,46,180
355030801000124,1,34,34,69,69,54,192
355030801000125,1,86,43,119,119,98,336
355030801000126,1,113,69,260,260,148,668
355030801000127,1,80,44,140,140,88,368
355030801000128,1,96,41,177,177,101,455
355030801000129,1,33,26,74,74,48,196
355030801000130,1,54,30,126,126,105,357
355030802000001,1,52,46,90,90,126,306
355030802000002,1,62,29,95,95,105,295
355030802000003,1,60,48,120,120,149,389
355030802000004,1,54,26,115,115,110,340
355030802000005,1,73,42,153,153,171,477
355030802000006,1,60,52,135,135,152,422
355030802000007,1,93,45,149,149,122,420
355030802000008,1,98,69,160,160,221,541
355030802000009,1,60,45,137,137,122,396
355030802000010,1,82,48,154,154,183,491
355030802000011,1,93,45,128,128,153,409
355030802000012,1,42,26,85,85,94,264
355030802000013,1,117,56,201,201,211,613
355030802000014,1,44,32,58,58,89,205
355030802000015,1,56,23,79,79,110,268
355030802000016,1,46,32,82,82,83,247
355030802000017,1,94,56,172,172,177,521
355030802000018,1,151,61,247,247,205,699
355030802000019,1,85,49,163,163,141,467
355030802000020,1,54,35,118,118,91,327
355030802000021,1,37,33,97,97,90,284
355030802000022,1,78,34,107,107,134,348
355030802000023,1,87,36,124,124,136,384
355030802000024,1,34,32,98,98,96,292
355030802000025,1,57,46,127,127,124,378
355030802000026,1,57,38,141,141,139,421
355030802000027,1,80,58,150,150,166,466
355030802000028,1,28,17,79,79,94,252
355030802000029,1,27,24,119,119,101,339
355030802000030,1,24,19,69,69,69,207
355030802000031,1,91,71,186,186,188,560
355030802000033,1,21,15,72,72,50,194
355030802000034,1,29,30,116,116,87,319
355030802000035,1,37,32,113,113,135,361
355030802000036,1,78,42,136,136,188,460
355030802000037,1,111,59,184,184,189,557
355030802000038,1,67,36,99,99,120,318
355030802000039,1,52,34,64,64,104,232
355030802000040,1,17,18,42,42,58,142
355030802000041,1,54,29,103,103,104,310
355030802000042,1,76,47,105,105,147,357
355030802000043,1,94,83,196,196,231,623
355030802000044,1,71,39,95,95,126,316
355030802000045,1,77,29,126,126,126,378
355030802000046,1,27,19,81,81,67,229
355030802000047,1,147,48,231,231,171,633
355030802000048,1,55,60,94,94,145,333
355030802000049,1,40,33,95,95,103,293
355030802000050,1,51,32,148,148,85,381
355030802000051,1,61,59,153,153,154,460
355030802000052,1,33,16,108,108,102,318
355030802000053,1,14,18,35,35,62,132
355030802000054,1,83,36,154,154,126,434
355030802000055,1,44,37,178,178,116,472
355030802000056,1,33,48,131,131,134,396
355030802000057,1,34,46,142,142,110,394
355030802000058,1,87,53,198,198,198,594
355030802000059,1,66,40,131,131,123,385
355030802000060,1,75,35,89,89,145,323
355030802000061,1,95,50,124,124,119,367
355030802000062,1,82,68,98,98,122,318
355030802000063,1,29,32,99,99,62,260
355030802000064,1,100,62,186,186,152,524
355030802000065,1,63,35,161,161,92,414
355030802000066,1,61,32,110,110,94,314
355030802000067,1,85,45,96,96,119,311
355030802000068,1,73,50,154,154,143,451
355030802000069,1,30,18,59,59,55,173
355030802000070,1,53,37,96,96,80,272
355030802000071,1,18,20,80,80,55,215
355030802000072,1,71,41,133,133,120,386
355030802000073,1,87,49,102,102,91,295
355030802000074,1,98,23,175,175,97,447
355030802000075,1,59,44,180,180,116,476
355030802000076,1,84,38,117,117,142,376
355030802000077,1,26,21,102,102,62,266
355030802000078,1,42,29,59,59,85,203
355030802000079,1,23,16,49,49,47,145
355030803000001,1,197,87,216,216,131,563
355030803000002,1,197,100,198,198,99,495
355030803000003,1,177,87,221,221,103,545
355030803000004,1,173,75,195,195,76,466
355030803000005,1,529,235,506,506,217,1229
355030803000006,1,187,96,201,201,108,510
355030803000007,1,422,230,474,474,296,1244
355030803000008,1,206,115,213,213,172,598
355030803000009,1,210,128,233,233,182,648
355030803000010,1,309,177,341,341,250,932
355030803000011,1,350,169,427,427,232,1086
355030803000012,1,215,117,247,247,145,639
355030803000013,1,164,85,184,184,143,511
355030803000014,1,141,93,184,184,165,533
355030803000015,1,120,73,152,152,167,471
355030803000016,1,113,54,131,131,123,385
355030803000017,1,192,102,256,256,232,744
355030803000018,1,201,129,248,248,157,653
355030803000019,1,24,15,27,27,21,75
355030803000020,1,115,83,126,126,68,320
355030803000021,1,192,65,186,186,62,434
355030803000022,1,121,64,124,124,105,353
355030803000023,1,113,50,121,121,108,350
355030803000024,1,210,77,268,268,153,689
355030803000025,1,156,105,199,199,216,614
355030803000026,1,225,96,270,270,167,707
355030803000027,1,18,4,19,19,25,63
355030803000028,1,127,66,149,149,72,370
355030803000029,1,59,16,64,64,28,156
355030803000030,1,374,165,431,431,214,1076
355030803000031,1,171,93,185,185,102,472
355030803000032,1,277,134,307,307,137,751
355030803000033,1,295,99,278,278,98,654
355030803000034,8,0,0,0,0,0,0
355030803000035,1,172,111,236,236,101,573
355030803000036,1,426,177,456,456,224,1136
355030803000037,1,219,132,236,236,204,676
355030803000038,1,321,149,405,405,199,1009
355030803000039,1,217,121,269,269,148,686
355030803000040,1,259,108,288,288,126,702
355030803000041,1,228,79,263,263,164,690
355030803000042,8,140,59,147,147,55,349
355030803000043,8,0,0,0,0,0,0
355030803000044,8,0,0,0,0,0,0
355030803000045,8,16,4,13,13,14,40
355030803000046,8,28,14,20,20,12,52
355030803000047,8,81,31,80,80,33,193
355030803000048,8,96,33,94,94,44,232
355030803000049,8,2,2,6,6,5,17
355030803000050,8,4,4,8,8,13,29
355030803000051,1,55,30,95,95,31,221
355030803000052,1,98,50,116,116,81,313
355030803000053,1,136,63,152,152,90,394
355030803000054,1,165,74,204,204,136,544
355030803000055,1,549,214,553,553,207,1313
355030803000056,2,41,11,43,43,14,100
355030803000057,4,219,101,262,262,98,622
355030803000058,1,56,21,83,83,34,200
355030803000059,4,49,17,53,53,30,136
355030803000060,1,116,38,107,107,38,252
355030803000061,4,407,161,369,369,119,857
355030803000066,8,10,2,10,10,4,24
355030803000067,8,124,54,94,94,26,214
355030803000070,2,26,5,21,21,8,50
355030803000071,2,0,0,0,0,0,0
355030803000073,2,20,20,36,36,17,89
355030803000074,8,37,11,40,40,15,95
355030803000076,1,219,151,280,280,207,767
355030803000077,1,582,225,652,652,203,1507
355030803000078,4,78,29,90,90,30,210
355030803000079,1,426,184,468,468,196,1132
355030803000080,1,143,64,167,167,53,387
355030803000082,2,25,8,26,26,9,61
355030803000083,8,63,27,79,79,30,188
355030803000084,8,17,11,16,16,17,49
355030803000085,2,0,0,0,0,0,0
355030803000086,2,19,4,27,27,10,64
355030803000087,8,5,3,6,6,3,15
355030803000088,8,2,3,4,4,7,15
355030803000089,2,3,1,5,5,4,14
355030803000090,1,24,11,15,15,11,41
355030803000091,2,116,46,130,130,44,304
355030803000093,8,0,0,0,0,0,0
355030803000094,1,204,105,295,295,181,771
355030803000095,2,10,6,18,18,13,49
355030803000096,2,55,25,65,65,35,165
355030803000097,8,4,5,10,10,9,29
355030803000098,8,0,0,0,0,0,0
355030803000100,8,4,4,9,9,4,22
355030803000101,3,290,120,341,341,186,868
355030803000102,2,25,14,43,43,44,130
355030803000103,2,16,1,15,15,14,44
355030803000104,2,9,2,9,9,2,20
355030803000105,1,259,95,302,302,95,699
355030803000106,8,0,0,0,0,0,0
355030803000107,8,48,11,30,30,11,71
355030803000111,1,243,91,290,290,100,680
355030803000112,1,115,42,100,100,31,231
355030803000113,1,54,29,57,57,36,150
355030803000114,1,279,102,359,359,128,846
355030803000115,1,264,120,252,252,84,588
355030803000116,1,133,67,135,135,60,330
355030803000117,1,121,56,108,108,38,254
355030803000118,1,53,35,53,53,18,124
355030803000119,1,168,89,172,172,95,439
355030803000120,1,173,45,124,124,23,271
355030803000121,1,330,119,325,325,137,787
355030804000001,1,113,52,162,162,98,422
355030804000002,1,93,46,125,125,114,364
355030804000003,1,120,41,137,137,92,366
355030804000004,1,135,67,176,176,105,457
355030804000005,1,254,123,283,283,230,796
355030804000006,1,143,51,94,94,47,235
355030804000007,1,60,41,106,106,100,312
355030804000008,1,144,57,179,179,132,490
355030804000009,1,185,68,153,153,56,362
355030804000010,1,116,43,105,105,102,312
355030804000011,1,168,91,217,217,170,604
355030804000012,1,131,54,170,170,126,466
355030804000013,1,129,71,205,205,142,552
355030804000014,1,141,91,235,235,193,663
355030804000015,1,117,59,159,159,147,465
355030804000016,1,60,37,104,104,131,339
355030804000017,1,111,32,122,122,101,345
355030804000018,1,111,79,122,122,122,366
355030804000019,1,322,132,263,263,159,685
355030804000020,1,165,75,194,194,175,563
355030804000021,1,178,77,247,247,207,701
355030804000022,1,147,80,236,236,228,700
355030804000023,1,110,70,169,169,171,509
355030804000024,1,124,69,195,195,164,554
355030804000025,1,224,85,325,325,170,820
355030804000026,1,133,52,221,221,100,542
355030804000027,1,131,68,188,188,166,542
355030804000028,1,158,65,250,250,167,667
355030804000029,1,139,69,189,189,168,546
355030804000030,1,148,98,247,247,210,704
355030804000031,1,153,99,204,204,155,563
355030804000032,1,145,58,162,162,130,454
355030804000033,1,88,55,147,147,108,402
355030804000034,1,80,42,106,106,99,311
355030804000035,1,139,84,229,229,171,629
355030804000036,1,150,85,173,173,206,552
355030804000037,1,328,128,218,218,117,553
355030804000038,1,126,72,160,160,103,423
355030804000039,1,95,60,130,130,105,365
355030804000040,1,54,30,73,73,73,219
355030804000041,1,130,74,184,184,173,541
355030804000042,1,106,69,183,183,182,548
355030804000043,1,78,36,116,116,102,334
355030804000044,1,56,43,99,99,143,341
355030804000045,1,58,46,123,123,111,357
355030804000046,1,117,54,154,154,182,490
355030804000047,1,75,31,111,111,89,311
355030804000048,1,65,41,92,92,96,280
355030804000049,1,84,36,138,138,108,384
355030804000050,1,119,46,192,192,128,512
355030804000051,1,96,54,165,165,151,481
355030804000052,1,139,53,207,207,189,603
355030804000053,1,58,17,91,91,59,241
355030804000054,1,165,69,193,193,157,543
355030804000055,1,148,71,168,168,128,464
355030804000056,1,62,49,86,86,85,257
355030804000057,1,94,40,142,142,119,403
355030804000059,1,137,63,169,169,163,501
355030804000060,1,182,62,211,211,163,585
355030804000061,1,86,62,123,123,119,365
355030804000062,1,178,60,436,436,190,1062
355030804000063,1,110,60,189,189,116,494
355030804000064,1,89,57,112,112,153,377
355030804000065,1,67,48,78,78,113,269
355030804000066,1,108,71,172,172,154,498
355030804000067,1,61,44,96,96,135,327
355030804000068,1,120,75,141,141,134,416
355030804000069,1,94,28,112,112,101,325
355030804000070,1,108,60,181,181,162,524
355030804000071,1,122,71,204,204,183,591
355030804000072,1,88,45,131,131,122,384
355030804000073,1,85,47,83,83,81,247
355030804000074,1,70,38,87,87,61,235
355030804000075,1,123,74,151,151,152,454
355030804000076,1,101,57,127,127,102,356
355030804000077,1,117,66,177,177,188,542
355030804000078,1,168,110,240,240,184,664
355030804000079,1,84,43,125,125,109,359
355030804000080,1,129,59,144,144,118,406
355030804000081,1,113,53,153,153,123,429
355030804000082,1,146,87,185,185,174,544
355030804000083,1,99,56,111,111,127,349
355030804000084,1,145,66,149,149,161,459
355030804000085,1,92,58,138,138,106,382
355030804000086,1,149,65,194,194,156,544
355030804000087,1,96,51,104,104,100,308
355030804000088,1,160,63,204,204,176,584
355030804000089,1,67,41,78,78,93,249
355030804000090,1,158,55,162,162,134,458
355030804000091,1,127,61,173,173,105,451
355030804000092,1,113,64,148,148,141,437
355030804000093,1,120,64,150,150,85,385
355030804000094,1,139,67,187,187,140,514
355030804000095,1,124,64,166,166,107,439
355030804000096,1,251,161,248,248,170,666
355030804000097,1,154,64,178,178,109,465
355030804000098,1,105,53,139,139,107,385
355030804000099,1,115,74,163,163,132,458
355030804000100,1,184,90,214,214,180,608
355030804000101,1,105,60,169,169,119,457
355030804000102,1,179,85,278,278,170,726
355030804000103,1,105,61,161,161,126,448
355030804000104,1,236,113,260,260,179,699
355030804000105,1,142,77,108,108,90,306
355030804000106,1,171,117,233,233,167,633
355030804000107,1,169,82,221,221,144,586
355030804000108,1,219,103,253,253,151,657
355030804000109,1,34,15,34,34,31,99
355030804000110,1,106,59,145,145,105,395
355030804000111,1,171,78,240,240,209,689
355030804000112,1,156,53,193,193,245,631
355030804000113,1,153,69,198,198,191,587
355030804000114,1,72,45,110,110,98,318
355030804000115,1,94,52,97,97,68,262
355030804000116,1,86,56,120,120,81,321
355030804000117,1,132,69,153,153,107,413
355030804000118,1,139,65,190,190,132,512
355030804000119,1,88,54,109,109,94,312
355030804000120,1,115,46,147,147,108,402
355030804000121,1,65,43,79,79,91,249
355030804000122,1,116,72,154,154,143,451
355030804000123,1,90,58,140,140,98,378
355030804000124,1,91,26,224,224,66,514
355030804000125,1,9,4,13,13,9,35
355030805000001,1,161,88,173,173,174,520
355030805000002,1,124,49,158,158,91,407
355030805000003,1,88,32,109,109,103,321
355030805000004,1,54,18,62,62,70,194
355030805000005,1,98,52,125,125,104,354
355030805000006,1,156,88,209,209,181,599
355030805000007,1,238,134,303,303,223,829
355030805000008,1,69,43,95,95,84,274
355030805000009,1,44,28,65,65,36,166
355030805000010,1,177,79,146,146,80,372
355030805000011,1,116,53,156,156,94,406
355030805000012,1,115,42,153,153,100,406
355030805000013,1,53,26,81,81,54,216
355030805000014,1,106,49,160,160,106,426
355030805000015,1,91,31,195,195,107,497
355030805000016,1,77,23,119,119,96,334
355030805000017,1,81,64,120,120,115,355
355030805000018,1,144,65,203,203,166,572
355030805000019,1,133,76,172,172,152,496
355030805000020,1,66,42,112,112,88,312
355030805000021,1,98,61,122,122,112,356
355030805000022,1,148,88,218,218,210,646
355030805000023,1,171,89,221,221,223,665
355030805000024,1,124,67,162,162,125,449
355030805000025,1,80,51,105,105,95,305
355030805000026,1,132,85,163,163,134,460
355030805000027,1,147,72,213,213,142,568
355030805000028,1,115,30,203,203,103,509
355030805000029,1,124,49,200,200,117,517
355030805000030,1,88,57,161,161,157,479
355030805000031,1,74,24,118,118,81,317
355030805000032,1,125,75,169,169,138,476
355030805000033,1,88,42,121,121,130,372
355030805000034,1,110,49,188,188,125,501
355030805000035,1,148,81,185,185,158,528
355030805000036,1,103,52,134,134,120,388
355030805000037,1,104,39,138,138,96,372
355030805000038,1,73,38,102,102,64,268
355030805000039,1,91,45,125,125,113,363
355030805000040,1,92,53,160,160,106,426
355030805000041,1,65,37,69,69,83,221
355030805000042,1,99,37,92,92,106,290
355030805000043,1,105,76,170,170,130,470
355030805000044,1,158,74,193,193,128,514
355030805000045,1,148,88,199,199,129,527
355030805000046,1,102,56,152,152,112,416
355030805000047,1,71,56,119,119,104,342
355030805000048,1,87,42,127,127,86,340
355030805000049,1,87,36,135,135,87,357
355030805000050,1,61,33,98,98,78,274
355030805000051,1,188,76,292,292,208,792
355030805000052,1,103,48,169,169,110,448
355030805000053,1,67,25,105,105,82,292
355030805000054,1,79,41,126,126,111,363
355030805000055,1,64,38,127,127,127,381
355030805000056,1,90,43,164,164,138,466
355030805000057,1,152,85,187,187,152,526
355030805000058,1,149,73,171,171,134,476
355030805000059,1,44,34,51,51,49,151
355030805000060,1,112,62,162,162,125,449
355030805000061,1,153,69,160,160,181,501
355030805000062,1,118,77,157,157,137,451
355030805000063,1,152,94,213,213,226,652
355030805000064,1,108,57,166,166,117,449
355030805000065,1,121,73,181,181,129,491
355030805000066,1,80,35,126,126,104,356
355030805000067,1,77,36,99,99,95,293
355030805000068,1,111,63,150,150,135,435
355030805000069,1,183,92,227,227,195,649
355030805000070,1,145,69,204,204,154,562
355030805000071,1,26,12,29,29,15,73
355030805000072,1,96,65,172,172,129,473
355030805000073,1,125,56,180,180,141,501
355030805000074,1,104,58,172,172,200,544
355030805000075,1,198,84,281,281,201,763
355030805000076,1,146,75,193,193,184,570
355030805000077,1,82,36,138,138,128,404
355030805000078,1,108,40,184,184,116,484
355030805000079,1,90,42,139,139,97,375
355030805000080,1,46,27,103,103,74,280
355030805000081,1,100,67,192,192,129,513
355030805000082,1,89,54,135,135,75,345
355030805000083,1,109,60,162,162,123,447
355030805000084,1,93,56,148,148,131,427
355030805000085,1,139,65,180,180,176,536
355030805000086,1,102,70,116,116,154,386
355030805000087,1,72,55,95,95,92,282
355030805000088,1,95,70,124,124,137,385
355030805000089,1,111,72,151,151,175,477
355030805000090,1,117,45,143,143,79,365
355030805000091,1,156,74,213,213,170,596
355030805000092,1,151,57,200,200,179,579
355030805000093,1,114,73,215,215,96,526
355030805000094,1,91,35,173,173,97,443
355030805000095,1,151,72,217,217,143,577
355030805000096,1,137,74,175,175,103,453
355030805000097,1,88,40,171,171,87,429
355030805000098,1,462,200,336,336,148,820
355030805000099,1,207,128,222,222,158,602
355030805000100,1,244,94,243,243,142,628
355030805000101,1,180,69,133,133,65,331
355030805000102,1,219,83,284,284,190,758
355030805000103,1,247,128,275,275,176,726
355030805000104,1,277,140,240,240,152,632
355030805000105,1,265,153,212,212,97,521
355030805000106,1,211,88,143,143,114,400
355030805000107,1,155,68,164,164,109,437
355030805000108,1,86,68,109,109,120,338
355030805000109,1,170,97,215,215,179,609
355030805000110,1,109,73,153,153,136,442
355030805000111,1,139,62,206,206,171,583
355030805000112,1,221,115,192,192,73,457
355030805000113,1,80,50,145,145,135,425
355030805000114,1,70,20,113,113,56,282
355030805000115,1,85,39,161,161,91,413
355030805000116,1,83,34,144,144,110,398
355030805000117,1,86,32,143,143,102,388
355030805000118,1,110,53,183,183,121,487
355030805000119,1,125,64,189,189,134,512
355030805000120,1,130,62,209,209,125,543
355030805000121,1,155,89,216,216,154,586
355030805000122,1,77,53,142,142,70,354
355030805000123,1,141,95,147,147,158,452
355030805000124,1,44,23,62,62,61,185
355030805000125,1,197,104,215,215,167,597
355030805000126,1,130,64,171,171,132,474
355030805000127,1,197,95,283,283,218,784
355030805000128,1,111,54,138,138,102,378
355030805000129,1,99,56,127,127,120,374
355030805000130,1,243,120,263,263,214,740
355030805000131,1,151,70,214,214,166,594
355030805000132,1,173,74,284,284,187,755
355030805000133,1,177,78,291,291,176,758
355030805000134,1,118,84,215,215,165,595
355030805000135,1,69,28,119,119,92,330
355030805000136,1,102,51,164,164,113,441
355030805000137,1,115,38,170,170,111,451
355030805000138,1,130,80,161,161,139,461
355030805000139,1,148,74,211,211,163,585
355030805000140,1,99,53,160,160,109,429
355030805000141,1,138,59,169,169,140,478
355030805000142,1,104,54,168,168,83,419
355030805000143,1,113,87,154,154,136,444
355030805000144,1,66,28,77,77,71,225
355030805000145,1,167,95,202,202,217,621
355030805000146,1,75,42,104,104,102,310
355030805000147,1,48,34,71,71,56,198
355030805000148,1,41,32,78,78,71,227
355030805000149,1,79,40,112,112,73,297
355030806000001,1,0,0,0,0,0,0
355030806000002,1,38,27,105,105,96,306
355030806000003,1,30,20,94,94,60,248
355030806000004,1,32,12,76,76,63,215
355030806000005,1,78,46,232,232,123,587
355030806000006,1,45,20,87,87,77,251
355030806000007,1,112,79,98,98,71,267
355030806000008,1,304,112,214,214,94,522
355030806000009,1,40,19,91,91,76,258
355030806000010,1,54,36,107,107,115,329
355030806000011,1,19,25,57,57,73,187
355030806000012,1,61,27,150,150,118,418
355030806000013,1,35,37,145,145,116,406
355030806000014,1,34,32,90,90,72,252
355030806000015,1,135,90,231,231,285,747
355030806000016,1,34,24,81,81,66,228
355030806000017,1,27,19,53,53,36,142
355030806000018,1,22,31,70,70,100,240
355030806000019,1,61,50,113,113,134,360
355030806000020,1,44,34,125,125,101,351
355030806000021,1,45,42,110,110,96,316
355030806000022,1,42,33,105,105,103,313
355030806000023,1,34,29,77,77,58,212
355030806000024,1,80,38,173,173,151,497
355030806000025,1,75,29,120,120,67,307
355030806000026,1,32,21,74,74,60,208
355030806000027,1,47,16,56,56,51,163
355030806000028,1,163,35,326,326,103,755
355030806000029,1,19,11,129,129,31,289
355030806000030,1,13,4,68,68,20,156
355030806000035,1,0,0,0,0,0,0
355030806000037,1,12,5,24,24,9,57
355030807000001,1,52,30,106,106,159,371
355030807000002,1,63,63,169,169,148,486
355030807000003,1,35,36,128,128,135,391
355030807000004,1,58,41,103,103,106,312
355030807000005,1,33,37,80,80,97,257
355030807000006,1,28,27,102,102,91,295
355030807000007,1,24,32,98,98,98,294
355030807000008,1,54,47,187,187,143,517
355030807000009,1,63,31,144,144,143,431
355030807000010,1,43,35,106,106,105,317
355030807000011,1,45,44,137,137,161,435
355030807000012,1,43,48,113,113,86,312
355030807000013,1,62,33,97,97,44,238
355030807000014,1,50,42,124,124,95,343
355030807000015,1,85,51,144,144,111,399
355030807000016,1,38,39,122,122,105,349
355030807000017,1,88,45,174,174,122,470
355030807000018,1,60,57,182,182,117,481
355030807000019,1,35,19,117,117,103,337
355030807000020,1,38,37,133,133,152,418
355030807000021,1,34,21,73,73,88,234
355030807000022,1,23,19,92,92,115,299
355030807000023,1,11,13,26,26,35,87
355030807000024,1,33,29,119,119,99,337
355030807000025,1,24,28,80,80,83,243
355030807000026,1,48,45,132,132,116,380
355030807000027,1,36,39,159,159,111,429
355030807000028,1,28,21,67,67,94,228
355030807000029,1,1,8,19,19,16,54
355030807000030,1,32,46,86,86,52,224
355030807000031,1,14,31,133,133,97,363
355030807000032,1,14,27,104,104,63,271
355030807000033,1,73,55,179,179,93,451
355030807000034,1,72,39,109,109,71,289
355030807000035,1,70,51,84,84,93,261
355030807000036,1,74,45,117,117,82,316
355030807000037,1,125,61,181,181,145,507
355030807000038,1,52,37,83,83,48,214
355030807000039,1,71,46,135,135,86,356
355030807000040,1,53,35,126,126,62,314
355030807000041,1,47,56,118,118,39,275
355030807000042,1,83,39,119,119,77,315
355030807000043,1,37,34,130,130,119,379
355030807000044,1,104,53,162,162,107,431
355030807000045,1,8,5,37,37,26,100
355030807000046,1,22,20,61,61,56,178
355030807000047,1,67,41,151,151,100,402
355030807000048,1,33,38,135,135,147,417
355030807000049,1,59,33,110,110,118,338
355030807000050,1,55,40,128,128,102,358
355030807000051,1,59,19,104,104,104,312
355030807000052,1,159,70,298,298,247,843
355030807000053,1,8,16,65,65,44,174
355030807000054,1,45,61,242,242,122,606
355030807000055,1,52,33,107,107,109,323
355030807000056,1,17,21,47,47,46,140
355030807000057,1,46,60,141,141,140,422
355030807000058,1,32,28,92,92,86,270
355030807000059,1,35,41,111,111,151,373
355030807000060,1,9,32,57,57,28,142
355030807000061,1,2,13,51,51,37,139
355030807000062,1,29,39,98,98,84,280
355030807000063,1,48,33,109,109,102,320
355030807000064,1,51,26,135,135,86,356
355030807000065,1,23,26,99,99,81,279
355030807000066,1,96,72,228,228,119,575
355030807000067,1,102,70,162,162,122,446
355030807000068,1,60,34,160,160,110,430
355030807000069,1,0,8,86,86,28,200
355030807000070,1,58,28,106,106,132,344
355030807000071,1,49,47,146,146,123,415
355030807000072,1,61,34,110,110,93,313
355030807000073,1,83,38,84,84,65,233
355030807000074,1,50,27,157,157,121,435
355030807000075,1,25,27,113,113,81,307
355030807000076,1,35,24,116,116,65,297
355030807000077,1,27,32,94,94,40,228
355030807000078,1,34,35,124,124,105,353
355030807000079,1,35,43,143,143,137,423
355030807000080,1,35,41,152,152,52,356
355030807000081,1,0,3,5,5,3,13
355030807000082,1,15,20,59,59,52,170
355030807000083,1,28,41,124,124,83,331
355030807000084,1,19,31,82,82,47,211
355030807000085,1,5,7,31,31,30,92
355030807000086,1,33,19,152,152,63,367
355030807000087,1,39,41,94,94,91,279
355030807000088,1,20,31,93,93,59,245
355030807000089,1,110,74,156,156,103,415
355030807000090,1,108,66,202,202,96,500
355030807000091,1,93,60,203,203,111,517
355030807000092,1,87,35,155,155,69,379
355030807000093,1,57,46,131,131,102,364
355030807000094,1,45,44,125,125,121,371
355030807000095,1,123,61,204,204,110,518
355030807000096,1,27,28,63,63,35,161
355030807000097,1,3,5,8,8,13,29
355030807000098,1,24,28,96,96,78,270
355030807000099,1,104,99,343,343,253,939
355030807000100,1,5,13,59,59,35,153
355030807000101,1,60,58,175,175,112,462
355030807000102,1,23,42,111,111,93,315
355030807000103,1,19,23,112,112,51,275
355030807000104,1,35,38,255,255,141,651
355030807000105,1,123,87,188,188,83,459
355030807000106,1,162,118,214,214,104,532
355030807000107,1,124,72,135,135,89,359
355030807000108,1,141,114,194,194,104,492
355030807000109,1,61,28,106,106,51,263
355030807000110,1,18,27,82,82,60,224
355030807000111,1,77,65,272,272,164,708
355030807000112,1,45,29,80,80,36,196
355030807000113,1,44,36,103,103,64,270
355030807000114,1,85,61,207,207,102,516
355030807000115,1,45,37,119,119,87,325
355030807000116,1,38,27,69,69,50,188
355030807000117,1,32,32,80,80,58,218
355030807000118,1,67,47,151,151,106,408
355030807000119,1,62,38,178,178,153,509
355030807000120,1,17,27,115,115,72,302
355030807000121,1,18,30,110,110,93,313
355030807000123,1,47,39,217,217,100,534
355030807000124,1,64,32,180,180,93,453
355030807000125,1,21,28,98,98,67,263
355030807000126,1,16,11,75,75,42,192
355030807000127,1,13,9,85,85,60,230
355030807000128,1,41,26,180,180,95,455
355030807000129,1,21,32,158,158,91,407
355030807000130,1,17,21,153,153,54,360
355030807000131,1,79,77,191,191,102,484
355030807000132,1,23,20,91,91,73,255
355030807000133,1,4,10,37,37,18,92
355030807000134,1,47,26,102,102,90,294
355030807000135,1,30,53,168,168,101,437
355030807000136,1,12,9,83,83,38,204
355030807000137,1,59,37,153,153,73,379
355030807000138,1,57,41,119,119,116,354
355030807000139,1,24,26,82,82,31,195
355030807000140,1,16,27,103,103,42,248
355030807000141,1,2,5,30,30,20,80
355030807000142,1,13,10,66,66,29,161
355030807000143,1,11,7,30,30,24,84
355030808000001,1,131,67,155,155,122,432
355030808000002,1,72,24,79,79,68,226
355030808000003,1,84,54,116,116,157,389
355030808000004,1,91,55,153,153,215,521
355030808000005,1,92,62,169,169,95,433
355030808000006,1,96,59,144,144,118,406
355030808000007,1,21,14,65,65,56,186
355030808000008,1,127,180,484,484,179,1147
355030808000009,1,292,114,224,224,87,535
355030808000010,1,59,38,95,95,114,304
355030808000011,1,81,79,134,134,230,498
355030808000012,1,68,35,129,129,152,410
355030808000013,1,33,17,50,50,58,158
355030808000014,1,65,34,112,112,96,320
355030808000015,1,44,25,63,63,60,186
355030808000016,1,65,51,110,110,90,310
355030808000017,1,120,73,212,212,165,589
355030808000018,1,107,68,162,162,166,490
355030808000019,1,49,23,68,68,72,208
355030808000020,1,100,61,151,151,174,476
355030808000021,1,97,65,155,155,121,431
355030808000022,1,33,23,70,70,60,200
355030808000023,1,138,76,174,174,166,514
355030808000024,1,94,55,123,123,96,342
355030808000025,1,123,72,169,169,139,477
355030808000026,1,165,84,194,194,137,525
355030808000027,1,111,72,145,145,77,367
355030808000028,1,103,68,103,103,75,281
355030808000029,1,116,56,160,160,134,454
355030808000030,1,87,62,123,123,140,386
355030808000031,1,122,66,170,170,144,484
355030808000032,1,66,31,78,78,77,233
355030808000033,1,110,47,152,152,201,505
355030808000034,1,115,52,185,185,174,544
355030808000035,1,104,58,136,136,141,413
355030808000036,1,42,21,76,76,78,230
355030808000037,1,66,35,136,136,143,415
355030808000038,1,50,38,77,77,88,242
355030808000039,1,61,41,126,126,110,362
355030808000040,1,155,79,189,189,113,491
355030808000041,1,68,48,78,78,68,224
355030808000042,1,153,98,189,189,182,560
355030808000043,1,52,24,81,81,54,216
355030808000044,1,204,94,231,231,115,577
355030808000045,1,70,38,140,140,117,397
355030808000046,1,66,26,118,118,84,320
355030808000047,1,64,38,91,91,130,312
355030808000048,1,67,26,85,85,100,270
355030808000049,1,77,52,147,147,161,455
355030808000050,1,55,37,104,104,89,297
355030808000051,1,20,17,50,50,30,130
355030808000052,1,67,53,119,119,101,339
355030808000053,1,56,56,96,96,95,287
355030808000054,1,60,28,56,56,76,188
355030808000055,1,65,45,125,125,87,337
355030808000056,1,25,18,33,33,46,112
355030808000057,1,41,21,44,44,49,137
355030808000058,1,65,43,125,125,78,328
355030808000059,1,51,31,69,69,55,193
355030808000060,1,42,36,96,96,93,285
355030808000061,1,122,44,217,217,107,541
355030808000062,1,63,19,155,155,56,366
355030808000063,1,76,32,220,220,62,502
355030808000064,1,78,28,228,228,73,529
355030808000065,1,274,122,227,227,102,556
355030808000066,1,50,36,95,95,100,290
355030808000067,1,30,33,65,65,70,200
355030808000068,1,46,41,55,55,106,216
355030808000069,1,65,28,159,159,81,399
355030808000070,1,56,22,94,94,80,268
355030808000071,1,66,32,94,94,49,237
355030808000072,1,23,18,63,63,26,152
355030808000073,1,15,10,68,68,17,153
355030808000075,1,104,36,203,203,67,473
355030808000076,1,45,31,139,139,44,322
355030808000077,1,55,15,204,204,63,471
355030808000078,1,44,19,130,130,44,304
355030808000079,1,69,22,197,197,46,440
355030809000001,1,86,45,122,122,112,356
355030809000002,1,70,49,108,108,124,340
355030809000003,1,89,70,176,176,202,554
355030809000004,1,122,90,203,203,194,600
355030809000005,1,85,31,114,114,114,342
355030809000006,1,51,51,100,100,128,328
355030809000007,1,54,38,96,96,92,284
355030809000008,1,62,50,100,100,83,283
355030809000009,1,135,71,218,218,162,598
355030809000010,1,80,51,103,103,85,291
355030809000011,1,153,92,197,197,167,561
355030809000012,1,74,52,138,138,136,412
355030809000013,1,91,78,157,157,165,479
355030809000014,1,115,72,199,199,173,571
355030809000015,1,105,58,130,130,125,385
355030809000016,1,51,40,81,81,72,234
355030809000017,1,61,31,102,102,86,290
355030809000018,1,133,80,184,184,146,514
355030809000019,1,100,51,156,156,87,399
355030809000020,1,137,66,165,165,90,420
355030809000021,1,491,246,524,524,195,1243
355030809000022,1,167,100,234,234,120,588
355030809000023,1,123,99,212,212,150,574
355030809000024,1,86,70,141,141,51,333
355030809000025,1,93,60,129,129,86,344
355030809000026,1,144,96,178,178,97,453
355030809000027,1,171,113,238,238,154,630
355030809000028,1,43,35,109,109,70,288
355030809000029,1,81,61,155,155,100,410
355030809000030,1,75,39,117,117,112,346
355030809000031,1,72,36,135,135,106,376
355030809000032,1,73,41,116,116,58,290
355030809000033,1,105,67,129,129,89,347
355030809000034,1,173,99,250,250,158,658
355030809000035,1,111,76,190,190,110,490
355030809000036,1,118,81,149,149,77,375
355030809000037,1,247,72,171,171,66,408
355030809000038,1,98,78,149,149,125,423
355030809000039,1,110,66,161,161,112,434
355030809000040,1,141,85,250,250,174,674
355030809000041,1,104,50,155,155,92,402
355030809000042,1,22,10,31,31,18,80
355030809000043,1,159,69,182,182,84,448
355030809000044,1,339,103,170,170,113,453
355030809000045,1,181,63,155,155,79,389
355030809000046,1,1,2,6,6,1,13
355030809000047,1,26,18,100,100,47,247
355030809000048,1,20,12,78,78,31,187
355030809000049,1,52,21,196,196,53,445
355030809000050,1,67,24,200,200,101,501
355030810000001,1,79,51,120,120,59,299
355030810000002,1,92,30,122,122,27,271
355030810000003,1,25,17,35,35,23,93
355030810000004,1,326,134,446,446,237,1129
355030810000005,1,95,77,182,182,96,460
355030810000006,1,123,43,168,168,59,395
355030810000007,1,66,53,95,95,62,252
355030810000008,1,96,55,140,140,118,398
355030810000009,1,94,62,191,191,85,467
355030810000010,1,109,79,139,139,87,365
355030810000011,1,53,33,112,112,92,316
355030810000012,1,89,65,138,138,121,397
355030810000013,1,55,38,97,97,78,272
355030810000014,1,153,94,221,221,134,576
355030810000015,1,144,67,188,188,61,437
355030810000016,1,85,63,103,103,58,264
355030810000017,1,52,13,54,54,30,138
355030810000018,1,179,102,232,232,141,605
355030810000019,1,123,59,142,142,91,375
355030810000020,1,116,51,231,231,86,548
355030810000021,1,45,59,82,82,133,297
355030810000022,1,120,62,154,154,117,425
355030810000023,1,10,11,14,14,21,49
355030810000024,1,103,63,145,145,89,379
355030810000025,1,202,152,269,269,104,642
355030810000026,1,31,26,48,48,34,130
355030810000027,1,64,32,133,133,77,343
355030810000028,1,49,22,69,69,53,191
355030810000029,1,23,3,34,34,21,89
355030810000030,1,60,39,105,105,74,284
355030810000031,1,97,60,110,110,59,279
355030810000032,1,134,56,210,210,122,542
355030810000033,1,85,55,113,113,82,308
355030810000034,1,77,54,113,113,94,320
355030810000035,1,53,39,87,87,135,309
355030810000036,1,50,46,116,116,131,363
355030810000037,1,54,32,144,144,88,376
355030810000038,1,62,43,135,135,108,378
355030810000039,1,90,68,154,154,145,453
355030810000040,1,84,45,114,114,75,303
355030810000041,1,29,8,54,54,32,140
355030810000042,1,73,52,189,189,57,435
355030810000043,1,92,50,113,113,47,273
355030810000044,1,78,42,124,124,68,316
355030810000045,1,136,52,167,167,86,420
355030810000046,1,87,48,129,129,128,386
355030810000047,1,57,23,70,70,32,172
355030810000048,1,37,22,57,57,27,141
355030810000049,1,96,44,89,89,77,255
355030810000050,1,65,62,135,135,157,427
355030810000051,1,29,18,57,57,51,165
355030810000052,1,58,33,72,72,65,209
355030810000053,1,102,42,191,191,153,535
355030810000054,1,108,78,187,187,107,481
355030810000055,1,0,0,0,0,11,11
355030810000056,1,49,26,69,69,86,224
355030811000001,1,163,88,186,186,143,515
355030811000002,1,142,65,171,171,107,449
355030811000003,1,393,174,303,303,204,810
355030811000004,1,212,94,214,214,158,586
355030811000005,1,184,93,189,189,152,530
355030811000006,1,146,63,150,150,91,391
355030811000007,1,214,120,261,261,212,734
355030811000008,1,155,68,163,163,128,454
355030811000009,1,195,69,152,152,109,413
355030811000010,1,225,96,206,206,147,559
355030811000011,1,191,87,163,163,105,431
355030811000012,1,226,122,227,227,144,598
355030811000013,1,121,48,108,108,53,269
355030811000014,1,217,98,191,191,117,499
355030811000015,1,390,153,284,284,148,716
355030811000016,1,132,62,135,135,86,356
355030811000017,1,226,78,169,169,84,422
355030811000018,1,160,64,153,153,125,431
355030811000019,1,116,48,130,130,57,317
355030811000020,1,264,111,201,201,126,528
355030811000021,1,119,71,143,143,113,399
355030811000022,1,242,118,228,228,125,581
355030811000023,1,70,42,86,86,61,233
355030811000024,1,120,57,147,147,92,386
355030811000025,1,117,54,130,130,68,328
355030811000026,1,245,113,212,212,148,572
355030811000027,1,151,73,153,153,81,387
355030811000028,1,53,32,44,44,24,112
355030811000029,1,90,31,156,156,55,367
355030811000030,1,170,32,198,198,85,481
355030811000031,1,209,113,230,230,143,603
355030811000032,1,84,35,80,80,70,230
355030811000033,1,136,84,176,176,132,484
355030811000034,1,109,51,134,134,111,379
355030811000035,1,267,127,237,237,152,626
355030811000036,1,174,89,200,200,154,554
355030811000037,1,42,19,40,40,32,112
355030811000038,1,120,72,193,193,184,570
355030811000039,1,127,84,194,194,219,607
355030811000040,1,117,59,180,180,123,483
355030811000041,1,132,59,203,203,129,535
355030811000042,1,93,33,183,183,84,450
355030811000043,1,144,49,235,235,116,586
355030811000044,1,128,65,141,141,131,413
355030811000045,1,124,63,181,181,130,492
355030811000046,1,183,82,202,202,121,525
355030811000047,1,261,116,240,240,223,703
355030811000048,1,37,13,35,35,14,84
355030811000049,1,60,25,40,40,36,116
355030811000050,1,107,59,128,128,65,321
355030811000051,1,146,53,156,156,84,396
355030811000052,1,121,38,117,117,67,301
355030811000053,1,121,63,107,107,63,277
355030811000054,1,150,68,186,186,79,451
355030811000055,1,57,17,43,43,35,121
355030811000056,1,163,73,167,167,112,446
355030811000057,1,101,69,124,124,140,388
355030811000058,1,151,84,216,216,208,640
355030811000059,1,51,29,61,61,40,162
355030811000060,1,170,91,185,185,124,494
355030811000061,1,188,76,218,218,152,588
355030811000062,1,123,67,179,179,148,506
355030811000063,1,93,87,126,126,154,406
355030811000064,1,91,47,143,143,145,431
355030811000065,1,160,95,167,167,176,510
355030811000066,1,118,51,95,95,68,258
355030811000067,1,171,89,154,154,95,403
355030811000068,1,437,204,347,347,208,902
355030811000069,1,77,43,94,94,76,264
355030811000070,1,149,97,196,196,155,547
355030811000071,1,151,68,201,201,161,563
355030811000072,1,167,82,174,174,148,496
355030811000073,1,143,71,184,184,133,501
355030811000074,1,121,91,188,188,197,573
355030811000075,1,153,81,193,193,181,567
355030811000076,1,102,61,92,92,93,277
355030811000077,1,226,85,206,206,151,563
355030811000078,1,149,74,138,138,95,371
355030811000079,1,266,144,230,230,128,588
355030811000080,1,53,23,44,44,29,117
355030811000081,1,283,142,281,281,157,719
355030811000082,1,151,73,152,152,88,392
355030811000083,1,136,53,125,125,90,340
355030811000084,1,99,40,109,109,63,281
355030811000085,1,236,140,248,248,132,628
355030811000086,1,158,77,133,133,98,364
355030811000087,1,250,133,222,222,158,602
355030811000088,4,10,6,9,9,12,30
355030811000089,1,180,101,146,146,85,377
355030811000090,1,368,165,369,369,111,849
355030811000091,1,321,143,241,241,194,676
355030811000092,1,336,120,251,251,143,645
355030811000093,1,221,71,175,175,94,444
355030811000094,1,247,105,237,237,106,580
355030811000095,1,321,142,278,278,150,706
355030811000096,1,182,60,184,184,109,477
355030811000097,1,207,102,204,204,128,536
355030811000098,1,107,45,100,100,64,264
355030811000099,1,180,98,185,185,96,466
355030811000100,1,85,53,142,142,93,377
355030811000101,1,176,78,180,180,88,448
355030811000102,1,154,45,191,191,136,518
355030811000103,1,93,41,90,90,96,276
355030811000104,1,131,56,142,142,103,387
355030811000105,1,161,88,149,149,110,408
355030811000106,1,127,58,156,156,139,451
355030811000107,1,193,73,248,248,171,667
355030811000108,1,157,88,139,139,143,421
355030811000109,1,190,82,239,239,189,667
355030811000110,1,94,52,110,110,127,347
355030811000111,1,256,110,301,301,241,843
355030811000112,1,78,26,138,138,61,337
355030811000113,1,191,91,204,204,159,567
355030811000114,1,116,52,152,152,117,421
355030811000115,1,183,93,229,229,149,607
355030811000116,1,197,99,248,248,186,682
355030811000117,1,68,58,95,95,94,284
355030811000118,1,42,15,46,46,26,118
355030811000119,1,147,94,194,194,145,533
355030811000120,1,63,53,81,81,71,233
355030811000121,1,117,63,182,182,161,525
355030811000122,1,152,90,201,201,125,527
355030811000123,1,94,52,115,115,90,320
355030811000124,1,97,54,130,130,136,396
355030811000125,1,154,75,151,151,152,454
355030811000126,1,191,75,208,208,167,583
355030811000127,1,108,50,115,115,99,329
355030811000128,1,49,29,75,75,76,226
355030811000129,1,164,101,243,243,190,676
355030811000130,1,226,93,211,211,166,588
355030811000131,1,205,99,241,241,177,659
355030811000132,1,145,92,176,176,94,446
355030811000133,1,163,65,158,158,86,402
355030811000134,1,245,122,248,248,165,661
355030811000135,1,82,36,96,96,47,239
355030811000136,1,152,77,157,157,105,419
355030811000137,1,399,190,413,413,253,1079
355030811000138,1,191,96,206,206,151,563
355030811000139,1,153,64,140,140,60,340
355030811000140,1,828,371,727,727,396,1850
355030811000141,1,123,53,79,79,62,220
355030811000142,1,169,74,129,129,63,321
355030811000143,1,243,97,197,197,120,514
355030811000144,1,97,37,98,98,43,239
355030811000145,1,296,133,233,233,159,625
355030811000146,1,265,235,158,158,215,531
355030811000147,1,178,131,125,125,119,369
355030811000148,1,111,75,104,104,142,350
355030811000149,1,231,108,178,178,108,464
355030811000150,1,127,56,142,142,107,391
355030811000151,1,194,116,239,239,195,673
355030811000152,1,132,66,167,167,107,441
355030811000153,1,145,94,166,166,145,477
355030811000154,1,186,83,230,230,159,619
355030811000155,1,73,33,96,96,74,266
355030811000156,1,147,86,194,194,153,541
355030811000157,1,217,104,230,230,169,629
355030811000158,1,64,47,78,78,63,219
355030811000159,1,175,86,184,184,185,553
355030811000160,1,102,52,115,115,88,318
355030811000161,1,124,75,148,148,120,416
355030811000162,1,274,123,243,243,148,634
355030811000163,1,65,28,64,64,39,167
355030811000164,1,284,124,287,287,135,709
355030811000165,1,217,81,235,235,121,591
355030811000166,1,120,56,121,121,84,326
355030811000167,1,181,95,170,170,123,463
355030811000168,1,224,103,209,209,101,519
355030811000169,1,117,64,119,119,78,316
355030811000171,1,209,115,227,227,127,581
355030811000172,1,226,123,267,267,167,701
355030811000173,1,137,48,106,106,62,274
355030811000174,1,178,92,213,213,135,561
355030811000175,1,64,18,46,46,32,124
355030811000176,1,223,98,207,207,178,592
355030811000177,1,273,147,297,297,172,766
355030811000178,1,317,124,331,331,194,856
355030811000179,1,252,152,263,263,147,673
355030811000180,1,204,116,202,202,135,539
355030811000181,1,203,77,194,194,110,498
355030811000182,1,163,86,223,223,157,603
355030811000183,1,211,93,220,220,178,618
355030811000184,1,297,83,231,231,128,590
355030811000185,1,177,63,180,180,78,438
355030811000186,1,274,107,238,238,110,586
355030811000187,1,193,68,188,188,88,464
355030811000188,1,399,172,335,335,162,832
355030811000189,1,269,125,291,291,127,709
355030811000190,1,70,25,78,78,31,187
355030811000191,1,237,80,209,209,105,523
355030811000192,1,182,85,160,160,108,428
355030811000193,1,216,104,207,207,150,564
355030811000194,4,28,14,18,18,6,42
355030811000195,1,341,146,350,350,214,914
355030811000196,1,194,82,196,196,131,523
355030811000197,1,336,161,340,340,182,862
355030811000198,1,107,56,107,107,78,292
355030811000199,1,216,80,153,153,90,396
355030811000200,1,208,116,192,192,101,485
355030811000201,1,329,140,349,349,168,866
355030811000202,1,259,139,249,249,166,664
355030811000203,1,141,57,158,158,71,387
355030811000204,1,117,60,132,132,122,386
355030811000205,1,128,80,148,148,198,494
355030811000206,1,119,42,140,140,61,341
355030811000207,1,70,37,88,88,53,229
355030811000208,1,133,61,142,142,118,402
355030811000209,1,205,90,197,197,83,477
355030811000210,4,333,130,277,277,100,654
355030811000211,1,283,81,225,225,80,530
355030811000212,1,216,79,178,178,72,428
355030811000213,1,134,56,131,131,101,363
355030811000215,1,63,38,46,46,47,139
355030811000217,1,455,214,431,431,207,1069
355030811000218,1,196,105,212,212,113,537
355030811000219,8,252,85,149,149,59,357
355030811000220,1,150,50,109,109,30,248
355030811000221,8,727,244,500,500,194,1194
355030811000222,1,77,41,109,109,73,291
355030811000223,1,198,103,182,182,134,498
355030811000224,1,311,146,263,263,131,657
355030811000225,1,138,51,102,102,35,239
355030811000226,1,35,12,22,22,23,67
355030811000227,1,406,164,372,372,159,903
355030811000228,1,207,94,140,140,69,349
355030811000229,1,157,53,176,176,96,448
355030811000230,1,151,64,154,154,80,388
355030811000231,1,142,49,128,128,75,331
355030811000232,1,116,39,98,98,89,285
355030811000233,1,207,72,178,178,92,448
355030811000234,1,100,45,100,100,61,261
355030811000235,1,190,105,189,189,125,503
355030811000236,1,201,94,193,193,132,518
355030811000237,1,116,68,154,154,160,468
355030811000238,1,164,75,145,145,85,375
355030811000239,1,125,70,150,150,123,423
355030811000240,1,164,91,179,179,108,466
355030811000241,1,133,64,122,122,97,341
355030811000242,1,262,111,189,189,84,462
355030811000243,1,210,87,203,203,115,521
355030811000244,1,137,76,161,161,168,490
355030811000245,1,92,51,95,95,63,253
355030811000246,1,88,50,116,116,107,339
355030811000247,1,155,55,105,105,84,294
355030811000248,1,134,67,156,156,109,421
355030811000249,1,175,64,148,148,79,375
355030811000250,1,63,34,52,52,50,154
355030811000251,1,92,50,105,105,47,257
355030811000252,1,62,21,72,72,54,198
355030811000253,1,143,71,139,139,106,384
355030811000255,1,463,154,335,335,143,813
355030811000256,1,295,150,337,337,169,843
355030811000257,1,122,45,109,109,58,276
355030811000258,1,178,89,214,214,101,529
355030811000259,4,238,116,255,255,177,687
355030811000260,1,150,78,171,171,108,450
355030811000261,4,145,61,201,201,136,538
355030811000262,1,113,58,144,144,80,368
355030811000263,1,104,54,119,119,53,291
355030811000265,8,13,6,12,12,6,30
355030811000266,8,52,23,32,32,18,82
355030811000271,1,118,58,111,111,86,308
355030811000272,1,75,38,86,86,56,228
355030811000273,1,127,66,145,145,115,405
355030811000274,1,100,67,98,98,96,292
355030811000275,1,110,56,126,126,67,319
355030811000276,1,96,40,97,97,42,236
355030811000277,1,35,16,38,38,22,98
355030811000278,1,41,18,48,48,53,149
355030811000279,1,108,43,90,90,90,270
355030811000280,1,95,51,106,106,73,285
355030811000281,1,44,14,43,43,32,118
355030811000282,1,79,25,65,65,45,175
355030811000283,1,92,39,98,98,92,288
355030811000284,1,77,28,91,91,68,250
355030811000285,1,40,20,50,50,41,141
355030811000286,1,54,29,75,75,62,212
355030811000287,1,69,34,80,80,64,224
355030811000288,1,60,38,83,83,71,237
355030811000289,1,144,69,196,196,100,492
355030811000290,1,187,106,191,191,94,476
355030811000291,1,382,178,349,349,222,920
355030811000292,1,96,60,84,84,69,237
355030811000293,1,35,25,33,33,37,103
355030811000294,1,106,64,111,111,111,333
355030811000295,1,99,53,126,126,72,324
355030811000296,1,121,51,143,143,101,387
355030811000297,1,96,47,120,120,99,339
355030811000298,1,158,63,140,140,90,370
355030811000299,1,259,58,168,168,34,370
355030811000300,1,102,48,125,125,47,297
355030811000301,1,49,38,44,44,33,121
355030811000302,1,70,25,86,86,69,241
355030811000303,1,89,31,91,91,71,253
355030811000304,1,189,103,227,227,124,578
355030811000305,1,125,56,126,126,80,332
355030811000306,1,230,105,213,213,110,536
355030811000307,1,94,30,94,94,42,230
355030811000308,1,222,110,195,195,93,483
355030811000309,1,184,61,152,152,77,381
355030811000310,1,115,67,129,129,79,337
355030811000311,1,155,62,151,151,87,389
355030811000312,1,200,81,188,188,141,517
355030811000313,1,75,36,64,64,39,167
355030811000314,1,133,60,150,150,89,389
355030811000315,1,265,111,274,274,176,724
355030811000316,1,143,88,147,147,116,410
355030811000317,1,171,82,150,150,87,387
355030811000318,1,174,81,162,162,74,398
355030811000319,1,582,225,496,496,244,1236
355030811000320,1,162,88,205,205,111,521
355030811000321,1,153,63,195,195,84,474
355030811000322,1,218,87,267,267,120,654
355030811000323,1,43,27,58,58,35,151
355030811000324,1,262,92,216,216,113,545
355030811000325,1,196,96,150,150,105,405
355030811000326,1,150,72,151,151,117,419
355030811000327,1,129,55,88,88,45,221
355030811000329,4,28,10,23,23,8,54
355030811000331,1,628,248,677,677,326,1680
355030811000333,1,437,146,300,300,98,698
355030811000334,2,54,14,29,29,16,74
355030811000335,2,178,61,117,117,38,272
355030811000336,2,191,91,200,200,96,496
355030811000338,1,103,33,82,82,30,194
355030811000339,1,880,339,695,695,240,1630
355030811000341,4,0,0,0,0,0,0
355030811000343,2,55,22,46,46,31,123
355030811000344,1,154,32,122,122,38,282
355030811000345,2,0,0,0,0,0,0
355030811000346,2,59,30,41,41,34,116
355030811000350,1,70,32,80,80,56,216
355030811000352,1,12,7,8,8,2,18
355030811000354,1,402,213,444,444,328,1216
355030811000355,1,361,121,243,243,90,576
355030811000356,1,75,20,69,69,33,171
355030811000357,1,24,15,41,41,9,91
355030811000358,1,60,29,52,52,40,144
355030811000359,1,181,89,160,160,45,365
355030811000360,1,72,25,66,66,27,159
355030811000361,1,24,13,21,21,22,64
355030811000362,1,62,21,36,36,15,87
355030811000363,1,80,51,92,92,41,225
355030811000364,1,319,163,245,245,114,604
355030811000365,1,91,38,82,82,43,207
355030811000366,1,29,12,20,20,9,49
355030811000367,1,35,21,34,34,26,94
355030811000368,1,135,86,143,143,79,365
355030811000369,1,124,60,94,94,52,240
355030811000370,1,94,42,79,79,51,209
355030811000371,1,42,18,42,42,19,103
355030811000372,1,60,26,64,64,25,153
355030811000373,1,166,78,154,154,64,372
355030811000374,1,261,95,190,190,84,464
355030811000375,1,244,119,248,248,135,631
355030811000376,1,187,85,141,141,66,348
355030811000377,1,146,72,129,129,60,318
355030811000378,1,40,17,38,38,12,88
355030811000379,1,105,50,101,101,35,237
355030811000380,1,72,31,62,62,57,181
355030811000381,1,91,57,104,104,55,263
355030811000382,1,14,9,15,15,9,39
355030811000383,1,43,23,35,35,16,86
355030811000384,1,363,153,323,323,172,818
355030811000385,1,220,81,156,156,59,371
355030811000386,1,167,62,131,131,52,314
355030811000387,1,36,25,40,40,26,106
355030811000388,1,104,42,77,77,34,188
355030811000389,1,32,16,30,30,27,87
355030811000390,1,100,63,100,100,56,256
355030812000001,1,44,37,120,120,107,347
355030812000002,1,81,48,174,174,147,495
355030812000003,1,71,41,191,191,100,482
355030812000004,1,27,17,63,63,72,198
355030812000005,1,49,20,57,57,55,169
355030812000006,1,24,34,80,80,55,215
355030812000007,1,168,62,167,167,114,448
355030812000008,1,47,37,73,73,70,216
355030812000009,1,64,24,99,99,76,274
355030812000010,1,56,54,127,127,100,354
355030812000011,1,38,32,92,92,77,261
355030812000012,1,30,18,54,54,47,155
355030812000013,1,22,17,56,56,59,171
355030812000014,1,24,11,74,74,55,203
355030812000015,1,33,31,90,90,82,262
355030812000016,1,9,3,16,16,15,47
355030812000017,1,49,27,111,111,93,315
355030812000018,1,110,67,134,134,135,403
355030812000019,1,41,24,78,78,62,218
355030812000020,1,18,34,71,71,75,217
355030812000021,1,22,8,41,41,41,123
355030812000022,1,24,34,33,33,91,157
355030812000023,1,34,34,42,42,91,175
355030812000024,1,14,4,34,34,25,93
355030812000025,1,99,45,182,182,131,495
355030812000026,1,35,27,59,59,73,191
355030812000027,1,12,9,44,44,19,107
355030812000028,1,26,22,80,80,63,223
355030812000029,1,26,17,49,49,60,158
355030812000030,1,54,34,89,89,135,313
355030812000031,1,66,36,98,98,138,334
355030812000032,1,31,9,49,49,39,137
355030812000033,1,25,21,63,63,53,179
355030812000034,1,61,32,113,113,90,316
355030812000035,1,75,34,98,98,91,287
355030812000036,1,46,17,93,93,85,271
355030812000037,1,53,31,95,95,110,300
355030812000038,1,2,0,10,10,5,25
355030812000039,1,15,19,41,41,18,100
355030812000040,1,42,31,90,90,99,279
355030812000041,1,63,41,116,116,114,346
355030812000042,1,52,47,112,112,104,328
355030812000043,1,24,17,60,60,93,213
355030812000044,1,29,23,73,73,64,210
355030812000045,1,37,29,70,70,86,226
355030812000046,1,40,22,54,54,58,166
355030812000047,1,108,37,143,143,117,403
355030812000048,1,66,25,103,103,90,296
355030812000049,1,56,37,89,89,93,271
355030812000050,1,16,13,45,45,55,145
355030812000051,1,32,15,77,77,58,212
355030812000052,1,3,25,72,72,2,146
355030812000053,1,51,26,68,68,74,210
355030812000054,1,48,21,67,67,69,203
355030812000055,1,15,24,51,51,57,159
355030812000056,1,14,25,51,51,57,159
355030812000057,1,10,27,38,38,61,137
355030812000058,1,48,27,113,113,118,344
355030812000059,1,38,15,86,86,72,244
355030812000060,1,33,17,68,68,56,192
355030812000061,1,79,28,154,154,111,419
355030812000062,1,33,18,82,82,52,216
355030812000063,1,87,64,142,142,146,430
355030812000064,1,93,45,160,160,146,466
355030812000065,1,116,72,181,181,177,539
355030812000066,1,133,67,175,175,141,491
355030812000067,1,100,46,165,165,119,449
355030812000068,1,106,49,219,219,125,563
355030812000069,1,75,40,95,95,139,329
355030812000070,1,2,2,9,9,7,25
355030812000071,1,64,28,99,99,102,300
355030812000072,1,47,25,70,70,76,216
355030812000073,1,49,11,86,86,50,222
355030812000074,1,24,13,95,95,12,202
355030812000075,1,20,12,35,35,34,104
355030812000076,1,16,16,35,35,50,120
355030812000077,1,24,27,59,59,46,164
355030812000078,1,40,15,59,59,49,167
355030812000079,1,48,20,82,82,70,234
355030812000080,1,26,18,73,73,77,223
355030812000081,1,66,60,152,152,145,449
355030812000082,1,18,13,47,47,60,154
355030812000083,1,31,21,66,66,49,181
355030812000084,1,31,16,76,76,55,207
355030812000085,1,42,26,104,104,79,287
355030812000086,1,37,36,118,118,85,321
355030812000087,1,53,26,112,112,87,311
355030812000088,1,60,30,84,84,93,261
355030812000089,1,38,43,94,94,91,279
355030812000090,1,53,32,113,113,118,344
355030812000091,1,28,15,50,50,60,160
355030812000092,1,19,20,59,59,41,159
355030812000093,1,55,38,119,119,91,329
355030812000094,1,32,22,52,52,59,163
355030812000095,1,49,47,73,73,89,235
355030812000096,1,16,30,53,53,44,150
355030812000097,1,28,19,55,55,50,160
355030812000098,1,57,41,89,89,94,272
355030812000099,1,18,25,64,64,29,157
355030812000100,1,35,16,63,63,60,186
355030812000101,1,25,18,57,57,47,161
355030812000102,1,51,38,77,77,111,265
355030812000103,1,43,19,72,72,66,210
355030812000104,1,44,52,106,106,98,310
355030812000105,1,25,22,63,63,60,186
355030812000106,1,37,14,74,74,64,212
355030812000107,1,44,23,90,90,84,264
355030812000108,1,33,42,99,99,63,261
355030812000109,1,3,24,39,39,29,107
355030812000110,1,9,38,33,33,37,103
355030812000111,1,17,43,45,45,32,122
355030812000112,1,26,10,57,57,52,166
355030812000113,1,25,16,60,60,78,198
355030812000114,1,37,20,66,66,83,215
355030812000115,1,39,25,81,81,70,232
355030812000116,1,47,15,72,72,47,191
355030812000117,1,49,22,81,81,99,261
355030812000118,1,81,65,155,155,127,437
355030812000119,1,40,14,83,83,33,199
355030812000120,1,46,17,94,94,39,227
355030812000121,1,42,7,70,70,23,163
355030812000122,1,58,37,96,96,77,269
355030812000123,1,51,44,131,131,102,364
355030812000124,1,52,41,139,139,119,397
355030812000125,1,2,82,59,59,2,120
355030812000126,1,1,10,84,84,1,169
355030812000127,1,68,21,78,78,62,218
355030812000128,1,43,22,67,67,68,202
355030812000129,1,42,22,72,72,52,196
355030812000130,1,21,25,75,75,69,219
355030812000131,1,29,12,58,58,62,178
355030812000132,1,32,27,60,60,75,195
355030812000133,1,35,20,94,94,65,253
355030812000134,1,24,6,69,69,29,167
355030812000135,1,18,14,41,41,39,121
355030812000136,1,157,50,172,172,65,409
355030812000137,1,55,27,94,94,96,284
355030812000138,1,49,17,131,131,27,289
355030812000139,1,14,7,50,50,17,117
355030812000140,1,14,4,61,61,9,131
355030812000141,1,18,3,66,66,22,154
355030812000142,1,12,2,70,70,13,153
355030812000143,1,192,56,330,330,140,800
355030812000144,1,53,30,89,89,75,253
355030812000145,1,31,14,58,58,29,145
355030812000146,1,32,21,42,42,18,102
355030813000001,1,124,51,146,146,94,386
355030813000002,1,124,86,154,154,105,413
355030813000003,1,169,101,206,206,179,591
355030813000004,1,182,96,206,206,142,554
355030813000005,1,148,87,221,221,181,623
355030813000006,1,163,92,222,222,141,585
355030813000007,1,380,185,346,346,152,844
355030813000008,1,158,91,188,188,160,536
355030813000009,1,173,62,310,310,165,785
355030813000010,1,182,105,210,210,208,628
355030813000011,1,170,65,185,185,116,486
355030813000012,1,79,40,85,85,95,265
355030813000013,1,155,70,158,158,106,422
355030813000014,1,273,124,233,233,116,582
355030813000015,1,302,142,249,249,97,595
355030813000016,1,159,78,165,165,75,405
355030813000017,1,193,105,253,253,173,679
355030813000018,1,162,68,115,115,69,299
355030813000020,1,79,58,99,99,66,264
355030813000021,1,122,65,102,102,49,253
355030813000022,1,72,55,74,74,87,235
355030813000023,1,115,56,129,129,112,370
355030813000024,1,147,66,164,164,124,452
355030813000025,1,137,99,147,147,112,406
355030813000026,1,146,72,200,200,146,546
355030813000027,1,131,71,163,163,129,455
355030813000028,1,138,76,156,156,156,468
355030813000029,1,143,73,170,170,162,502
355030813000030,1,119,73,179,179,153,511
355030813000031,1,142,78,184,184,100,468
355030813000032,1,108,41,125,125,102,352
355030813000033,1,131,70,138,138,95,371
355030813000034,1,69,27,79,79,74,232
355030813000035,1,125,75,168,168,142,478
355030813000036,1,134,75,167,167,169,503
355030813000037,1,66,42,106,106,113,325
355030813000038,1,106,63,159,159,153,471
355030813000039,1,317,133,476,476,207,1159
355030813000040,1,209,111,242,242,157,641
355030813000042,1,171,91,249,249,205,703
355030813000043,1,130,86,142,142,163,447
355030813000044,1,112,68,120,120,123,363
355030813000045,1,150,72,180,180,141,501
355030813000046,1,174,67,161,161,120,442
355030813000047,1,174,68,169,169,81,419
355030813000048,1,347,163,262,262,139,663
355030813000049,1,233,109,237,237,142,616
355030813000050,1,210,99,189,189,87,465
355030813000051,1,164,83,174,174,133,481
355030813000052,1,96,39,100,100,56,256
355030813000053,1,81,51,88,88,53,229
355030813000054,1,151,73,180,180,124,484
355030813000055,1,127,57,127,127,91,345
355030813000056,1,190,83,211,211,124,546
355030813000057,1,67,35,90,90,73,253
355030813000058,1,131,55,144,144,92,380
355030813000059,1,215,135,244,244,198,686
355030813000060,1,96,55,122,122,101,345
355030813000061,1,105,54,160,160,128,448
355030813000062,1,289,156,367,367,272,1006
355030813000063,1,321,150,297,297,163,757
355030813000064,1,270,148,267,267,242,776
355030813000065,1,87,49,106,106,80,292
355030813000066,1,191,89,256,256,199,711
355030813000067,1,146,60,183,183,159,525
355030813000068,1,119,56,153,153,146,452
355030813000069,1,148,60,209,209,114,532
355030813000070,1,67,58,126,126,145,397
355030813000071,1,130,70,160,160,151,471
355030813000072,1,143,82,173,173,134,480
355030813000073,1,83,66,113,113,137,363
355030813000074,1,153,84,156,156,198,510
355030813000075,1,119,62,174,174,213,561
355030813000076,1,40,26,61,61,58,180
355030813000077,1,118,71,173,173,140,486
355030813000078,1,117,50,129,129,119,377
355030813000079,1,125,95,176,176,135,487
355030813000080,1,109,39,122,122,82,326
355030813000081,1,145,72,128,128,114,370
355030813000082,1,57,29,62,62,20,144
355030813000083,1,183,91,169,169,78,416
355030813000084,1,109,53,96,96,53,245
355030813000085,1,73,36,74,74,31,179
355030813000086,1,273,126,231,231,134,596
355030813000087,1,197,77,186,186,94,466
355030813000088,1,245,115,191,191,100,482
355030813000089,1,290,159,289,289,167,745
355030813000090,1,107,65,111,111,85,307
355030813000091,1,101,55,133,133,80,346
355030813000092,1,52,37,67,67,50,184
355030813000093,1,248,119,291,291,276,858
355030813000094,1,134,81,153,153,100,406
355030813000095,1,111,47,153,153,103,409
355030813000096,1,135,57,161,161,139,461
355030813000097,1,190,71,213,213,169,595
355030813000098,1,163,71,186,186,194,566
355030813000099,1,165,86,179,179,107,465
355030813000100,1,150,84,122,122,65,309
355030813000101,1,163,77,178,178,154,510
355030813000102,1,390,189,434,434,240,1108
355030813000103,1,277,123,242,242,114,598
355030813000104,1,227,107,232,232,198,662
355030813000105,1,499,213,308,308,144,760
355030813000106,1,149,80,243,243,189,675
355030813000107,1,187,105,245,245,210,700
355030813000108,1,60,30,75,75,91,241
355030813000109,1,82,45,89,89,90,268
355030813000110,1,191,111,212,212,156,580
355030813000111,1,56,32,72,72,59,203
355030813000112,1,135,83,186,186,141,513
355030813000113,1,88,58,149,149,118,416
355030813000114,1,91,35,112,112,83,307
355030813000115,1,150,72,220,220,158,598
355030813000116,1,140,95,184,184,164,532
355030813000117,1,79,35,102,102,99,303
355030813000118,1,137,86,174,174,167,515
355030813000119,1,127,80,132,132,86,350
355030813000120,1,123,40,113,113,75,301
355030813000121,1,78,32,76,76,46,198
355030813000122,1,82,34,92,92,49,233
355030813000123,1,146,66,112,112,67,291
355030813000124,1,101,34,87,87,68,242
355030813000125,1,108,59,115,115,93,323
355030813000126,1,34,25,31,31,19,81
355030813000127,1,164,82,165,165,75,405
355030813000128,1,117,52,124,124,70,318
355030813000129,1,82,36,92,92,62,246
355030813000130,1,98,49,109,109,125,343
355030813000131,1,85,40,125,125,109,359
355030813000132,1,122,64,170,170,160,500
355030813000133,1,65,34,130,130,102,362
355030813000134,1,72,48,104,104,87,295
355030813000135,1,205,123,247,247,237,731
355030813000136,1,100,63,168,168,163,499
355030813000137,1,99,60,171,171,139,481
355030813000138,1,123,61,132,132,125,389
355030813000139,1,106,32,143,143,115,401
355030813000140,1,111,48,116,116,84,316
355030813000141,1,101,52,116,116,129,361
355030813000142,1,323,170,291,291,244,826
355030813000143,1,109,44,75,75,78,228
355030813000144,1,137,92,101,101,110,312
355030813000145,1,422,218,354,354,129,837
355030813000146,1,177,91,161,161,122,444
355030813000147,1,108,72,136,136,127,399
355030813000148,1,94,62,123,123,120,366
355030813000149,1,95,48,101,101,106,308
355030813000150,1,87,31,163,163,96,422
355030813000151,1,129,62,118,118,68,304
355030813000152,1,39,11,45,45,21,111
355030813000153,1,108,45,68,68,40,176
355030813000154,1,199,113,226,226,98,550
355030813000155,1,298,149,258,258,174,690
355030813000156,1,137,55,132,132,73,337
355030813000157,1,145,47,367,367,123,857
355030813000158,1,262,86,308,308,129,745
355030813000159,1,72,26,109,109,66,284
355030813000160,1,163,68,272,272,141,685
355030813000161,1,191,61,274,274,142,690
355030813000162,1,65,18,130,130,45,305
355030813000163,1,97,34,190,190,60,440
355030813000164,1,76,39,115,115,86,316
355030813000165,1,54,18,105,105,34,244
355030813000166,1,87,50,188,188,62,438
355030813000167,1,94,63,139,139,156,434
355030813000168,1,162,82,200,200,118,518
355030813000169,1,173,94,179,179,103,461
355030813000170,1,233,62,153,153,47,353
355030813000172,1,297,109,142,142,72,356
355030813000174,1,162,57,102,102,47,251
355030813000175,1,263,81,158,158,58,374
355030813000176,1,334,105,239,239,76,554
355030813000178,1,79,64,124,124,99,347
355030813000179,1,176,88,204,204,176,584
355030813000180,1,78,21,189,189,33,411
355030813000182,1,106,40,169,169,44,382
355030813000183,1,61,20,105,105,27,237
355030813000184,1,152,53,164,164,84,412
355030813000185,1,110,49,104,104,27,235
355030813000186,1,638,275,467,467,238,1172
355030813000187,1,46,21,39,39,26,104
355030813000188,1,134,56,103,103,32,238
355030813000189,1,60,26,81,81,71,233
355030813000190,1,67,32,84,84,57,225
355030813000191,1,75,24,89,89,72,250
355030813000192,1,70,51,118,118,77,313
355030813000193,1,49,35,43,43,13,99
355030813000194,1,145,74,148,148,80,376
355030813000195,4,24,5,10,10,8,28
355030813000198,1,31,12,42,42,22,106
355030813000199,1,59,37,89,89,102,280
355030813000200,1,138,66,124,124,89,337
355030813000201,1,69,37,102,102,93,297
355030813000202,1,143,56,90,90,39,219
355030813000203,1,0,0,0,0,0,0
355030813000204,1,0,0,0,0,0,0
355030813000205,1,21,7,28,28,15,71
355030813000206,1,10,5,8,8,5,21
355030813000208,4,52,26,58,58,40,156
355030813000209,4,40,14,29,29,9,67
355030813000210,1,186,75,137,137,69,343
355030813000211,1,54,24,53,53,27,133
355030813000213,1,68,31,76,76,46,198
355030813000214,1,98,36,99,99,62,260
355030813000215,1,65,23,60,60,30,150
355030813000217,1,89,53,86,86,50,222
355030813000218,1,87,46,62,62,47,171
355030813000219,1,71,32,56,56,32,144
355030813000220,1,34,18,30,30,24,84
355030813000221,1,55,36,45,45,30,120
355030813000222,1,32,15,38,38,18,94
355030813000223,1,43,13,44,44,29,117
355030813000224,1,183,81,155,155,77,387
355030813000225,1,107,43,83,83,39,205
355030813000226,1,36,23,35,35,26,96
355030813000227,1,55,27,59,59,24,142
355030813000228,1,0,0,0,0,0,0
355030814000001,1,78,53,146,146,169,461
355030814000002,1,127,69,203,203,161,567
355030814000003,1,167,88,231,231,181,643
355030814000004,1,89,43,128,128,127,383
355030814000005,1,59,30,139,139,109,387
355030814000006,1,36,22,98,98,77,273
355030814000007,1,118,56,172,172,151,495
355030814000008,1,66,41,158,158,121,437
355030814000009,1,53,43,119,119,39,277
355030814000010,1,50,25,105,105,114,324
355030814000011,1,102,64,131,131,131,393
355030814000012,1,96,42,106,106,81,293
355030814000013,1,43,21,106,106,128,340
355030814000014,1,161,84,290,290,200,780
355030814000015,1,79,58,143,143,165,451
355030814000016,1,113,47,182,182,152,516
355030814000017,1,22,16,119,119,136,374
355030814000018,1,59,39,133,133,104,370
355030814000019,1,74,52,138,138,124,400
355030814000020,1,92,60,167,167,166,500
355030814000021,1,69,41,114,114,146,374
355030814000022,1,133,37,228,228,146,602
355030814000023,1,68,41,143,143,127,413
355030814000024,1,105,51,213,213,153,579
355030814000025,1,160,80,229,229,143,601
355030814000026,1,158,86,202,202,169,573
355030814000027,1,160,73,203,203,117,523
355030814000028,1,133,77,145,145,124,414
355030814000029,1,125,85,142,142,168,452
355030814000030,1,79,36,83,83,66,232
355030814000031,1,96,42,104,104,52,260
355030814000032,1,72,56,152,152,155,459
355030814000033,1,70,49,131,131,143,405
355030814000034,1,44,35,96,96,81,273
355030814000035,1,121,50,173,173,130,476
355030814000036,1,51,37,133,133,113,379
355030814000037,1,66,31,135,135,134,404
355030814000038,1,60,32,107,107,81,295
355030814000039,1,57,24,77,77,58,212
355030814000040,1,79,44,80,80,58,218
355030814000041,1,100,57,128,128,88,344
355030814000042,1,73,32,132,132,120,384
355030814000043,1,105,49,170,170,154,494
355030814000044,1,160,99,207,207,143,557
355030814000045,1,108,63,190,190,176,556
355030814000046,1,128,63,158,158,113,429
355030814000047,1,105,60,149,149,107,405
355030814000048,1,64,39,91,91,72,254
355030814000049,1,163,76,296,296,196,788
355030814000050,1,95,33,185,185,121,491
355030814000052,1,113,50,376,376,116,868
355030814000053,1,85,14,263,263,73,599
355030814000054,1,166,36,278,278,91,647
355030814000055,1,118,32,251,251,66,568
355030814000056,1,100,34,268,268,107,643
355030815000001,1,39,39,101,101,118,320
355030815000002,1,25,15,68,68,65,201
355030815000003,1,199,65,134,134,40,308
355030815000004,1,151,58,128,128,53,309
355030815000005,1,179,36,90,90,39,219
355030815000006,1,106,64,187,187,136,510
355030815000007,1,67,35,162,162,117,441
355030815000008,1,71,28,117,117,133,367
355030815000009,1,19,22,64,64,62,190
355030815000010,1,29,27,106,106,96,308
355030815000011,1,38,35,166,166,116,448
355030815000012,1,29,19,94,94,80,268
355030815000013,1,46,17,120,120,108,348
355030815000014,1,58,32,147,147,123,417
355030815000015,1,169,74,366,366,119,851
355030815000017,1,57,24,107,107,104,318
355030815000018,1,151,58,125,125,65,315
355030815000019,1,72,37,115,115,110,340
355030815000020,1,76,70,126,126,124,376
355030815000021,1,112,43,163,163,125,451
355030815000022,1,122,45,166,166,92,424
355030815000023,1,55,15,107,107,77,291
355030815000024,1,46,26,89,89,122,300
355030815000025,1,49,29,94,94,138,326
355030815000026,1,70,30,119,119,114,352
355030815000027,1,41,23,112,112,100,324
355030815000028,1,43,20,104,104,109,317
355030815000029,1,0,3,4,4,6,14
355030815000030,1,68,20,100,100,79,279
355030815000031,1,93,31,107,107,70,284
355030815000032,1,94,61,94,94,63,251
355030815000033,1,69,47,130,130,130,390
355030815000034,1,22,21,64,64,47,175
355030815000035,1,37,19,99,99,71,269
355030815000036,1,54,28,112,112,114,338
355030815000037,1,50,32,106,106,110,322
355030815000038,1,47,30,134,134,107,375
355030815000039,1,62,38,133,133,123,389
355030815000040,1,47,22,139,139,91,369
355030815000041,1,24,19,84,84,71,239
355030815000042,1,54,40,118,118,109,345
355030815000043,1,93,35,173,173,122,468
355030815000044,1,38,23,62,62,53,177
355030815000045,1,86,53,136,136,165,437
355030815000046,1,57,38,100,100,103,303
355030815000047,1,51,29,82,82,97,261
355030815000048,1,24,20,43,43,43,129
355030815000049,1,57,32,112,112,117,341
355030815000050,1,48,19,66,66,69,201
355030815000051,1,11,9,75,75,80,230
355030815000052,1,53,14,143,143,92,378
355030815000053,1,54,22,90,90,92,272
355030815000054,1,32,7,75,75,90,240
355030815000055,1,53,22,114,114,107,335
355030815000056,1,47,25,114,114,113,341
355030815000057,1,44,45,114,114,84,312
355030815000058,1,24,14,86,86,49,221
355030815000059,1,28,20,65,65,83,213
355030815000060,1,43,30,115,115,115,345
355030815000061,1,84,59,133,133,142,408
355030815000062,1,52,34,108,108,89,305
355030815000063,1,63,35,138,138,110,386
355030815000064,1,24,23,57,57,72,186
355030815000065,1,88,53,206,206,165,577
355030815000066,1,50,15,102,102,69,273
355030815000067,1,14,22,67,67,77,211
355030815000068,1,50,35,128,128,146,402
355030815000069,1,51,17,92,92,75,259
355030815000070,1,60,29,121,121,84,326
355030815000071,1,39,25,80,80,56,216
355030815000072,1,70,36,125,125,106,356
355030815000073,1,43,24,75,75,98,248
355030815000074,1,24,17,96,96,68,260
355030815000075,1,59,41,117,117,137,371
355030815000076,1,32,13,147,147,105,399
355030815000077,1,33,25,103,103,116,322
355030815000078,1,69,66,157,157,159,473
355030815000079,1,105,53,193,193,160,546
355030815000080,1,47,23,118,118,81,317
355030815000081,1,98,52,158,158,128,444
355030815000082,1,354,140,212,212,80,504
355030815000083,1,63,45,159,159,141,459
355030815000084,1,81,31,137,137,150,424
355030815000085,1,45,22,87,87,119,293
355030815000086,1,27,21,49,49,82,180
355030815000087,1,40,30,75,75,67,217
355030815000088,1,84,39,120,120,166,406
355030815000089,1,27,12,69,69,53,191
355030815000090,1,52,33,102,102,139,343
355030815000091,1,58,46,99,99,155,353
355030815000092,1,63,44,155,155,148,458
355030815000093,1,34,18,109,109,116,334
355030815000094,1,30,23,78,78,87,243
355030815000095,1,21,15,70,70,86,226
355030815000096,1,46,41,113,113,107,333
355030815000097,1,51,45,129,129,90,348
355030815000098,1,48,30,122,122,133,377
355030815000099,1,48,18,99,99,104,302
355030815000100,1,47,23,91,91,100,282
355030815000101,1,56,43,102,102,110,314
355030815000102,1,57,30,99,99,108,306
355030815000103,1,4,3,33,33,19,85
355030815000104,1,82,53,146,146,189,481
355030815000105,1,27,7,50,50,33,133
355030815000106,1,37,24,89,89,73,251
355030815000107,1,15,11,59,59,45,163
355030815000108,1,33,19,76,76,75,227
355030815000109,1,0,2,32,32,5,69
355030815000110,1,12,8,42,42,24,108
355030815000111,1,48,25,122,122,91,335
355030815000112,1,37,12,75,75,68,218
355030815000113,1,25,25,79,79,53,211
355030815000114,1,24,14,63,63,85,211
355030815000115,1,72,27,190,190,67,447
355030815000116,1,56,45,98,98,123,319
355030815000117,1,86,43,147,147,129,423
355030815000118,1,60,34,148,148,136,432
355030815000119,1,18,8,46,46,53,145
355030815000120,1,32,19,65,65,69,199
355030815000121,1,42,24,117,117,90,324
355030815000122,1,44,35,85,85,71,241
355030815000123,1,138,50,224,224,104,552
355030815000124,1,17,19,124,124,61,309
355030815000125,1,40,25,104,104,77,285
355030815000126,1,15,19,38,38,50,126
355030815000127,1,37,19,96,96,58,250
355030815000128,1,96,37,198,198,104,500
355030815000129,1,107,14,238,238,83,559
355030815000130,1,68,24,134,134,95,363
355030815000131,1,62,35,123,123,133,379
355030815000132,1,16,8,91,91,45,227
355030815000133,1,52,34,100,100,102,302
355030815000134,1,28,18,103,103,43,249
355030815000135,1,25,8,55,55,54,164
355030815000136,1,35,21,99,99,86,284
355030815000137,1,11,9,67,67,31,165
355030815000138,1,45,32,66,66,98,230
355030815000139,1,50,26,106,106,93,305
355030815000140,1,66,32,225,225,120,570
355030815000141,1,112,38,88,88,40,216
355030815000142,1,30,20,69,69,66,204
355030815000146,1,45,19,46,46,28,120
355030815000147,1,46,24,36,36,14,86
355030815000148,1,44,16,31,31,20,82
355030816000001,1,123,70,187,187,168,542
355030816000002,1,168,76,189,189,148,526
355030816000003,1,135,78,168,168,123,459
355030816000004,1,83,49,120,120,132,372
355030816000005,1,68,42,116,116,118,350
355030816000006,1,48,37,116,116,123,355
355030816000007,1,63,35,95,95,93,283
355030816000008,1,119,74,183,183,172,538
355030816000009,1,65,39,155,155,114,424
355030816000010,1,106,42,158,158,132,448
355030816000011,1,80,41,179,179,128,486
355030816000012,1,106,81,190,190,111,491
355030816000013,1,101,50,135,135,109,379
355030816000014,1,63,31,98,98,87,283
355030816000015,1,183,80,105,105,78,288
355030816000016,1,117,57,151,151,122,424
355030816000017,1,93,57,159,159,136,454
355030816000018,1,117,78,202,202,208,612
355030816000019,1,76,40,138,138,101,377
355030816000020,1,83,38,119,119,110,348
355030816000021,1,86,36,139,139,128,406
355030816000022,1,99,56,174,174,164,512
355030816000023,1,158,51,326,326,120,772
355030816000024,1,73,29,117,117,87,321
355030816000025,1,178,101,179,179,159,517
355030816000026,1,103,58,191,191,147,529
355030816000027,1,124,90,217,217,163,597
355030816000028,1,170,82,265,265,170,700
355030816000029,1,83,58,151,151,141,443
355030816000030,1,54,36,97,97,97,291
355030816000031,1,54,34,86,86,108,280
355030816000032,1,47,30,103,103,107,313
355030816000033,1,182,111,265,265,224,754
355030816000034,1,154,31,295,295,102,692
355030816000035,1,131,36,271,271,103,645
355030816000036,1,149,57,253,253,156,662
355030816000037,1,96,50,158,158,142,458
355030816000038,1,123,59,177,177,154,508
355030816000039,1,111,92,173,173,191,537
355030816000040,1,86,52,125,125,137,387
355030816000041,1,133,75,231,231,228,690
355030816000042,1,93,46,164,164,126,454
355030816000043,1,66,53,118,118,116,352
355030816000044,1,114,77,166,166,146,478
355030816000045,1,77,27,142,142,91,375
355030816000046,1,39,15,88,88,68,244
355030816000047,1,137,56,131,131,86,348
355030816000048,1,114,57,169,169,98,436
355030816000049,1,94,44,138,138,75,351
355030816000050,1,170,89,273,273,215,761
355030816000051,1,117,86,217,217,241,675
355030816000052,1,76,43,117,117,131,365
355030816000053,1,66,32,92,92,67,251
355030816000054,1,174,95,217,217,188,622
355030816000055,1,90,39,150,150,115,415
355030816000056,1,132,65,199,199,179,577
355030816000057,1,123,74,180,180,192,552
355030816000058,1,112,64,205,205,193,603
355030816000059,1,116,65,201,201,210,612
355030816000060,1,178,78,272,272,263,807
355030816000061,1,85,50,148,148,94,390
355030816000062,1,78,48,118,118,114,350
355030816000063,1,45,33,92,92,75,259
355030816000064,1,59,27,58,58,77,193
355030816000065,1,68,37,131,131,98,360
355030816000066,1,52,28,116,116,90,322
355030816000067,1,9,4,4,4,6,14
355030816000068,1,75,55,141,141,140,422
355030816000069,1,67,47,90,90,116,296
355030816000070,1,86,72,195,195,178,568
355030816000071,1,73,39,158,158,110,426
355030816000072,1,98,42,107,107,111,325
355030816000073,1,108,33,210,210,137,557
355030816000074,1,80,50,156,156,153,465
355030816000075,1,87,49,168,168,144,480
355030816000076,1,89,46,123,123,171,417
355030816000077,1,79,47,164,164,156,484
355030816000078,1,142,63,181,181,155,517
355030816000079,1,169,59,267,267,161,695
355030816000080,1,34,27,93,93,79,265
355030816000081,1,57,45,88,88,142,318
355030816000082,1,190,93,215,215,238,668
355030816000083,1,140,69,137,137,91,365
355030816000084,1,133,51,190,190,111,491
355030816000085,1,169,89,233,233,197,663
355030816000086,1,129,106,285,285,273,843
355030816000087,1,52,30,97,97,80,274
355030816000088,1,127,81,265,265,162,692
355030816000089,1,161,76,317,317,178,812
355030816000090,1,74,54,101,101,122,324
355030816000091,1,66,35,134,134,62,330
355030816000092,2,71,29,115,115,106,336
355030816000093,1,106,53,212,212,115,539
355030816000094,1,86,56,140,140,141,421
355030816000095,1,27,24,60,60,88,208
355030816000096,1,95,60,143,143,199,485
355030816000097,1,52,37,105,105,80,290
355030816000098,1,129,74,196,196,174,566
355030816000099,1,64,44,108,108,103,319
355030816000100,1,22,13,35,35,41,111
355030816000101,1,52,39,94,94,117,305
355030816000102,1,54,40,89,89,89,267
355030816000103,1,79,43,106,106,108,320
355030816000104,1,20,17,26,26,24,76
355030816000105,1,44,25,73,73,57,203
355030816000106,1,119,63,200,200,142,542
355030816000108,1,108,53,165,165,136,466
355030816000109,1,78,32,120,120,126,366
355030816000110,1,60,38,72,72,71,215
355030816000111,1,62,45,111,111,125,347
355030816000112,1,114,25,259,259,69,587
355030816000113,1,100,24,267,267,46,580
355030816000114,1,78,45,69,69,36,174
355030816000115,1,128,58,217,217,68,502
355030816000116,1,141,50,246,246,150,642
355030816000117,1,84,48,96,96,69,261
355030816000118,1,196,99,221,221,120,562
355030816000119,1,79,47,139,139,73,351
355030816000120,1,174,52,282,282,130,694
355030816000121,1,105,36,194,194,64,452
355030816000122,1,68,43,186,186,70,442
355030816000123,1,180,49,331,331,119,781
355030816000124,1,62,47,89,89,87,265
355030816000125,1,125,41,146,146,129,421
355030816000126,1,122,37,340,340,73,753
355030816000127,1,60,42,141,141,89,371
355030816000128,1,9,2,7,7,5,19
355030816000129,1,93,63,160,160,182,502
355030816000130,1,130,63,202,202,152,556
355030816000131,1,99,53,161,161,122,444
355030816000133,1,125,70,218,218,189,625
355030816000134,1,108,47,207,207,141,555
355030816000135,1,53,22,78,78,47,203
355030816000136,1,66,27,123,123,29,275
355030816000137,1,91,33,135,135,52,322
355030816000138,1,53,11,141,141,27,309
355030816000139,1,106,27,240,240,65,545
355030816000140,1,101,46,226,226,128,580
355030816000141,1,88,63,191,191,146,528
355030816000142,1,67,41,133,133,93,359
355030816000143,1,149,50,123,123,149,395
355030816000144,1,102,85,181,181,188,550
355030816000145,1,55,39,108,108,98,314
355030816000146,1,58,32,96,96,70,262
355030816000147,1,68,49,149,149,118,416
355030816000148,1,332,152,272,272,145,689
355030816000149,1,44,13,123,123,55,301
355030816000150,1,0,0,0,0,0,0
355030816000151,1,46,41,115,115,126,356
355030816000152,1,82,37,114,114,95,323
355030816000153,1,39,24,80,80,92,252
355030816000154,1,71,33,100,100,110,310
355030816000155,1,120,59,182,182,143,507
355030816000156,1,58,34,124,124,87,335
355030816000157,1,52,47,67,67,123,257
355030816000158,1,60,19,83,83,67,233
355030816000159,1,70,39,109,109,104,322
355030816000160,1,0,0,0,0,0,0
355030816000161,1,11,6,13,13,13,39
355030816000162,1,55,29,83,83,47,213
355030816000163,1,72,20,113,113,52,278
355030816000164,1,40,17,112,112,58,282
355030816000165,1,59,16,127,127,26,280
355030816000166,1,48,17,93,93,27,213
355030816000167,2,40,21,66,66,50,182
355030816000168,2,104,38,118,118,55,291
355030816000169,2,0,0,0,0,0,0
355030816000170,2,26,34,51,51,38,140
355030816000171,2,11,5,18,18,12,48
355030816000174,1,75,48,106,106,80,292
355030816000175,1,49,16,49,49,16,114
355030816000176,1,44,16,37,37,21,95
355030816000177,1,60,21,48,48,16,112
355030816000178,1,13,7,18,18,23,59
355030817000001,1,123,56,161,161,94,416
355030817000002,1,61,37,81,81,61,223
355030817000003,1,192,94,209,209,202,620
355030817000004,1,103,48,161,161,121,443
355030817000005,1,200,102,243,243,218,704
355030817000006,1,102,40,112,112,71,295
355030817000007,1,24,20,48,48,46,142
355030817000008,1,105,42,107,107,39,253
355030817000009,1,66,32,80,80,112,272
355030817000010,1,53,34,88,88,49,225
355030817000011,1,536,238,560,560,297,1417
355030817000012,1,92,43,117,117,124,358
355030817000013,1,149,71,180,180,129,489
355030817000014,1,114,61,166,166,117,449
355030817000015,1,151,77,221,221,154,596
355030817000016,1,120,51,123,123,86,332
355030817000017,1,116,39,120,120,71,311
355030817000018,1,100,48,145,145,122,412
355030817000019,1,73,32,96,96,77,269
355030817000020,1,132,87,190,190,163,543
355030817000021,1,69,28,97,97,76,270
355030817000022,1,124,76,143,143,99,385
355030817000023,1,123,70,182,182,149,513
355030817000024,1,117,68,176,176,138,490
355030817000025,1,104,62,155,155,160,470
355030817000026,1,91,42,120,120,91,331
355030817000027,1,82,53,104,104,52,260
355030817000028,1,105,41,187,187,70,444
355030817000029,1,81,39,109,109,61,279
355030817000030,1,150,52,135,135,83,353
355030817000031,1,158,81,134,134,79,347
355030817000032,1,68,33,83,83,56,222
355030817000033,1,85,42,117,117,101,335
355030817000034,1,100,62,172,172,102,446
355030817000035,1,391,139,627,627,221,1475
355030817000036,1,224,97,426,426,239,1091
355030817000037,1,167,97,244,244,198,686
355030817000038,1,131,60,209,209,176,594
355030817000039,1,190,97,227,227,179,633
355030817000040,1,142,88,187,187,127,501
355030817000041,1,287,144,332,332,164,828
355030817000042,1,103,20,88,88,38,214
355030817000043,1,128,43,127,127,41,295
355030817000044,1,164,64,162,162,57,381
355030817000045,1,105,39,161,161,61,383
355030817000046,1,153,103,182,182,126,490
355030817000047,1,70,41,103,103,52,258
355030817000048,1,104,51,163,163,145,471
355030817000049,1,79,28,130,130,97,357
355030817000050,1,101,56,121,121,86,328
355030817000051,1,158,70,206,206,187,599
355030817000052,1,95,56,104,104,120,328
355030817000053,1,57,42,68,68,80,216
355030817000054,1,113,60,135,135,92,362
355030817000055,1,387,161,372,372,236,980
355030817000056,1,72,29,74,74,60,208
355030817000057,1,215,102,201,201,116,518
355030817000058,1,112,45,98,98,45,241
355030817000059,1,185,65,174,174,135,483
355030817000060,1,71,24,69,69,52,190
355030817000061,1,136,43,154,154,47,355
355030817000062,1,288,112,252,252,101,605
355030817000063,1,126,76,141,141,96,378
355030817000064,1,201,85,262,262,142,666
355030817000065,1,261,79,268,268,215,751
355030817000066,1,148,84,192,192,73,457
355030817000067,1,116,56,143,143,93,379
355030817000068,1,145,55,151,151,69,371
355030817000069,1,93,50,134,134,90,358
355030817000070,1,120,58,175,175,159,509
355030817000071,1,98,53,166,166,133,465
355030817000072,1,105,43,158,158,98,414
355030817000073,1,24,10,18,18,7,43
355030817000074,1,25,9,30,30,23,83
355030817000075,1,212,99,180,180,112,472
355030817000076,1,96,45,115,115,58,288
355030817000077,1,118,86,165,165,117,447
355030817000078,1,139,74,188,188,111,487
355030817000079,1,100,46,139,139,59,337
355030817000080,1,92,40,99,99,75,273
355030817000081,1,249,106,218,218,105,541
355030817000082,1,59,30,70,70,55,195
355030817000083,1,153,83,154,154,101,409
355030817000084,1,135,83,156,156,118,430
355030817000085,1,130,78,204,204,162,570
355030817000086,1,82,52,108,108,109,325
355030817000087,1,73,34,152,152,110,414
355030817000088,1,119,71,139,139,109,387
355030817000089,1,45,19,44,44,31,119
355030817000090,1,269,121,269,269,169,707
355030817000091,1,159,60,115,115,58,288
355030817000092,1,206,101,173,173,89,435
355030817000093,1,102,43,121,121,109,351
355030817000094,1,150,77,167,167,120,454
355030817000095,1,129,94,204,204,106,514
355030817000096,1,82,42,95,95,53,243
355030817000097,1,68,31,91,91,65,247
355030817000098,1,331,150,356,356,208,920
355030817000099,1,76,42,83,83,60,226
355030817000100,1,153,74,170,170,127,467
355030817000101,1,144,71,157,157,93,407
355030817000102,1,218,97,242,242,156,640
355030817000103,1,75,57,79,79,92,250
355030817000104,1,185,75,232,232,136,600
355030817000105,1,45,14,73,73,36,182
355030817000106,1,146,65,149,149,116,414
355030817000107,1,410,172,369,369,153,891
355030817000108,1,118,79,172,172,172,516
355030817000109,1,104,61,184,184,162,530
355030817000110,1,101,32,72,72,57,201
355030817000111,1,159,110,171,171,236,578
355030817000112,1,85,32,184,184,79,447
355030817000113,1,131,61,160,160,116,436
355030817000114,1,96,21,145,145,78,368
355030817000115,1,47,28,52,52,58,162
355030817000116,1,338,151,277,277,115,669
355030817000117,1,63,40,77,77,45,199
355030817000118,1,199,122,245,245,176,666
355030817000119,1,104,37,116,116,44,276
355030817000120,1,231,102,168,168,87,423
355030817000121,1,139,75,262,262,151,675
355030817000122,1,333,93,583,583,205,1371
355030817000123,1,384,142,348,348,133,829
355030817000124,1,160,79,172,172,99,443
355030817000125,1,74,36,86,86,58,230
355030817000126,1,106,53,112,112,47,271
355030817000127,1,126,55,132,132,47,311
355030817000128,1,84,37,65,65,44,174
355030817000129,1,147,87,190,190,129,509
355030817000130,1,274,105,300,300,152,752
355030817000131,1,232,102,248,248,131,627
355030817000132,1,95,42,132,132,89,353
355030817000133,1,82,57,139,139,157,435
355030817000134,1,257,93,363,363,183,909
355030817000135,1,47,42,78,78,98,254
355030817000136,1,70,50,117,117,100,334
355030817000137,1,157,77,182,182,145,509
355030817000138,1,151,70,181,181,139,501
355030817000139,1,148,60,159,159,91,409
355030817000140,1,52,20,56,56,41,153
355030817000141,1,170,72,283,283,122,688
355030817000142,1,172,62,106,106,44,256
355030817000143,1,214,69,232,232,147,611
355030817000144,1,141,53,145,145,126,416
355030817000145,1,230,92,296,296,147,739
355030817000146,1,195,99,255,255,109,619
355030817000147,1,160,86,159,159,59,377
355030817000148,1,276,120,303,303,186,792
355030817000149,1,210,122,203,203,127,533
355030817000150,1,261,145,298,298,164,760
355030817000151,1,181,93,196,196,63,455
355030817000152,1,97,72,106,106,62,274
355030817000153,1,277,114,282,282,166,730
355030817000154,1,228,89,203,203,88,494
355030817000155,1,108,60,118,118,91,327
355030817000156,1,263,150,312,312,176,800
355030817000157,1,53,20,46,46,20,112
355030817000158,1,102,70,187,187,156,530
355030817000159,1,77,58,95,95,83,273
355030817000160,1,183,103,346,346,272,964
355030817000161,1,105,57,205,205,154,564
355030817000162,1,69,37,116,116,87,319
355030817000163,1,123,71,154,154,173,481
355030817000164,1,207,105,263,263,164,690
355030817000165,1,49,24,86,86,78,250
355030817000166,1,139,63,269,269,156,694
355030817000167,1,162,87,200,200,149,549
355030817000168,1,433,182,419,419,133,971
355030817000169,1,270,94,238,238,99,575
355030817000170,1,156,66,185,185,110,480
355030817000171,1,120,68,117,117,83,317
355030817000172,1,204,93,245,245,138,628
355030817000173,1,173,59,212,212,161,585
355030817000174,1,162,58,192,192,151,535
355030817000175,1,157,77,184,184,93,461
355030817000176,1,157,67,209,209,122,540
355030817000177,1,668,313,723,723,393,1839
355030817000178,1,75,39,65,65,25,155
355030817000179,1,245,108,263,263,143,669
355030817000180,1,153,85,251,251,179,681
355030817000181,1,102,31,73,73,34,180
355030817000182,1,161,71,194,194,102,490
355030817000183,1,163,65,178,178,97,453
355030817000184,1,167,113,208,208,184,600
355030817000185,1,132,53,107,107,31,245
355030817000186,1,121,72,168,168,125,461
355030817000187,1,103,51,107,107,115,329
355030817000188,1,145,66,216,216,124,556
355030817000189,1,73,48,80,80,84,244
355030817000190,1,122,57,188,188,130,506
355030817000191,1,71,34,148,148,86,382
355030817000192,1,255,131,340,340,219,899
355030817000193,1,247,105,281,281,128,690
355030817000194,1,108,44,136,136,95,367
355030817000195,1,362,178,416,416,136,968
355030817000196,1,19,18,18,18,14,50
355030817000197,1,147,74,169,169,109,447
355030817000198,1,159,87,176,176,130,482
355030817000199,1,156,53,172,172,57,401
355030817000200,1,132,56,143,143,109,395
355030817000201,1,112,55,149,149,109,407
355030817000202,1,129,55,139,139,112,390
355030817000203,1,62,30,63,63,34,160
355030817000204,1,240,103,391,391,190,972
355030817000205,1,233,82,196,196,83,475
355030817000206,1,78,66,103,103,34,240
355030817000207,1,88,51,135,135,81,351
355030817000208,1,79,43,78,78,82,238
355030817000209,1,32,11,37,37,25,99
355030817000210,1,65,33,74,74,36,184
355030817000211,1,118,66,235,235,134,604
355030817000212,1,155,37,198,198,69,465
355030817000213,1,109,51,104,104,50,258
355030817000214,1,118,66,107,107,55,269
355030817000215,1,172,121,219,219,121,559
355030817000216,1,230,124,245,245,167,657
355030817000217,1,221,116,227,227,160,614
355030817000218,1,235,119,253,253,152,658
355030817000219,1,49,39,98,98,67,263
355030817000220,1,202,71,151,151,58,360
355030817000221,1,184,62,180,180,218,578
355030817000222,1,166,66,180,180,101,461
355030817000223,1,115,54,100,100,51,251
355030817000224,1,141,66,148,148,108,404
355030817000225,1,158,72,194,194,99,487
355030817000226,1,144,66,173,173,110,456
355030817000227,1,131,57,173,173,83,429
355030817000228,1,78,63,101,101,65,267
355030817000229,1,91,50,116,116,88,320
355030817000230,1,89,42,141,141,112,394
355030817000231,1,285,112,244,244,114,602
355030817000232,1,93,60,123,123,103,349
355030817000233,1,108,67,140,140,149,429
355030817000234,1,33,33,53,53,42,148
355030817000235,1,130,66,148,148,108,404
355030817000236,1,107,33,136,136,121,393
355030817000237,1,94,50,106,106,59,271
355030817000238,1,126,55,99,99,59,257
355030817000239,1,36,17,66,66,25,157
355030817000240,1,20,8,26,26,7,59
355030817000241,1,184,57,134,134,43,311
355030817000242,1,84,20,83,83,23,189
355030817000243,1,60,18,111,111,50,272
355030817000244,1,87,50,93,93,88,274
355030817000245,1,145,65,145,145,80,370
355030817000246,1,38,15,47,47,56,150
355030817000247,1,63,43,88,88,77,253
355030817000248,1,97,36,66,66,65,197
355030817000249,1,93,54,104,104,71,279
355030817000250,1,107,39,96,96,41,233
355030817000251,1,100,48,112,112,44,268
355030817000252,1,134,53,119,119,57,295
355030817000253,1,126,51,154,154,96,404
355030817000254,1,234,83,195,195,81,471
355030817000255,1,136,74,143,143,79,365
355030817000256,1,374,177,320,320,146,786
355030817000257,1,159,69,163,163,97,423
355030817000258,1,122,64,177,177,77,431
355030817000259,1,109,60,141,141,110,392
355030817000260,1,95,68,103,103,91,297
355030817000261,1,100,58,142,142,117,401
355030817000262,1,142,36,116,116,43,275
355030817000263,1,23,20,17,17,18,52
355030817000264,1,160,69,206,206,143,555
355030817000265,1,86,47,121,121,129,371
355030817000266,1,166,60,421,421,116,958
355030817000267,1,0,0,0,0,0,0
355030817000268,1,329,118,264,264,128,656
355030817000269,1,63,16,59,59,39,157
355030817000270,1,93,54,124,124,52,300
355030817000271,1,100,67,159,159,141,459
355030817000272,1,46,32,86,86,81,253
355030817000273,1,209,93,304,304,101,709
355030817000274,1,167,82,214,214,98,526
355030817000275,1,119,45,79,79,89,247
355030817000276,1,72,32,59,59,28,146
355030817000277,1,137,73,132,132,61,325
355030817000278,1,154,70,177,177,106,460
355030817000279,1,210,130,315,315,259,889
355030817000280,1,58,34,120,120,72,312
355030817000281,1,94,72,151,151,81,383
355030817000282,1,148,62,138,138,35,311
355030817000283,1,137,87,156,156,123,435
355030817000284,1,183,80,225,225,114,564
355030817000285,1,34,23,29,29,16,74
355030817000286,1,89,38,73,73,36,182
355030817000287,1,21,10,25,25,16,66
355030817000288,1,66,35,124,124,83,331
355030817000289,1,202,83,297,297,116,710
355030817000290,1,148,53,117,117,63,297
355030817000291,1,101,43,98,98,68,264
355030817000292,1,31,15,32,32,16,80
355030817000293,1,59,34,69,69,29,167
355030817000296,1,38,10,38,38,22,98
355030817000298,1,126,62,127,127,71,325
355030817000299,1,67,23,128,128,34,290
355030817000301,1,117,26,288,288,47,623
355030817000302,1,13,6,32,32,2,66
355030817000303,1,68,14,138,138,14,290
355030817000304,1,225,127,269,269,118,656
355030817000305,1,263,87,243,243,95,581
355030817000307,1,50,33,72,72,25,169
355030817000308,1,35,17,47,47,22,116
355030817000309,1,22,12,37,37,11,85
355030817000310,1,33,17,27,27,15,69
355030817000311,1,90,33,111,111,31,253
355030817000312,1,89,37,93,93,27,213
355030817000313,1,112,54,104,104,44,252
355030817000314,1,0,0,0,0,0,0
355030817000315,1,61,28,66,66,24,156
355030817000316,1,61,36,70,70,45,185
355030817000317,1,23,12,26,26,27,79
355030817000318,1,22,17,41,41,25,107
355030817000319,1,89,48,115,115,74,304
355030817000320,1,38,28,34,34,37,105
355030817000321,1,60,28,56,56,26,138
355030817000322,1,54,21,48,48,25,121
355030817000323,1,64,40,69,69,18,156
355030817000324,1,79,36,78,78,46,202
355030817000325,1,134,44,116,116,56,288
355030817000326,1,70,37,64,64,31,159
355030817000327,1,53,22,58,58,45,161
355030817000328,1,58,28,54,54,25,133
355030817000329,1,100,46,87,87,51,225
355030817000330,1,236,81,232,232,62,526
355030817000331,1,80,26,50,50,46,146
355030817000332,1,85,29,45,45,21,111
355030818000001,1,54,33,70,70,50,190
355030818000002,1,257,90,409,409,212,1030
355030818000003,1,117,52,120,120,90,330
355030818000004,1,129,68,114,114,110,338
355030818000005,1,165,73,157,157,112,426
355030818000006,1,127,50,181,181,109,471
355030818000007,1,186,76,280,280,176,736
355030818000008,1,72,51,103,103,67,273
355030818000009,1,89,66,121,121,120,362
355030818000010,1,146,57,177,177,133,487
355030818000011,1,223,106,264,264,165,693
355030818000012,1,156,77,132,132,57,321
355030818000013,1,322,135,316,316,141,773
355030818000014,1,647,280,496,496,255,1247
355030818000015,1,103,43,87,87,24,198
355030818000016,1,146,53,129,129,94,352
355030818000017,1,120,63,172,172,166,510
355030818000018,1,143,70,212,212,132,556
355030818000019,1,189,109,341,341,214,896
355030818000020,1,142,68,213,213,168,594
355030818000021,1,138,79,192,192,169,553
355030818000022,1,116,84,151,151,143,445
355030818000023,1,86,40,118,118,102,338
355030818000024,1,82,114,170,170,138,478
355030818000025,1,104,40,141,141,107,389
355030818000026,1,63,38,99,99,91,289
355030818000027,1,128,50,150,150,80,380
355030818000028,1,94,38,115,115,82,312
355030818000029,1,148,74,209,209,116,534
355030818000030,1,207,102,251,251,164,666
355030818000031,1,216,73,216,216,144,576
355030818000032,1,94,55,144,144,112,400
355030818000033,1,131,70,119,119,99,337
355030818000034,1,165,76,261,261,156,678
355030818000035,1,63,40,117,117,106,340
355030818000036,1,119,69,135,135,89,359
355030818000037,1,87,59,145,145,106,396
355030818000038,1,109,57,122,122,111,355
355030818000039,1,220,98,323,323,146,792
355030818000040,1,145,90,134,134,112,380
355030818000041,1,0,0,0,0,0,0
355030818000042,1,155,82,198,198,152,548
355030818000043,1,106,46,125,125,98,348
355030818000044,1,97,64,133,133,113,379
355030818000045,1,124,65,120,120,122,362
355030818000046,1,205,108,240,240,205,685
355030818000047,1,113,49,132,132,102,366
355030818000048,1,58,34,66,66,49,181
355030818000049,1,181,103,230,230,152,612
355030818000050,1,131,62,170,170,133,473
355030818000051,1,38,16,44,44,20,108
355030818000052,1,89,44,117,117,99,333
355030818000053,1,164,76,320,320,163,803
355030818000054,1,61,18,95,95,57,247
355030818000055,1,90,36,93,93,68,254
355030818000056,1,49,20,74,74,52,200
355030818000057,1,89,63,145,145,158,448
355030818000058,1,42,35,69,69,80,218
355030818000059,1,62,33,78,78,80,236
355030818000060,1,77,51,124,124,92,340
355030818000061,1,135,58,178,178,131,487
355030818000062,1,167,99,171,171,176,518
355030818000063,1,241,115,293,293,197,783
355030818000064,1,106,57,172,172,139,483
355030818000065,1,72,41,134,134,84,352
355030818000066,1,226,116,257,257,188,702
355030818000067,1,166,93,220,220,191,631
355030818000068,1,96,46,124,124,97,345
355030818000069,1,201,119,249,249,228,726
355030818000070,1,232,97,213,213,185,611
355030818000071,1,96,59,117,117,110,344
355030818000072,1,298,130,331,331,195,857
355030818000073,1,108,68,172,172,154,498
355030818000074,1,110,63,170,170,144,484
355030818000075,1,121,79,150,150,179,479
355030818000076,1,157,59,180,180,136,496
355030818000077,1,99,50,126,126,144,396
355030818000078,1,132,63,158,158,147,463
355030818000079,1,141,76,199,199,166,564
355030818000080,1,160,80,167,167,69,403
355030818000081,1,261,81,288,288,109,685
355030818000082,1,157,108,156,156,137,449
355030818000083,1,200,127,235,235,220,690
355030818000084,1,134,61,190,190,139,519
355030818000085,1,87,55,111,111,106,328
355030818000086,1,82,43,101,101,82,284
355030818000087,1,223,104,201,201,147,549
355030818000088,1,103,42,132,132,90,354
355030818000089,1,182,89,238,238,200,676
355030818000090,1,71,42,112,112,84,308
355030818000091,1,75,34,90,90,120,300
355030818000092,1,144,78,195,195,120,510
355030818000093,1,106,59,152,152,136,440
355030818000094,1,120,61,140,140,107,387
355030818000095,1,104,64,136,136,131,403
355030818000096,1,155,63,147,147,76,370
355030818000097,1,80,37,85,85,48,218
355030818000098,1,82,29,150,150,60,360
355030818000099,1,142,35,215,215,89,519
355030818000100,1,122,95,135,135,176,446
355030818000101,1,152,101,180,180,121,481
355030818000102,1,106,57,143,143,95,381
355030818000103,1,85,43,106,106,84,296
355030818000104,1,94,40,128,128,109,365
355030818000105,1,102,39,112,112,91,315
355030818000106,1,96,82,119,119,140,378
355030818000107,1,111,57,140,140,102,382
355030818000108,1,73,27,83,83,63,229
355030818000109,1,99,61,114,114,141,369
355030818000110,1,63,37,110,110,91,311
355030818000111,1,112,49,112,112,96,320
355030818000112,1,0,0,0,0,0,0
355030818000113,1,216,109,230,230,115,575
355030818000114,1,390,166,423,423,206,1052
355030818000115,1,100,64,127,127,88,342
355030818000116,1,98,66,142,142,95,379
355030818000117,1,76,42,95,95,178,368
355030818000118,1,178,112,219,219,193,631
355030818000119,1,104,72,149,149,97,395
355030818000120,1,94,47,152,152,118,422
355030818000121,1,65,48,75,75,97,247
355030818000122,1,64,33,104,104,97,305
355030818000123,1,121,84,183,183,145,511
355030818000124,1,63,45,105,105,101,311
355030818000125,1,57,26,66,66,39,171
355030818000126,1,94,49,136,136,99,371
355030818000127,1,75,40,135,135,101,371
355030818000128,1,173,64,176,176,152,504
355030818000129,1,131,73,197,197,144,538
355030818000130,1,97,50,112,112,65,289
355030818000131,1,62,35,83,83,70,236
355030818000132,1,118,75,154,154,106,414
355030818000133,1,83,48,96,96,84,276
355030818000134,1,93,45,101,101,85,287
355030818000135,1,141,100,190,190,241,621
355030818000136,1,101,49,164,164,127,455
355030818000137,1,155,69,212,212,171,595
355030818000138,1,74,77,121,121,181,423
355030818000139,1,174,105,168,168,181,517
355030818000140,1,111,56,122,122,103,347
355030818000141,1,198,85,226,226,177,629
355030818000142,1,133,58,147,147,116,410
355030818000143,1,119,56,146,146,105,397
355030818000144,1,81,51,121,121,108,350
355030818000145,1,156,88,205,205,180,590
355030818000146,1,129,89,191,191,178,560
355030818000147,1,127,52,177,177,130,484
355030818000148,1,119,70,147,147,143,437
355030818000149,1,45,47,73,73,78,224
355030818000150,1,94,81,149,149,163,461
355030818000151,1,35,30,54,54,54,162
355030818000152,1,105,53,130,130,101,361
355030818000153,1,68,34,72,72,78,222
355030818000154,1,92,40,128,128,88,344
355030818000155,1,77,41,92,92,97,281
355030818000156,1,53,41,93,93,114,300
355030818000157,1,154,103,217,217,250,684
355030818000158,1,32,16,44,44,25,113
355030818000159,1,70,42,74,74,80,228
355030818000160,1,101,49,102,102,68,272
355030818000161,1,66,40,96,96,97,289
355030818000162,1,77,73,132,132,132,396
355030818000163,1,130,81,145,145,130,420
355030818000164,1,36,17,36,36,38,110
355030818000165,1,107,39,116,116,75,307
355030818000166,1,136,82,172,172,90,434
355030818000167,1,156,73,210,210,139,559
355030818000168,1,145,56,164,164,78,406
355030818000169,1,94,39,109,109,107,325
355030818000170,1,99,66,108,108,95,311
355030818000171,1,114,83,122,122,103,347
355030818000172,1,118,65,133,133,114,380
355030818000173,1,101,52,125,125,98,348
355030818000174,1,73,49,114,114,113,341
355030818000175,1,107,64,151,151,99,401
355030818000176,1,102,40,130,130,106,366
355030818000177,1,71,32,69,69,40,178
355030818000178,1,59,26,65,65,54,184
355030818000179,1,65,43,103,103,77,283
355030818000180,1,93,53,125,125,72,322
355030818000181,1,200,111,199,199,166,564
355030818000182,1,154,91,180,180,152,512
355030818000183,1,123,59,145,145,138,428
355030818000184,1,62,40,117,117,41,275
355030818000185,1,94,49,122,122,119,363
355030818000186,1,65,36,89,89,103,281
355030818000187,1,88,43,119,119,111,349
355030818000188,1,40,19,57,57,30,144
355030818000189,1,177,63,175,175,83,433
355030818000190,1,169,82,169,169,106,444
355030818000191,1,135,63,104,104,54,262
355030818000192,1,140,35,96,96,39,231
355030818000193,1,384,175,366,366,138,870
355030818000194,1,152,76,196,196,157,549
355030818000195,1,225,81,181,181,65,427
355030818000196,1,177,69,135,135,50,320
355030818000197,1,187,77,173,173,118,464
355030818000198,1,139,74,180,180,114,474
355030818000199,1,141,68,166,166,115,447
355030818000200,1,86,52,120,120,110,350
355030818000201,1,56,25,95,95,73,263
355030818000202,1,112,65,135,135,92,362
355030818000203,1,164,40,221,221,77,519
355030818000204,1,71,37,74,74,32,180
355030818000205,1,55,26,59,59,58,176
355030818000206,1,120,42,112,112,68,292
355030818000207,1,56,33,57,57,42,156
355030818000208,1,57,27,37,37,19,93
355030819000001,1,81,43,88,88,81,257
355030819000002,1,136,79,173,173,125,471
355030819000003,1,138,67,151,151,145,447
355030819000004,1,210,121,227,227,178,632
355030819000005,1,103,59,79,79,58,216
355030819000006,1,133,66,179,179,119,477
355030819000007,1,160,60,110,110,57,277
355030819000008,1,149,50,180,180,93,453
355030819000009,1,79,48,117,117,101,335
355030819000010,1,139,56,190,190,134,514
355030819000011,1,123,68,163,163,90,416
355030819000012,1,52,38,85,85,67,237
355030819000013,1,137,79,178,178,114,470
355030819000014,1,110,46,163,163,98,424
355030819000015,1,138,70,199,199,112,510
355030819000016,1,63,23,84,84,36,204
355030819000017,1,129,44,111,111,52,274
355030819000018,1,74,40,99,99,65,263
355030819000019,1,213,103,268,268,191,727
355030819000020,1,93,59,113,113,86,312
355030819000021,1,204,100,223,223,128,574
355030819000022,1,125,51,128,128,127,383
355030819000023,1,197,107,204,204,149,557
355030819000024,1,253,124,263,263,198,724
355030819000025,1,97,62,140,140,107,387
355030819000026,1,129,67,145,145,128,418
355030819000027,1,108,49,120,120,110,350
355030819000028,1,154,62,200,200,122,522
355030819000029,1,106,60,151,151,97,399
355030819000030,1,144,70,189,189,136,514
355030819000031,1,102,50,106,106,52,264
355030819000032,1,56,32,100,100,96,296
355030819000033,1,134,54,226,226,91,543
355030819000034,1,113,44,155,155,156,466
355030819000035,1,106,42,137,137,113,387
355030819000036,1,130,78,189,189,144,522
355030819000037,1,276,146,301,301,188,790
355030819000038,1,105,52,86,86,44,216
355030819000039,1,130,54,177,177,119,473
355030819000040,1,173,104,221,221,139,581
355030819000041,1,222,83,307,307,128,742
355030819000042,1,131,62,140,140,100,380
355030819000043,1,155,75,190,190,98,478
355030819000044,1,101,58,110,110,101,321
355030819000045,1,138,57,142,142,84,368
355030819000046,1,116,43,124,124,65,313
355030819000047,1,200,79,173,173,151,497
355030819000048,1,140,70,120,120,89,329
355030819000049,1,99,41,120,120,97,337
355030819000050,1,105,38,114,114,92,320
355030819000051,1,215,102,263,263,151,677
355030819000052,1,157,83,195,195,134,524
355030819000053,1,100,57,122,122,83,327
355030819000054,1,130,64,130,130,93,353
355030819000055,1,120,51,123,123,66,312
355030819000056,1,361,177,406,406,207,1019
355030819000057,1,121,80,130,130,83,343
355030819000058,1,184,82,209,209,104,522
355030819000059,1,114,67,142,142,87,371
355030819000060,1,270,100,268,268,170,706
355030819000061,1,135,76,205,205,149,559
355030819000062,1,156,102,178,178,138,494
355030819000063,1,332,125,275,275,109,659
355030819000064,1,165,70,155,155,101,411
355030819000065,1,147,92,233,233,112,578
355030819000066,1,77,61,120,120,99,339
355030819000067,1,108,54,109,109,76,294
355030819000068,1,66,28,60,60,26,146
355030819000069,1,331,138,282,282,149,713
355030819000070,1,174,68,156,156,78,390
355030819000071,1,226,122,189,189,95,473
355030819000072,1,317,117,294,294,134,722
355030819000073,1,79,33,78,78,55,211
355030819000074,1,109,42,123,123,71,317
355030819000075,1,157,72,145,145,74,364
355030819000076,1,277,97,252,252,136,640
355030819000077,1,147,77,168,168,86,422
355030819000078,1,121,69,109,109,75,293
355030819000079,1,131,68,172,172,136,480
355030819000080,1,235,101,269,269,155,693
355030819000081,1,343,186,376,376,157,909
355030819000082,1,67,51,92,92,68,252
355030819000083,1,275,125,207,207,143,557
355030819000084,1,272,95,200,200,107,507
355030819000085,1,162,93,237,237,321,795
355030819000086,1,92,68,144,144,116,404
355030819000087,1,107,48,139,139,116,394
355030819000088,1,84,37,116,116,83,315
355030819000089,1,103,54,101,101,87,289
355030819000090,1,314,123,281,281,123,685
355030819000091,1,120,73,185,185,120,490
355030819000092,1,70,38,104,104,86,294
355030819000093,1,122,62,148,148,91,387
355030819000094,1,146,76,171,171,71,413
355030819000095,1,145,68,161,161,83,405
355030819000096,1,139,68,143,143,121,407
355030819000097,1,139,61,165,165,137,467
355030819000098,1,185,91,187,187,141,515
355030819000099,1,177,115,193,193,123,509
355030819000100,1,187,90,164,164,94,422
355030819000101,1,212,85,240,240,146,626
355030819000102,1,177,94,162,162,135,459
355030819000103,1,150,87,163,163,125,451
355030819000104,1,96,53,105,105,39,249
355030819000105,1,113,53,139,139,68,346
355030819000106,1,283,121,257,257,144,658
355030819000107,1,84,34,69,69,60,198
355030819000108,1,115,46,118,118,79,315
355030819000109,1,98,39,93,93,51,237
355030819000110,1,82,35,84,84,48,216
355030819000111,1,208,96,227,227,104,558
355030819000112,1,139,70,168,168,88,424
355030819000113,1,145,74,139,139,66,344
355030819000114,1,9,4,15,15,5,35
355030819000115,1,215,127,295,295,112,702
355030819000116,1,327,125,339,339,165,843
355030819000117,1,291,103,239,239,102,580
355030819000118,1,164,82,187,187,134,508
355030819000119,1,78,50,121,121,124,366
355030819000120,1,146,62,192,192,124,508
355030819000121,1,341,132,253,253,152,658
355030819000122,1,210,92,280,280,152,712
355030819000123,1,174,68,117,117,80,314
355030819000124,1,136,80,190,190,116,496
355030819000125,1,88,40,98,98,61,257
355030819000126,1,63,50,83,83,71,237
355030819000127,1,72,39,72,72,56,200
355030819000128,1,167,74,181,181,120,482
355030819000129,1,173,67,163,163,80,406
355030819000130,1,109,56,143,143,88,374
355030819000131,1,146,77,207,207,101,515
355030819000132,1,279,133,306,306,155,767
355030819000133,1,288,132,266,266,141,673
355030819000134,1,257,115,325,325,152,802
355030819000135,1,145,80,166,166,103,435
355030819000136,1,176,86,208,208,130,546
355030819000137,1,121,56,162,162,79,403
355030819000138,1,136,73,154,154,112,420
355030819000139,1,207,82,237,237,131,605
355030819000140,1,73,18,57,57,9,123
355030819000141,1,214,91,181,181,93,455
355030819000142,1,49,26,50,50,37,137
355030819000143,1,60,43,66,66,39,171
355030819000144,1,207,104,216,216,97,529
355030819000145,1,123,81,172,172,99,443
355030819000146,1,271,143,325,325,146,796
355030819000147,1,58,32,55,55,21,131
355030819000148,1,236,111,237,237,131,605
355030819000149,1,136,59,134,134,106,374
355030819000150,1,229,107,331,331,146,808
355030819000151,1,158,89,139,139,86,364
355030819000152,1,359,210,478,478,237,1193
355030819000153,1,130,80,155,155,90,400
355030819000154,1,222,126,290,290,184,764
355030819000155,1,176,87,247,247,242,736
355030819000156,1,84,58,156,156,152,464
355030819000157,1,67,40,111,111,71,293
355030819000158,1,115,49,153,153,135,441
355030819000159,1,180,82,214,214,128,556
355030819000160,1,126,42,148,148,80,376
355030819000161,1,200,101,155,155,103,413
355030819000162,1,202,114,248,248,176,672
355030819000163,1,96,51,116,116,48,280
355030819000164,1,121,63,110,110,122,342
355030819000165,1,194,91,217,217,91,525
355030819000166,1,215,110,192,192,173,557
355030819000167,1,134,72,206,206,88,500
355030819000168,1,164,54,158,158,104,420
355030819000169,1,191,89,158,158,128,444
355030819000170,1,115,47,90,90,60,240
355030819000171,1,32,14,30,30,14,74
355030819000172,1,154,74,140,140,74,354
355030819000173,1,181,71,194,194,103,491
355030819000174,1,183,88,209,209,135,553
355030819000175,1,153,76,191,191,87,469
355030819000176,1,232,136,197,197,129,523
355030819000177,1,90,38,91,91,56,238
355030819000178,1,210,111,245,245,149,639
355030819000179,1,181,90,192,192,123,507
355030819000180,1,93,34,113,113,64,290
355030819000181,1,145,113,212,212,245,669
355030819000182,1,95,48,126,126,113,365
355030819000183,1,95,60,175,175,159,509
355030819000184,1,25,13,36,36,30,102
355030819000185,1,208,74,175,175,72,422
355030819000186,1,20,11,23,23,9,55
355030819000187,1,104,40,95,95,51,241
355030819000188,1,160,76,177,177,95,449
355030819000189,1,180,61,166,166,99,431
355030819000190,1,134,58,130,130,91,351
355030819000191,1,172,76,153,153,134,440
355030819000192,1,138,57,167,167,110,444
355030819000193,1,260,98,254,254,134,642
355030819000194,1,73,29,79,79,51,209
355030819000195,1,168,55,186,186,102,474
355030819000196,1,237,133,304,304,174,782
355030819000197,1,42,33,39,39,45,123
355030819000198,1,213,102,252,252,130,634
355030819000199,1,228,108,222,222,119,563
355030819000200,1,241,142,284,284,190,758
355030819000201,1,140,75,143,143,107,393
355030819000202,1,191,75,202,202,122,526
355030819000203,1,377,181,411,411,247,1069
355030819000204,1,93,62,139,139,91,369
355030819000205,1,133,53,122,122,85,329
355030819000206,1,229,92,248,248,127,623
355030819000207,1,251,82,356,356,150,862
355030819000208,1,235,97,246,246,139,631
355030819000209,1,79,24,92,92,44,228
355030819000210,1,247,117,264,264,124,652
355030819000211,1,74,55,92,92,47,231
355030819000212,1,236,98,206,206,107,519
355030819000213,1,289,149,294,294,206,794
355030819000214,1,108,41,109,109,72,290
355030819000215,1,283,123,291,291,141,723
355030819000216,1,434,191,408,408,158,974
355030819000217,1,107,31,146,146,85,377
355030819000218,1,101,61,105,105,59,269
355030819000219,1,128,60,205,205,135,545
355030819000220,1,102,42,118,118,81,317
355030819000221,1,113,62,159,159,108,426
355030819000222,1,92,63,140,140,86,366
355030819000223,1,123,50,121,121,97,339
355030819000224,1,209,119,231,231,151,613
355030819000225,1,145,66,135,135,120,390
355030819000226,1,219,79,232,232,127,591
355030819000227,1,184,92,287,287,208,782
355030819000228,1,132,49,164,164,76,404
355030819000229,1,182,57,197,197,54,448
355030819000230,1,194,102,198,198,99,495
355030819000231,1,247,101,247,247,138,632
355030819000232,1,120,60,105,105,105,315
355030819000233,1,192,87,178,178,110,466
355030819000234,1,99,40,123,123,63,309
355030819000235,1,116,55,145,145,88,378
355030819000236,1,262,101,219,219,107,545
355030819000237,1,244,108,207,207,137,551
355030819000238,1,105,41,114,114,74,302
355030819000239,1,227,102,176,176,124,476
355030819000240,1,220,101,173,173,70,416
355030819000241,1,95,45,102,102,69,273
355030819000242,1,117,39,113,113,78,304
355030819000243,1,186,106,258,258,148,664
355030819000244,1,129,36,93,93,23,209
355030819000245,1,98,36,152,152,63,367
355030819000246,1,97,28,88,88,60,236
355030819000247,1,152,72,199,199,145,543
355030819000248,1,113,54,130,130,90,350
355030819000249,1,210,95,215,215,126,556
355030819000250,1,158,73,162,162,79,403
355030819000251,1,155,71,206,206,104,516
355030819000252,1,105,48,136,136,85,357
355030819000253,1,187,85,170,170,98,438
355030819000254,1,126,49,109,109,90,308
355030819000255,1,265,110,237,237,152,626
355030819000256,1,42,34,64,64,51,179
355030819000257,1,59,17,38,38,33,109
355030819000258,1,254,106,251,251,136,638
355030819000259,1,183,73,179,179,95,453
355030819000260,1,154,85,160,160,111,431
355030819000261,1,165,102,150,150,84,384
355030819000262,1,155,86,157,157,77,391
355030819000263,1,261,105,229,229,155,613
355030819000264,1,198,99,189,189,88,466
355030819000265,1,65,27,73,73,49,195
355030819000266,1,212,87,202,202,74,478
355030819000267,1,163,63,151,151,70,372
355030819000268,1,248,108,278,278,107,663
355030819000269,1,140,73,121,121,92,334
355030819000270,1,107,49,137,137,98,372
355030819000271,1,69,34,104,104,51,259
355030819000272,1,197,125,253,253,137,643
355030819000273,1,98,52,125,125,78,328
355030819000274,1,90,37,114,114,36,264
355030819000275,1,291,106,214,214,102,530
355030819000276,1,161,66,162,162,76,400
355030819000277,1,210,61,132,132,60,324
355030819000278,1,128,45,125,125,72,322
355030819000279,1,207,104,249,249,128,626
355030819000280,1,152,84,171,171,110,452
355030819000281,1,61,33,70,70,39,179
355030819000282,1,121,75,150,150,116,416
355030819000283,1,84,27,68,68,35,171
355030819000284,1,275,156,312,312,163,787
355030819000285,1,103,49,156,156,76,388
355030819000286,1,68,25,77,77,30,184
355030819000287,1,239,100,206,206,142,554
355030819000288,1,55,17,57,57,35,149
355030819000289,1,216,95,251,251,204,706
355030819000290,1,197,92,232,232,123,587
355030819000291,1,128,56,160,160,84,404
355030819000292,1,155,73,161,161,101,423
355030819000293,1,195,103,235,235,138,608
355030819000294,1,188,88,225,225,146,596
355030819000295,1,240,116,232,232,152,616
355030819000296,1,174,59,244,244,155,643
355030819000297,1,78,36,62,62,48,172
355030819000298,1,136,70,144,144,92,380
355030819000299,1,151,74,138,138,106,382
355030819000300,1,232,95,233,233,92,558
355030819000301,1,176,76,182,182,106,470
355030819000302,1,234,112,280,280,146,706
355030819000303,1,137,75,158,158,106,422
355030819000304,1,268,97,295,295,121,711
355030819000305,1,170,77,212,212,92,516
355030819000306,1,278,125,248,248,145,641
355030819000307,1,157,97,175,175,135,485
355030819000308,1,166,88,184,184,125,493
355030819000309,1,129,83,125,125,72,322
355030819000310,1,91,48,127,127,71,325
355030819000311,1,121,53,140,140,89,369
355030819000312,1,68,40,77,77,66,220
355030819000313,1,121,57,115,115,59,289
355030819000314,1,70,35,94,94,78,266
355030819000315,1,100,65,147,147,122,416
355030819000316,1,115,43,162,162,96,420
355030819000317,1,112,72,144,144,98,386
355030819000318,1,121,67,143,143,84,370
355030819000319,1,109,43,157,157,86,400
355030819000320,1,126,50,135,135,89,359
355030819000321,1,106,47,135,135,87,357
355030819000322,1,57,33,55,55,30,140
355030819000323,1,92,34,128,128,67,323
355030819000324,1,101,57,136,136,118,390
355030819000325,1,94,70,147,147,88,382
355030819000327,1,87,47,121,121,85,327
355030819000328,1,226,90,212,212,76,500
355030819000329,1,122,55,147,147,74,368
355030819000330,1,126,50,109,109,69,287
355030819000331,1,125,57,169,169,77,415
355030819000332,1,78,55,128,128,124,380
355030819000333,1,76,46,124,124,69,317
355030819000334,1,114,63,148,148,94,390
355030819000335,1,157,69,158,158,91,407
355030819000336,1,143,58,129,129,63,321
355030819000337,1,81,34,91,91,73,255
355030819000338,1,123,67,142,142,69,353
355030819000339,1,43,15,47,47,31,125
355030819000340,1,54,25,103,103,91,297
355030819000341,1,113,54,112,112,89,313
355030819000342,1,131,59,126,126,62,314
355030819000343,1,287,128,249,249,168,666
355030819000344,1,142,64,159,159,86,404
355030819000345,1,138,63,162,162,112,436
355030819000346,1,139,53,136,136,80,352
355030819000347,1,181,102,154,154,120,428
355030819000348,1,98,48,98,98,62,258
355030819000349,1,156,67,136,136,59,331
355030819000350,1,183,66,196,196,101,493
355030819000351,1,80,35,133,133,58,324
355030819000352,1,74,28,114,114,82,310
355030819000353,1,128,61,183,183,144,510
355030819000354,1,65,25,65,65,63,193
355030819000355,1,96,43,87,87,89,263
355030819000356,1,85,21,153,153,55,361
355030819000357,1,130,49,113,113,66,292
355030819000358,1,79,24,69,69,42,180
355030819000359,1,180,66,181,181,139,501
355030819000360,1,283,181,423,423,237,1083
355030819000361,1,77,28,114,114,33,261
355030819000362,1,43,28,47,47,36,130
355030819000363,1,36,22,42,42,38,122
355030819000364,1,37,18,47,47,39,133
355030819000365,1,20,11,39,39,18,96
355030819000366,1,31,5,26,26,17,69
355030819000367,1,125,65,134,134,83,351
355030819000368,1,78,42,63,63,57,183
355030819000369,1,62,29,66,66,31,163
355030819000370,1,61,31,109,109,44,262
355030819000371,1,18,12,19,19,4,42
355030819000372,1,50,23,43,43,25,111
355030819000374,1,91,41,52,52,25,129
355030819000375,1,38,17,45,45,24,114
355030819000376,1,234,104,206,206,90,502
355030819000377,1,90,42,99,99,59,257
355030819000378,1,123,60,121,121,55,297
355030819000379,1,26,15,31,31,16,78
355030819000380,1,320,132,212,212,93,517
355030819000381,1,41,32,37,37,38,112
355030819000382,1,29,15,25,25,28,78
355030819000383,1,56,27,54,54,43,151
355030819000384,1,54,30,58,58,32,148
355030819000385,1,41,11,37,37,22,96
355030819000386,1,30,11,38,38,27,103
355030819000387,1,54,14,47,47,32,126
355030819000388,1,63,35,71,71,38,180
355030819000390,1,77,24,85,85,41,211
355030819000391,1,105,53,105,105,68,278
355030819000392,1,87,47,94,94,46,234
355030819000393,1,13,9,16,16,2,34
355030819000394,1,148,75,161,161,70,392
355030819000395,1,79,28,85,85,40,210
355030819000396,1,8,5,16,16,5,37
355030819000397,1,23,10,22,22,9,53
355030819000398,1,30,20,33,33,22,88
355030819000399,1,171,56,149,149,70,368
355030819000400,1,108,48,114,114,52,280
355030819000401,1,28,10,27,27,19,73
355030819000402,1,83,61,104,104,54,262
355030819000403,1,45,23,56,56,16,128
355030819000404,1,139,64,131,131,48,310
355030819000405,1,28,8,24,24,20,68
355030819000406,1,26,6,22,22,10,54
355030819000407,1,55,20,47,47,22,116
355030819000408,1,17,8,16,16,16,48
355030819000409,1,116,49,111,111,60,282
355030819000410,1,55,15,54,54,34,142
355030819000411,1,19,7,11,11,10,32
355030819000412,1,14,5,15,15,12,42
355030819000413,1,17,7,21,21,12,54
355030819000414,1,20,8,15,15,10,40
355030819000415,1,53,20,46,46,20,112
355030819000416,1,78,31,66,66,43,175
355030819000417,1,142,60,128,128,52,308
355030820000001,1,52,35,96,96,96,288
355030820000002,1,100,58,173,173,139,485
355030820000003,1,108,61,160,160,116,436
355030820000004,1,131,73,172,172,204,548
355030820000005,1,78,55,99,99,111,309
355030820000006,1,99,60,225,225,170,620
355030820000007,1,95,44,140,140,124,404
355030820000008,1,114,66,173,173,150,496
355030820000009,1,127,72,268,268,206,742
355030820000010,1,110,79,179,179,209,567
355030820000011,1,72,40,109,109,100,318
355030820000012,1,75,44,126,126,131,383
355030820000013,1,66,41,106,106,108,320
355030820000014,1,79,47,150,150,128,428
355030820000015,1,65,39,110,110,99,319
355030820000016,1,114,67,188,188,154,530
355030820000017,1,74,36,120,120,90,330
355030820000018,1,176,73,256,256,173,685
355030820000019,1,107,71,204,204,135,543
355030820000020,1,215,92,380,380,201,961
355030820000021,1,105,49,137,137,148,422
355030820000023,1,71,45,92,92,112,296
355030820000024,1,35,25,61,61,76,198
355030820000025,1,56,25,69,69,71,209
355030820000026,1,49,41,72,72,61,205
355030820000027,1,121,74,177,177,153,507
355030820000028,1,107,45,134,134,146,414
355030820000029,1,93,39,107,107,127,341
355030820000030,1,68,46,104,104,88,296
355030820000031,1,68,48,145,145,136,426
355030820000033,1,109,62,134,134,150,418
355030820000034,1,95,59,165,165,138,468
355030820000035,1,99,61,187,187,159,533
355030820000036,1,131,74,143,143,152,438
355030820000037,1,83,54,125,125,111,361
355030820000038,1,98,57,136,136,104,376
355030820000039,1,103,60,155,155,128,438
355030820000040,1,50,44,81,81,94,256
355030820000041,1,117,48,145,145,148,438
355030820000042,1,277,105,487,487,271,1245
355030820000043,1,101,63,160,160,160,480
355030820000044,1,107,43,140,140,180,460
355030820000045,1,148,74,201,201,115,517
355030820000046,1,127,66,143,143,126,412
355030820000047,1,114,69,163,163,128,454
355030820000048,1,132,64,141,141,145,427
355030820000049,1,211,129,383,383,290,1056
355030820000050,1,99,48,161,161,112,434
355030820000051,1,124,66,171,171,151,493
355030820000052,1,97,49,177,177,145,499
355030820000053,1,100,82,199,199,185,583
355030820000054,1,155,73,206,206,215,627
355030820000055,1,126,90,191,191,198,580
355030820000056,1,115,58,178,178,173,529
355030820000057,1,113,58,163,163,156,482
355030820000058,1,128,60,180,180,156,516
355030820000059,1,91,51,146,146,119,411
355030820000060,1,76,45,112,112,124,348
355030820000061,1,122,79,210,210,183,603
355030820000062,1,105,49,162,162,130,454
355030820000063,1,73,38,119,119,155,393
355030820000064,1,107,71,193,193,139,525
355030820000065,1,71,41,101,101,133,335
355030820000066,1,29,13,63,63,69,195
355030820000067,1,46,33,89,89,136,314
355030820000068,1,68,32,94,94,114,302
355030820000069,1,91,58,152,152,167,471
355030820000070,1,98,76,172,172,213,557
355030820000071,1,24,16,38,38,50,126
355030820000072,1,38,25,71,71,78,220
355030820000073,1,97,64,165,165,130,460
355030820000074,1,100,44,138,138,124,400
355030820000075,1,116,53,165,165,151,481
355030820000076,1,65,37,108,108,109,325
355030820000077,1,110,64,189,189,171,549
355030820000078,1,60,34,122,122,148,392
355030820000079,1,143,92,185,185,237,607
355030820000080,1,174,66,394,394,128,916
355030820000081,1,125,102,140,140,165,445
355030820000083,1,81,46,103,103,118,324
355030820000084,1,89,46,130,130,138,398
355030820000085,1,87,42,125,125,113,363
355030820000086,1,102,59,207,207,132,546
355030820000087,1,81,64,137,137,149,423
355030820000088,1,198,92,297,297,276,870
355030820000090,1,89,62,162,162,194,518
355030820000091,1,76,66,150,150,163,463
355030820000092,1,97,65,156,156,141,453
355030820000093,1,77,25,140,140,120,400
355030820000094,1,104,83,191,191,240,622
355030820000095,1,84,65,161,161,177,499
355030820000096,1,93,62,159,159,179,497
355030820000097,1,164,88,249,249,262,760
355030820000098,1,81,44,132,132,143,407
355030820000099,1,195,101,228,228,114,570
355030820000100,1,130,66,215,215,155,585
355030820000101,1,79,21,149,149,114,412
355030820000102,1,161,82,192,192,141,525
355030820000103,1,339,132,483,483,230,1196
355030820000104,1,99,53,145,145,160,450
355030820000105,1,132,88,205,205,185,595
355030820000106,1,151,89,226,226,168,620
355030820000107,1,113,71,166,166,147,479
355030820000108,1,93,55,144,144,139,427
355030820000109,1,72,46,138,138,104,380
355030820000110,1,116,62,175,175,194,544
355030820000111,1,80,52,118,118,118,354
355030820000112,1,145,72,276,276,247,799
355030820000113,1,311,135,577,577,300,1454
355030820000114,1,161,112,281,281,190,752
355030820000115,1,130,61,124,124,70,318
355030821000001,1,125,76,165,165,136,466
355030821000002,1,114,58,155,155,139,449
355030821000003,1,141,81,216,216,144,576
355030821000004,1,128,55,169,169,126,464
355030821000005,1,55,36,92,92,69,253
355030821000006,1,153,79,195,195,148,538
355030821000007,1,92,44,145,145,116,406
355030821000008,1,130,69,174,174,127,475
355030821000009,1,60,27,72,72,69,213
355030821000010,1,209,111,204,204,226,634
355030821000011,1,196,114,233,233,211,677
355030821000012,1,129,55,164,164,147,475
355030821000013,1,121,75,166,166,151,483
355030821000014,1,91,63,144,144,147,435
355030821000015,1,74,47,156,156,167,479
355030821000016,1,140,59,134,134,102,370
355030821000017,1,93,46,109,109,105,323
355030821000018,1,33,25,69,69,89,227
355030821000019,1,74,32,109,109,84,302
355030821000020,1,124,54,148,148,107,403
355030821000021,1,144,90,198,198,144,540
355030821000022,1,82,32,103,103,93,299
355030821000023,1,152,74,156,156,163,475
355030821000024,1,100,50,137,137,136,410
355030821000025,1,128,65,151,151,137,439
355030821000026,1,113,53,170,170,128,468
355030821000027,1,83,44,99,99,88,286
355030821000028,1,98,43,133,133,99,365
355030821000029,1,143,74,148,148,163,459
355030821000030,1,98,68,175,175,200,550
355030821000031,1,67,36,99,99,112,310
355030821000032,1,63,24,129,129,126,384
355030821000033,1,80,15,129,129,75,333
355030821000034,1,68,45,138,138,128,404
355030821000035,1,86,68,155,155,162,472
355030821000036,1,62,27,77,77,58,212
355030821000037,1,99,67,133,133,173,439
355030821000038,1,77,41,113,113,103,329
355030821000039,1,88,59,147,147,140,434
355030821000040,1,96,56,152,152,128,432
355030821000041,1,96,50,118,118,100,336
355030821000042,1,106,74,167,167,179,513
355030821000043,1,100,47,123,123,118,364
355030821000044,1,84,54,98,98,84,280
355030821000045,1,194,79,209,209,172,590
355030821000046,1,74,49,90,90,92,272
355030821000047,1,115,57,112,112,98,322
355030821000048,1,83,51,134,134,125,393
355030821000049,1,71,46,109,109,119,337
355030821000050,1,118,75,174,174,180,528
355030821000051,1,96,63,162,162,170,494
355030821000052,1,87,57,135,135,131,401
355030821000053,1,128,94,206,206,114,526
355030821000054,1,102,53,152,152,128,432
355030821000055,1,76,38,137,137,131,405
355030821000056,1,152,59,217,217,138,572
355030821000057,1,116,66,149,149,106,404
355030821000058,1,69,59,132,132,104,368
355030821000059,1,72,50,125,125,110,360
355030821000060,1,105,42,137,137,105,379
355030821000061,1,105,56,168,168,140,476
355030821000062,1,67,42,127,127,99,353
355030821000063,1,77,41,138,138,143,419
355030821000064,1,125,52,229,229,144,602
355030821000065,1,160,59,270,270,125,665
355030821000066,1,138,74,180,180,228,588
355030821000067,1,143,68,289,289,169,747
355030821000068,1,79,39,120,120,93,333
355030821000069,1,71,42,127,127,100,354
355030821000070,1,124,66,161,161,134,456
355030821000071,1,197,97,186,186,156,528
355030821000072,1,107,54,122,122,76,320
355030821000073,1,134,73,186,186,171,543
355030821000074,1,112,49,104,104,82,290
355030821000075,1,116,53,126,126,118,370
355030821000076,1,156,75,169,169,115,453
355030821000077,1,192,53,196,196,104,496
355030821000078,1,233,122,251,251,172,674
355030821000079,1,105,64,167,167,115,449
355030821000080,1,192,69,170,170,170,510
355030821000081,1,143,86,183,183,152,518
355030821000082,1,58,49,168,168,139,475
355030821000083,1,52,25,101,101,96,298
355030821000084,1,65,31,105,105,83,293
355030821000085,1,68,31,108,108,81,297
355030821000086,1,125,59,177,177,155,509
355030821000087,1,34,32,90,90,101,281
355030821000088,1,46,35,89,89,93,271
355030821000089,1,118,93,145,145,254,544
355030821000090,1,141,84,219,219,232,670
355030821000091,1,101,72,143,143,185,471
355030821000092,1,74,34,105,105,92,302
355030821000093,1,71,49,174,174,189,537
355030821000094,1,77,54,116,116,116,348
355030821000095,1,138,50,145,145,122,412
355030821000096,1,155,72,200,200,160,560
355030821000097,1,168,81,207,207,139,553
355030821000098,1,128,80,139,139,105,383
355030821000099,1,130,57,135,135,88,358
355030821000100,1,81,56,143,143,100,386
355030821000101,1,146,75,178,178,143,499
355030821000102,1,161,87,184,184,132,500
355030821000103,1,99,47,132,132,110,374
355030821000104,1,121,67,139,139,108,386
355030821000105,1,111,73,176,176,128,480
355030821000106,1,110,67,141,141,108,390
355030821000107,1,46,30,77,77,63,217
355030821000108,1,34,27,43,43,36,122
355030821000109,1,144,68,129,129,132,390
355030821000110,1,147,60,187,187,125,499
355030821000111,1,150,68,171,171,117,459
355030821000112,1,91,55,124,124,77,325
355030821000113,1,42,30,100,100,90,290
355030821000114,1,70,32,113,113,111,337
355030821000115,1,50,29,98,98,118,314
355030821000116,1,249,122,269,269,106,644
355030821000117,1,63,29,84,84,80,248
355030821000118,1,48,30,72,72,107,251
355030821000119,1,98,28,227,227,66,520
355030821000120,1,105,46,173,173,150,496
355030821000121,1,41,16,155,155,31,341
355030821000122,1,37,11,122,122,62,306
355030821000123,1,95,40,143,143,87,373
355030821000124,1,93,43,244,244,73,561
355030821000125,1,39,31,66,66,74,206
355030821000126,1,73,47,116,116,134,366
355030821000128,2,9,3,22,22,6,50
355030821000129,1,108,36,135,135,98,368
355030821000130,1,44,29,83,83,83,249
355030821000131,1,51,37,79,79,80,238
355030821000132,1,78,52,113,113,86,312
355030821000133,1,45,8,85,85,46,216
355030822000001,1,70,54,77,77,58,212
355030822000002,1,94,66,149,149,115,413
355030822000003,1,151,63,244,244,166,654
355030822000004,1,242,99,246,246,173,665
355030822000005,1,89,46,92,92,65,249
355030822000006,1,168,79,180,180,104,464
355030822000007,1,243,129,243,243,161,647
355030822000008,1,179,81,336,336,155,827
355030822000009,1,205,88,220,220,139,579
355030822000010,1,189,108,222,222,146,590
355030822000011,1,101,40,154,154,76,384
355030822000012,1,78,51,100,100,71,271
355030822000013,1,119,62,165,165,140,470
355030822000014,1,117,90,172,172,115,459
355030822000015,1,133,75,189,189,134,512
355030822000016,1,146,66,185,185,178,548
355030822000017,1,255,92,256,256,151,663
355030822000018,1,150,65,144,144,89,377
355030822000019,1,73,42,77,77,38,192
355030822000020,1,251,117,244,244,123,611
355030822000021,1,271,114,233,233,122,588
355030822000022,1,98,39,88,88,52,228
355030822000023,1,166,68,146,146,68,360
355030822000024,1,205,78,209,209,94,512
355030822000025,1,147,66,159,159,88,406
355030822000026,1,263,129,301,301,171,773
355030822000027,1,145,60,144,144,80,368
355030822000028,1,196,93,222,222,132,576
355030822000029,1,199,92,201,201,113,515
355030822000030,1,161,76,148,148,121,417
355030822000031,1,262,127,246,246,126,618
355030822000032,1,92,42,126,126,113,365
355030822000033,1,85,36,94,94,73,261
355030822000034,1,19,10,30,30,18,78
355030822000035,1,31,19,106,106,49,261
355030822000036,1,40,45,108,108,91,307
355030822000037,1,79,45,107,107,95,309
355030822000038,1,101,44,121,121,102,344
355030822000039,1,110,68,138,138,131,407
355030822000040,1,162,87,200,200,129,529
355030822000041,1,78,40,75,75,25,175
355030822000042,1,251,104,257,257,129,643
355030822000043,1,276,117,249,249,106,604
355030822000044,1,227,95,224,224,138,586
355030822000045,1,138,56,228,228,88,544
355030822000046,1,159,81,208,208,112,528
355030822000047,1,211,82,203,203,69,475
355030822000048,1,240,128,266,266,133,665
355030822000049,1,154,83,164,164,98,426
355030822000050,1,137,80,104,104,57,265
355030822000051,1,293,125,287,287,120,694
355030822000052,1,311,171,309,309,169,787
355030822000053,1,242,113,206,206,106,518
355030822000054,1,120,56,115,115,64,294
355030822000055,1,255,104,303,303,205,811
355030822000056,1,254,126,315,315,195,825
355030822000057,1,313,151,365,365,187,917
355030822000058,1,128,69,172,172,106,450
355030822000059,1,219,102,258,258,166,682
355030822000060,1,181,91,252,252,202,706
355030822000061,1,215,113,272,272,169,713
355030822000062,1,110,84,165,165,142,472
355030822000063,1,145,60,218,218,125,561
355030822000064,1,68,45,74,74,95,243
355030822000065,1,146,48,248,248,119,615
355030822000066,1,108,51,122,122,117,361
355030822000067,1,79,47,115,115,92,322
355030822000068,1,64,32,78,78,61,217
355030822000069,1,75,35,118,118,102,338
355030822000070,1,149,109,266,266,223,755
355030822000071,1,171,117,243,243,189,675
355030822000072,1,108,48,182,182,147,511
355030822000073,1,57,31,79,79,62,220
355030822000074,1,159,81,180,180,150,510
355030822000075,1,112,55,168,168,140,476
355030822000076,1,96,56,137,137,92,366
355030822000077,1,171,103,176,176,141,493
355030822000078,1,96,53,139,139,80,358
355030822000079,1,112,53,107,107,94,308
355030822000080,1,180,97,181,181,103,465
355030822000081,1,93,49,120,120,63,303
355030822000082,1,14,13,23,23,8,54
355030822000083,1,332,157,328,328,166,822
355030822000084,1,435,125,634,634,96,1364
355030822000085,1,210,71,146,146,101,393
355030822000086,1,131,68,120,120,84,324
355030822000087,1,210,110,280,280,150,710
355030822000088,1,169,110,241,241,152,634
355030822000089,1,175,91,140,140,89,369
355030822000090,1,180,99,157,157,95,409
355030822000091,1,151,69,185,185,145,515
355030822000092,1,278,118,331,331,162,824
355030822000093,1,69,45,69,69,40,178
355030822000094,1,214,98,239,239,175,653
355030822000095,1,238,93,206,206,122,534
355030822000096,1,252,86,165,165,85,415
355030822000097,1,348,166,266,266,145,677
355030822000098,1,162,85,133,133,96,362
355030822000099,1,182,85,219,219,130,568
355030822000100,1,69,49,96,96,51,243
355030822000101,1,216,119,267,267,170,704
355030822000102,1,153,68,172,172,112,456
355030822000103,1,110,66,149,149,76,374
355030822000104,1,173,91,180,180,117,477
355030822000105,1,216,124,196,196,174,566
355030822000106,1,289,127,272,272,161,705
355030822000107,1,361,161,341,341,156,838
355030822000108,1,201,109,252,252,168,672
355030822000109,1,137,72,196,196,174,566
355030822000110,1,93,55,147,147,156,450
355030822000111,1,109,58,174,174,140,488
355030822000112,1,64,46,111,111,95,317
355030822000113,1,110,49,125,125,115,365
355030822000114,1,87,32,135,135,104,374
355030822000115,1,141,66,252,252,156,660
355030822000116,1,71,51,112,112,125,349
355030822000117,1,180,118,218,218,211,647
355030822000118,1,89,58,132,132,93,357
355030822000119,1,129,65,190,190,106,486
355030822000120,1,98,51,117,117,135,369
355030822000121,1,100,48,127,127,97,351
355030822000122,1,133,94,183,183,182,548
355030822000123,1,105,59,132,132,113,377
355030822000124,1,204,93,214,214,154,582
355030822000125,1,387,183,355,355,189,899
355030822000126,1,194,79,171,171,97,439
355030822000127,1,226,122,212,212,91,515
355030822000128,1,103,44,101,101,54,256
355030822000129,1,66,30,67,67,45,179
355030822000130,1,99,45,67,67,34,168
355030822000131,1,168,76,166,166,109,441
355030822000132,1,193,94,160,160,99,419
355030822000133,1,118,66,138,138,89,365
355030822000134,1,216,92,188,188,91,467
355030822000135,1,149,71,187,187,133,507
355030822000136,1,237,128,292,292,202,786
355030822000137,1,170,71,250,250,172,672
355030822000138,1,51,22,48,48,32,128
355030822000139,1,155,84,173,173,74,420
355030822000140,1,135,53,151,151,104,406
355030822000141,1,58,35,50,50,65,165
355030822000142,1,154,89,191,191,117,499
355030822000143,1,109,69,152,152,142,446
355030822000144,1,122,61,187,187,133,507
355030822000145,1,108,73,202,202,208,612
355030822000146,1,73,47,132,132,94,358
355030822000147,1,72,53,115,115,103,333
355030822000148,1,168,73,215,215,156,586
355030822000149,1,162,90,169,169,109,447
355030822000150,1,202,104,255,255,149,659
355030822000151,1,72,50,95,95,51,241
355030822000152,1,199,90,201,201,129,531
355030822000153,1,232,108,217,217,122,556
355030822000154,1,254,108,278,278,135,691
355030822000155,1,166,83,205,205,130,540
355030822000156,1,197,109,244,244,156,644
355030822000157,1,133,80,168,168,106,442
355030822000158,1,47,19,102,102,40,244
355030822000159,1,147,71,171,171,121,463
355030822000160,1,206,130,272,272,234,778
355030822000161,1,64,39,90,90,84,264
355030822000162,1,90,59,173,173,168,514
355030822000163,1,92,58,159,159,177,495
355030822000164,1,139,106,191,191,222,604
355030822000165,1,48,55,106,106,101,313
355030822000166,1,173,81,208,208,135,551
355030822000167,1,179,99,250,250,167,667
355030822000168,1,193,102,186,186,86,458
355030822000169,1,105,58,138,138,86,362
355030822000170,1,130,66,165,165,86,416
355030822000171,1,248,86,197,197,99,493
355030822000172,1,129,50,133,133,71,337
355030822000173,1,137,59,131,131,83,345
355030822000174,1,151,72,140,140,75,355
355030822000175,1,229,99,245,245,134,624
355030822000176,1,66,38,74,74,40,188
355030822000177,1,154,58,154,154,70,378
355030822000178,1,151,83,133,133,69,335
355030822000179,1,241,117,298,298,143,739
355030822000180,1,189,98,268,268,155,691
355030822000181,1,67,42,71,71,56,198
355030822000182,1,227,138,456,456,246,1158
355030822000183,1,160,96,202,202,176,580
355030822000184,1,96,49,167,167,138,472
355030822000185,1,49,48,129,129,102,360
355030822000186,1,71,60,165,165,157,487
355030822000187,1,80,56,173,173,154,500
355030822000188,1,161,62,166,166,89,421
355030822000189,1,123,63,134,134,93,361
355030822000190,1,195,85,192,192,107,491
355030822000191,1,153,86,223,223,148,594
355030822000192,1,92,81,160,160,101,421
355030822000193,1,149,84,180,180,100,460
355030822000194,1,214,114,178,178,115,471
355030822000195,1,178,86,195,195,126,516
355030822000196,1,182,111,256,256,155,667
355030822000197,1,187,96,236,236,137,609
355030822000198,1,257,130,270,270,130,670
355030822000199,1,76,36,95,95,44,234
355030822000200,1,242,102,198,198,92,488
355030822000201,1,230,109,201,201,112,514
355030822000202,1,113,46,131,131,74,336
355030822000203,1,42,37,50,50,61,161
355030822000204,1,52,30,68,68,52,188
355030822000205,1,63,45,132,132,114,378
355030822000206,1,55,30,121,121,108,350
355030822000207,1,65,46,131,131,135,397
355030822000208,1,63,47,195,195,190,580
355030822000209,1,93,63,162,162,81,405
355030822000210,1,269,129,219,219,129,567
355030822000211,1,72,25,67,67,39,173
355030822000212,1,52,27,98,98,95,291
355030822000213,1,55,38,93,93,91,277
355030822000214,1,185,74,240,240,109,589
355030822000215,1,125,56,123,123,62,308
355030822000216,1,169,78,178,178,146,502
355030822000217,1,215,101,211,211,192,614
355030822000218,1,50,16,51,51,34,136
355030822000219,1,159,85,207,207,173,587
355030822000220,1,108,55,149,149,137,435
355030822000221,1,98,39,107,107,76,290
355030822000222,1,88,72,123,123,98,344
355030822000223,1,176,106,209,209,171,589
355030822000224,1,239,118,275,275,159,709
355030822000225,1,165,81,143,143,117,403
355030822000226,1,121,48,156,156,78,390
355030822000227,1,107,74,144,144,97,385
355030822000228,1,135,60,157,157,90,404
355030822000229,1,290,140,318,318,190,826
355030822000230,1,183,106,215,215,150,580
355030822000231,1,106,65,159,159,169,487
355030822000232,1,117,92,240,240,189,669
355030822000233,1,53,40,185,185,232,602
355030822000234,1,59,29,95,95,124,314
355030822000235,1,137,78,165,165,117,447
355030822000236,1,250,114,230,230,165,625
355030822000237,1,277,124,280,280,181,741
355030822000238,1,120,62,164,164,83,411
355030822000239,1,268,127,214,214,123,551
355030822000240,1,153,76,184,184,131,499
355030822000241,1,30,11,37,37,33,107
355030822000242,1,27,9,18,18,10,46
355030822000243,1,147,73,136,136,121,393
355030822000244,1,132,65,215,215,147,577
355030822000245,1,139,73,191,191,150,532
355030822000246,1,129,79,170,170,105,445
355030822000247,1,125,64,230,230,223,683
355030822000248,1,119,89,166,166,252,584
355030822000249,1,154,52,193,193,134,520
355030822000250,1,187,94,229,229,159,617
355030822000251,1,224,118,285,285,181,751
355030822000252,1,149,76,233,233,126,592
355030822000253,1,47,18,57,57,20,134
355030822000254,1,256,111,249,249,109,607
355030822000255,1,258,133,212,212,119,543
355030822000256,1,348,140,278,278,122,678
355030822000257,1,77,38,76,76,33,185
355030822000258,1,252,108,234,234,73,541
355030822000259,1,418,174,329,329,149,807
355030822000260,1,328,147,320,320,167,807
355030822000261,1,212,102,213,213,82,508
355030822000262,1,129,79,103,103,54,260
355030822000263,1,66,29,65,65,32,162
355030822000264,1,204,109,247,247,141,635
355030822000265,1,168,78,192,192,131,515
355030822000266,1,28,20,50,50,59,159
355030822000267,1,103,49,231,231,167,629
355030822000268,1,79,53,146,146,147,439
355030822000269,1,142,74,160,160,95,415
355030822000270,1,145,95,169,169,123,461
355030822000271,1,150,86,145,145,88,378
355030822000272,1,207,103,197,197,117,511
355030822000273,1,152,83,145,145,88,378
355030822000274,1,179,88,218,218,118,554
355030822000275,1,68,43,71,71,53,195
355030822000276,1,105,87,147,147,99,393
355030822000277,1,86,76,178,178,174,530
355030822000278,1,56,36,90,90,98,278
355030822000279,1,162,73,165,165,105,435
355030822000280,1,77,53,86,86,63,235
355030822000281,1,209,110,223,223,122,568
355030822000282,1,91,23,322,322,87,731
355030822000283,1,293,110,243,243,136,622
355030822000284,1,99,52,108,108,89,305
355030822000285,1,10,4,14,14,3,31
355030822000286,1,235,91,209,209,119,537
355030822000287,1,168,84,217,217,129,563
355030822000288,1,89,61,136,136,102,374
355030822000289,1,153,75,186,186,131,503
355030822000290,1,146,56,146,146,84,376
355030822000291,1,137,54,137,137,79,353
355030822000292,1,176,83,206,206,111,523
355030822000293,1,38,15,55,55,51,161
355030822000294,1,177,103,209,209,127,545
355030822000295,1,113,60,155,155,92,402
355030822000296,1,83,48,164,164,128,456
355030822000297,1,141,73,142,142,100,384
355030822000298,1,143,65,155,155,68,378
355030822000299,1,143,74,134,134,82,350
355030822000300,1,233,86,174,174,103,451
355030822000301,1,81,37,107,107,80,294
355030822000302,1,82,53,132,132,72,336
355030822000303,1,87,33,130,130,93,353
355030822000304,1,102,52,127,127,84,338
355030822000305,1,84,36,90,90,50,230
355030822000306,1,119,58,149,149,71,369
355030822000307,1,145,85,200,200,115,515
355030822000308,1,162,84,222,222,168,612
355030822000309,1,91,37,263,263,71,597
355030822000310,1,218,105,186,186,86,458
355030822000311,1,101,50,173,173,126,472
355030822000312,1,95,63,169,169,127,465
355030822000313,1,100,49,100,100,69,269
355030822000314,1,189,86,216,216,137,569
355030822000315,1,272,152,221,221,128,570
355030822000316,1,79,42,185,185,80,450
355030822000317,1,39,23,52,52,47,151
355030822000318,1,156,70,199,199,143,541
355030822000319,1,90,47,125,125,91,341
355030822000320,1,45,18,61,61,49,171
355030822000321,1,48,21,56,56,38,150
355030822000322,1,50,16,194,194,16,404
355030822000323,1,151,76,157,157,93,407
355030822000324,1,35,20,69,69,52,190
355030822000325,1,176,87,194,194,141,529
355030822000326,1,112,56,167,167,110,444
355030822000327,1,116,53,219,219,94,532
355030822000328,1,192,89,198,198,124,520
355030822000329,1,79,35,101,101,36,238
355030822000330,1,96,55,148,148,102,398
355030822000331,1,175,83,182,182,81,445
355030822000332,1,66,37,89,89,79,257
355030822000333,1,77,31,93,93,78,264
355030822000334,1,54,24,111,111,62,284
355030822000335,1,89,23,160,160,102,422
355030822000336,1,175,62,163,163,77,403
355030822000337,1,231,123,205,205,83,493
355030822000338,1,107,48,90,90,47,227
355030822000339,1,94,53,90,90,65,245
355030822000340,1,81,31,82,82,58,222
355030822000341,1,155,79,170,170,87,427
355030822000342,1,53,13,65,65,27,157
355030822000343,1,128,72,101,101,54,256
355030822000344,1,161,73,160,160,64,384
355030822000345,1,97,62,114,114,63,291
355030822000346,1,120,66,116,116,103,335
355030822000347,1,151,69,127,127,78,332
355030822000348,1,83,35,69,69,39,177
355030822000349,1,199,122,183,183,129,495
355030822000350,1,38,29,55,55,56,166
355030822000351,1,106,59,173,173,114,460
355030822000352,1,71,39,131,131,76,338
355030822000353,1,161,82,149,149,105,403
355030822000354,1,49,37,92,92,114,298
355030822000355,1,148,60,231,231,117,579
355030822000356,1,31,14,29,29,23,81
355030822000357,1,49,27,81,81,71,233
355030822000358,1,49,21,76,76,51,203
355030822000359,1,102,51,122,122,79,323
355030822000360,1,80,42,92,92,48,232
355030822000362,1,18,13,33,33,13,79
355030822000364,1,70,28,66,66,47,179
355030822000365,1,77,27,86,86,62,234
355030822000366,1,74,40,77,77,26,180
355030822000367,1,66,44,53,53,66,172
355030822000368,1,72,36,66,66,40,172
355030822000369,1,49,27,40,40,32,112
355030822000370,1,98,56,82,82,55,219
355030822000371,1,148,71,113,113,74,300
355030822000372,1,262,118,222,222,131,575
355030822000373,1,98,45,82,82,35,199
355030822000374,1,189,82,161,161,85,407
355030822000375,1,29,15,34,34,21,89
355030822000376,1,152,74,168,168,95,431
355030822000377,1,22,17,31,31,24,86
355030822000378,1,25,9,25,25,10,60
355030822000379,1,68,26,78,78,36,192
355030822000380,1,159,74,179,179,91,449
355030823000001,1,149,57,222,222,168,612
355030823000002,1,144,59,212,212,99,523
355030823000003,1,205,107,171,171,88,430
355030823000004,1,116,40,115,115,62,292
355030823000005,1,165,83,217,217,154,588
355030823000006,1,110,70,173,173,182,528
355030823000007,1,156,70,232,232,180,644
355030823000008,1,111,63,168,168,139,475
355030823000009,1,151,60,132,132,58,322
355030823000010,1,87,44,60,60,58,178
355030823000011,1,143,73,221,221,163,605
355030823000012,1,172,76,143,143,102,388
355030823000013,1,86,46,118,118,105,341
355030823000014,1,131,85,218,218,162,598
355030823000015,1,91,63,213,213,208,634
355030823000016,1,192,89,262,262,160,684
355030823000017,1,126,76,183,183,115,481
355030823000018,1,348,150,352,352,217,921
355030823000019,1,216,124,230,230,164,624
355030823000020,1,344,164,341,341,262,944
355030823000021,1,186,100,258,258,246,762
355030823000022,1,108,56,187,187,176,550
355030823000023,1,94,42,160,160,134,454
355030823000024,1,129,76,241,241,165,647
355030823000025,1,135,59,178,178,153,509
355030823000026,1,132,73,188,188,181,557
355030823000027,1,47,31,88,88,72,248
355030823000028,1,139,60,126,126,70,322
355030823000029,1,89,38,72,72,68,212
355030823000030,1,138,82,210,210,121,541
355030823000031,1,98,46,126,126,95,347
355030823000032,1,164,65,186,186,121,493
355030823000033,1,131,60,150,150,102,402
355030823000034,1,49,27,54,54,33,141
355030823000035,1,153,84,180,180,124,484
355030823000036,1,158,67,203,203,144,550
355030823000037,1,160,63,243,243,183,669
355030823000038,1,126,78,183,183,169,535
355030823000039,1,311,176,367,367,285,1019
355030823000040,1,126,72,194,194,182,570
355030823000041,1,243,113,322,322,210,854
355030823000042,1,239,123,229,229,114,572
355030823000043,1,130,59,180,180,94,454
355030823000044,1,221,139,296,296,183,775
355030823000045,1,85,36,127,127,92,346
355030823000046,1,228,122,290,290,191,771
355030823000047,1,193,97,161,161,82,404
355030823000048,1,243,125,310,310,210,830
355030823000049,1,154,92,137,137,95,369
355030823000050,1,55,20,47,47,51,145
355030823000051,1,237,117,179,179,98,456
355030823000052,1,196,90,188,188,118,494
355030823000053,1,507,190,322,322,138,782
355030823000054,1,245,112,183,183,103,469
355030823000055,1,189,98,164,164,94,422
355030823000056,1,129,79,190,190,134,514
355030823000057,1,116,62,172,172,202,546
355030823000058,1,105,64,145,145,138,428
355030823000059,1,128,73,182,182,127,491
355030823000060,1,121,66,175,175,136,486
355030823000061,1,146,105,199,199,171,569
355030823000062,1,76,76,149,149,196,494
355030823000063,1,116,70,182,182,205,569
355030823000064,1,63,42,110,110,136,356
355030823000065,1,119,67,199,199,211,609
355030823000066,1,138,79,289,289,217,795
355030823000067,1,79,42,137,137,102,376
355030823000068,1,201,101,221,221,157,599
355030823000069,1,108,70,165,165,107,437
355030823000070,1,184,85,199,199,120,518
355030823000071,1,126,83,162,162,124,448
355030823000072,1,240,116,228,228,149,605
355030823000073,1,169,100,172,172,115,459
355030823000074,1,103,49,109,109,65,283
355030823000075,1,265,106,213,213,115,541
355030823000076,1,188,93,169,169,88,426
355030823000077,1,142,71,157,157,123,437
355030823000078,1,137,59,149,149,110,408
355030823000079,1,137,85,189,189,156,534
355030823000080,1,195,98,279,279,249,807
355030823000081,1,216,157,264,264,274,802
355030823000082,1,187,71,189,189,130,508
355030823000083,1,119,75,218,218,168,604
355030823000084,1,124,57,128,128,166,422
355030823000085,1,50,16,66,66,60,192
355030823000086,1,264,124,345,345,185,875
355030823000087,1,128,67,165,165,94,424
355030823000088,1,239,126,217,217,168,602
355030823000089,1,139,49,169,169,96,434
355030823000090,1,207,88,271,271,176,718
355030823000091,1,78,48,82,82,79,243
355030823000092,1,103,61,167,167,121,455
355030823000093,1,182,88,246,246,221,713
355030823000094,1,254,135,367,367,277,1011
355030823000095,1,225,113,290,290,239,819
355030823000096,1,85,31,129,129,141,399
355030823000097,1,133,77,177,177,123,477
355030823000099,1,117,43,154,154,102,410
355030823000100,1,183,65,164,164,95,423
355030823000101,1,146,70,192,192,160,544
355030823000102,1,122,55,157,157,113,427
355030823000103,1,122,79,143,143,61,347
355030823000104,1,62,39,85,85,51,221
355030823000105,1,235,97,246,246,157,649
355030823000106,1,385,143,330,330,106,766
355030823000107,1,126,61,154,154,155,463
355030823000108,1,215,112,284,284,159,727
355030823000109,1,128,67,189,189,139,517
355030823000110,1,130,86,216,216,214,646
355030823000111,1,160,114,198,198,204,600
355030823000112,1,257,140,294,294,247,835
355030823000113,1,248,126,266,266,228,760
355030823000114,1,241,158,289,289,226,804
355030823000115,1,222,107,276,276,156,708
355030823000116,1,142,91,233,233,124,590
355030823000117,1,162,82,221,221,172,614
355030823000118,1,139,88,190,190,131,511
355030823000119,1,136,106,237,237,182,656
355030823000120,1,135,78,195,195,151,541
355030823000121,1,136,71,224,224,138,586
355030823000122,1,125,63,182,182,128,492
355030823000123,1,137,75,166,166,137,469
355030823000124,1,48,27,46,46,30,122
355030823000125,1,165,76,170,170,111,451
355030823000126,1,311,156,260,260,135,655
355030823000127,1,227,100,210,210,121,541
355030823000128,1,314,135,321,321,207,849
355030823000129,1,118,48,151,151,89,391
355030823000130,1,104,56,150,150,108,408
355030823000131,1,185,83,215,215,128,558
355030823000132,1,161,101,228,228,161,617
355030823000133,1,168,73,146,146,93,385
355030823000134,1,262,133,228,228,161,617
355030823000135,1,314,119,324,324,243,891
355030823000136,1,123,87,195,195,200,590
355030823000137,1,220,121,427,427,313,1167
355030823000138,1,198,94,208,208,130,546
355030823000139,1,295,135,228,228,118,574
355030823000140,1,251,156,370,370,247,987
355030823000141,1,108,69,161,161,150,472
355030823000142,1,263,110,412,412,215,1039
355030823000143,1,163,88,228,228,164,620
355030823000144,1,113,85,119,119,100,338
355030823000145,1,162,90,186,186,138,510
355030823000146,1,232,80,202,202,75,479
355030823000147,1,310,127,404,404,192,1000
355030823000148,1,205,87,225,225,173,623
355030823000149,1,223,50,275,275,96,646
355030823000150,1,222,117,291,291,128,710
355030823000151,1,138,83,152,152,119,423
355030823000152,1,255,144,321,321,203,845
355030823000153,1,179,82,224,224,163,611
355030823000154,1,229,109,288,288,222,798
355030823000155,1,212,98,208,208,115,531
355030823000156,1,216,117,273,273,204,750
355030823000157,1,70,23,58,58,48,164
355030823000158,1,103,52,118,118,75,311
355030823000159,1,141,63,167,167,114,448
355030823000160,1,139,67,176,176,92,444
355030823000161,1,245,125,248,248,163,659
355030823000162,1,184,80,175,175,104,454
355030823000163,1,58,20,56,56,39,151
355030823000164,1,158,88,197,197,147,541
355030823000165,1,76,42,72,72,42,186
355030823000166,1,143,55,133,133,78,344
355030823000167,1,179,86,173,173,99,445
355030823000168,1,214,98,205,205,138,548
355030823000169,1,250,119,340,340,301,981
355030823000170,1,86,42,141,141,108,390
355030823000171,1,167,59,144,144,80,368
355030823000172,1,111,66,107,107,73,287
355030823000173,1,163,67,164,164,71,399
355030823000174,1,444,249,424,424,247,1095
355030823000175,1,225,130,226,226,137,589
355030823000176,1,365,215,420,420,230,1070
355030823000177,1,108,48,85,85,36,206
355030823000178,1,142,85,215,215,220,650
355030823000179,1,90,36,155,155,142,452
355030823000180,1,56,38,95,95,97,287
355030823000181,1,204,86,260,260,196,716
355030823000182,1,167,87,222,222,129,573
355030823000183,1,3,1,9,9,8,26
355030823000185,1,199,93,184,184,156,524
355030823000186,1,276,127,294,294,197,785
355030823000187,1,249,102,218,218,105,541
355030823000188,1,190,120,250,250,199,699
355030823000189,1,58,49,94,94,98,286
355030823000190,1,144,77,203,203,137,543
355030823000191,1,120,47,117,117,68,302
355030823000192,1,89,45,101,101,67,269
355030823000193,1,33,15,47,47,35,129
355030823000194,1,315,159,308,308,180,796
355030823000195,1,171,71,134,134,77,345
355030823000196,1,225,87,349,349,172,870
355030823000197,1,115,69,194,194,122,510
355030823000198,1,170,89,203,203,128,534
355030823000199,1,177,87,232,232,119,583
355030823000200,1,142,90,159,159,124,442
355030823000201,1,144,70,223,223,116,562
355030823000202,1,58,25,60,60,45,165
355030823000203,1,158,105,209,209,152,570
355030823000204,1,186,94,275,275,149,699
355030823000205,1,244,118,289,289,163,741
355030823000206,1,59,14,77,77,27,181
355030823000207,1,168,85,178,178,120,476
355030823000208,1,146,86,192,192,189,573
355030823000209,1,150,139,172,172,188,532
355030823000210,1,183,65,164,164,118,446
355030823000211,1,185,90,189,189,106,484
355030823000212,1,134,101,159,159,150,468
355030823000213,1,268,122,270,270,278,818
355030823000214,1,193,83,161,161,94,416
355030823000215,1,279,131,309,309,202,820
355030823000216,2,3,1,6,6,2,14
355030823000217,1,53,31,57,57,49,163
355030823000218,1,82,39,134,134,132,400
355030823000219,1,178,96,217,217,158,592
355030823000220,1,187,83,145,145,104,394
355030823000221,1,141,88,171,171,93,435
355030823000222,1,153,54,104,104,57,265
355030823000223,1,184,63,160,160,85,405
355030823000224,1,114,56,157,157,116,430
355030823000225,1,54,17,51,51,12,114
355030823000226,1,208,72,163,163,45,371
355030823000227,1,49,28,75,75,49,199
355030823000228,1,126,64,140,140,112,392
355030823000229,1,111,55,130,130,113,373
355030823000230,1,169,76,175,175,102,452
355030823000231,1,86,49,97,97,77,271
355030823000232,1,187,81,139,139,53,331
355030823000233,1,176,52,210,210,88,508
355030823000234,8,57,31,57,57,27,141
355030823000236,8,50,28,54,54,40,148
355030823000238,1,32,18,43,43,27,113
355030823000239,1,32,10,34,34,32,100
355030823000240,1,18,6,20,20,13,53
355030823000241,1,125,54,158,158,113,429
355030823000242,1,24,13,15,15,18,48
355030823000243,1,37,23,56,56,41,153
355030823000244,1,63,31,71,71,48,190
355030823000245,1,91,52,127,127,67,321
355030823000246,1,7,8,7,7,8,22
355030823000247,1,76,22,76,76,46,198
355030823000248,1,74,29,71,71,30,172
355030823000249,1,38,17,24,24,37,85
355030823000250,1,90,33,95,95,40,230
355030823000251,1,94,35,68,68,48,184
355030823000252,1,46,18,54,54,36,144
355030823000253,1,42,15,39,39,22,100
355030823000254,1,22,16,19,19,7,45
355030823000255,1,65,18,65,65,24,154
355030823000256,1,178,52,130,130,51,311
355030823000257,1,60,15,52,52,15,119
355030823000258,1,50,27,81,81,49,211
355030824000001,1,134,60,163,163,84,410
355030824000002,1,181,85,215,215,186,616
355030824000003,1,163,73,161,161,89,411
355030824000004,1,162,107,170,170,164,504
355030824000005,1,181,102,216,216,217,649
355030824000006,1,147,61,175,175,122,472
355030824000007,1,144,90,201,201,182,584
355030824000008,1,236,137,229,229,241,699
355030824000009,1,167,75,218,218,179,615
355030824000010,1,99,54,141,141,96,378
355030824000011,1,77,39,82,82,96,260
355030824000012,1,117,87,185,185,136,506
355030824000013,1,47,24,66,66,59,191
355030824000014,1,146,76,166,166,107,439
355030824000015,1,215,98,205,205,141,551
355030824000016,1,168,89,185,185,153,523
355030824000017,1,156,87,214,214,153,581
355030824000018,1,118,44,97,97,69,263
355030824000019,1,174,93,192,192,145,529
355030824000020,1,107,72,130,130,155,415
355030824000021,1,185,102,211,211,150,572
355030824000022,1,233,145,305,305,246,856
355030824000023,1,232,134,223,223,229,675
355030824000024,1,149,103,180,180,191,551
355030824000025,1,94,50,123,123,81,327
355030824000026,1,127,65,138,138,135,411
355030824000027,1,126,68,165,165,113,443
355030824000028,1,114,50,120,120,109,349
355030824000029,1,97,46,107,107,89,303
355030824000030,1,153,89,196,196,156,548
355030824000031,1,144,85,165,165,161,491
355030824000032,1,79,28,81,81,57,219
355030824000033,1,150,74,172,172,142,486
355030824000034,1,91,47,125,125,128,378
355030824000035,1,196,135,307,307,259,873
355030824000036,1,165,92,200,200,178,578
355030824000037,1,139,74,179,179,170,528
355030824000038,1,207,101,258,258,143,659
355030824000039,1,272,116,359,359,239,957
355030824000040,1,125,50,147,147,124,418
355030824000041,1,110,52,146,146,139,431
355030824000042,1,179,95,190,190,159,539
355030824000043,1,189,111,287,287,187,761
355030824000044,1,208,105,202,202,114,518
355030824000045,1,139,64,122,122,109,353
355030824000046,1,207,114,225,225,180,630
355030824000047,1,233,147,232,232,241,705
355030824000048,1,101,78,126,126,132,384
355030824000050,1,144,56,160,160,98,418
355030824000051,1,195,50,365,365,87,817
355030824000052,1,286,65,500,500,115,1115
355030824000053,1,186,72,211,211,153,575
355030824000054,1,229,116,250,250,150,650
355030824000055,1,222,100,228,228,122,578
355030824000056,1,53,37,73,73,66,212
355030824000057,1,219,106,227,227,110,564
355030824000058,1,74,36,94,94,80,268
355030824000059,1,127,79,194,194,130,518
355030824000060,1,93,53,112,112,79,303
355030824000061,1,239,107,242,242,155,639
355030824000062,1,203,102,251,251,165,667
355030824000063,1,46,20,52,52,41,145
355030824000064,1,150,97,203,203,153,559
355030824000065,1,167,70,328,328,381,1037
355030824000066,1,68,32,68,68,93,229
355030824000067,1,96,44,118,118,100,336
355030824000068,1,113,49,127,127,115,369
355030824000069,1,137,63,173,173,134,480
355030824000070,1,174,96,218,218,212,648
355030824000071,1,94,86,179,179,141,499
355030824000072,1,431,179,635,635,255,1525
355030824000073,1,200,96,207,207,121,535
355030824000074,1,253,105,232,232,102,566
355030824000075,1,181,113,191,191,187,569
355030824000076,1,221,127,250,250,185,685
355030824000077,1,137,77,144,144,145,433
355030824000078,1,146,67,182,182,155,519
355030824000079,1,69,47,99,99,76,274
355030824000080,1,78,40,121,121,58,300
355030824000081,1,71,45,97,97,65,259
355030824000082,1,81,40,91,91,57,239
355030824000083,1,114,73,189,189,132,510
355030824000084,1,186,85,254,254,92,600
355030824000085,1,118,63,133,133,110,376
355030824000086,1,261,114,258,258,182,698
355030824000087,1,119,49,145,145,83,373
355030824000088,1,68,38,64,64,34,162
355030824000089,1,142,58,110,110,40,260
355030824000090,1,678,299,653,653,215,1521
355030824000091,1,97,38,114,114,95,323
355030824000092,1,100,58,175,175,110,460
355030824000093,1,306,123,265,265,155,685
355030824000094,1,208,87,236,236,131,603
355030824000095,1,123,48,106,106,55,267
355030824000096,1,208,112,232,232,188,652
355030824000097,1,125,51,155,155,131,441
355030824000098,1,121,58,124,124,115,363
355030824000099,1,123,65,169,169,122,460
355030824000100,1,79,47,105,105,99,309
355030824000101,1,197,70,246,246,200,692
355030824000102,1,200,116,299,299,203,801
355030824000103,1,227,100,296,296,145,737
355030824000104,1,211,127,300,300,203,803
355030824000105,1,117,55,122,122,116,360
355030824000106,1,143,69,184,184,145,513
355030824000107,1,117,58,131,131,84,346
355030824000108,1,161,89,174,174,135,483
355030824000109,1,112,44,135,135,93,363
355030824000110,1,126,69,154,154,136,444
355030824000111,1,196,95,243,243,183,669
355030824000112,1,97,44,125,125,92,342
355030824000113,1,104,43,142,142,104,388
355030824000114,1,148,69,172,172,130,474
355030824000115,1,154,64,203,203,184,590
355030824000116,1,201,106,225,225,157,607
355030824000117,1,125,65,158,158,123,439
355030824000118,1,130,61,138,138,129,405
355030824000119,1,225,86,257,257,184,698
355030824000120,1,296,141,276,276,151,703
355030824000121,1,163,90,229,229,213,671
355030824000122,1,112,54,186,186,140,512
355030824000123,1,140,87,220,220,145,585
355030824000124,1,99,53,118,118,98,334
355030824000125,1,136,81,192,192,157,541
355030824000126,1,80,36,91,91,93,275
355030824000127,1,101,70,139,139,167,445
355030824000128,1,168,104,260,260,226,746
355030824000129,1,121,49,163,163,133,459
355030824000130,1,195,79,244,244,158,646
355030824000131,1,116,77,140,140,81,361
355030824000132,1,108,65,124,124,141,389
355030824000133,1,91,55,138,138,86,362
355030824000134,1,125,57,119,119,62,300
355030824000135,1,110,63,115,115,118,348
355030824000136,1,193,97,232,232,130,594
355030824000137,1,100,56,148,148,104,400
355030824000138,1,140,55,180,180,129,489
355030824000139,1,168,87,168,168,154,490
355030824000140,1,157,96,171,171,106,448
355030824000141,1,319,137,470,470,218,1158
355030824000142,1,166,72,165,165,79,409
355030824000143,1,92,69,151,151,117,419
355030824000144,1,58,28,86,86,50,222
355030824000145,1,88,54,84,84,69,237
355030824000146,1,67,42,68,68,65,201
355030824000147,1,70,48,107,107,89,303
355030824000148,1,153,63,196,196,119,511
355030824000149,1,121,57,149,149,129,427
355030824000150,1,75,43,97,97,84,278
355030824000151,1,65,47,69,69,68,206
355030824000152,1,128,63,166,166,120,452
355030824000153,1,50,10,163,163,22,348
355030824000154,1,113,41,138,138,37,313
355030824000155,1,83,26,157,157,35,349
355030824000157,1,85,33,102,102,109,313
355030824000158,1,38,17,38,38,42,118
355030824000159,1,119,68,126,126,79,331
355030824000160,1,107,46,90,90,64,244
355030824000161,1,96,39,125,125,51,301
355030824000162,1,288,132,201,201,99,501
355030824000163,1,147,47,113,113,27,253
355030824000164,1,307,144,308,308,149,765
355030824000165,1,649,238,615,615,164,1394
355030825000001,1,136,83,173,173,157,503
355030825000002,1,207,113,191,191,162,544
355030825000003,1,128,68,158,158,132,448
355030825000004,1,101,59,94,94,98,286
355030825000005,1,134,73,134,134,127,395
355030825000006,1,168,77,175,175,143,493
355030825000007,1,112,55,136,136,66,338
355030825000008,1,94,31,104,104,66,274
355030825000009,1,79,34,95,95,62,252
355030825000010,1,84,46,111,111,64,286
355030825000011,1,158,75,188,188,100,476
355030825000012,1,122,58,158,158,88,404
355030825000013,1,294,120,193,193,80,466
355030825000014,1,282,125,235,235,144,614
355030825000015,1,262,126,203,203,156,562
355030825000016,1,127,78,120,120,106,346
355030825000017,1,97,80,117,117,106,340
355030825000018,1,98,38,87,87,84,258
355030825000019,1,202,73,177,177,138,492
355030825000020,1,188,93,192,192,89,473
355030825000021,1,216,92,161,161,119,441
355030825000022,1,221,112,173,173,114,460
355030825000023,1,170,64,185,185,74,444
355030825000024,1,222,79,177,177,96,450
355030825000025,1,172,71,189,189,50,428
355030825000026,1,185,72,182,182,67,431
355030825000027,1,160,57,130,130,68,328
355030825000028,1,236,85,187,187,97,471
355030825000029,1,291,95,233,233,106,572
355030825000030,1,153,76,173,173,102,448
355030825000031,1,315,134,277,277,133,687
355030825000032,1,200,87,232,232,118,582
355030825000033,1,203,86,242,242,129,613
355030825000034,1,304,151,273,273,199,745
355030825000035,1,137,87,141,141,102,384
355030825000036,1,78,54,44,44,74,162
355030825000037,1,211,93,178,178,148,504
355030825000038,1,150,88,154,154,95,403
355030825000039,1,173,75,178,178,123,479
355030825000040,1,162,69,141,141,102,384
355030825000041,1,185,116,204,204,170,578
355030825000042,1,181,94,149,149,164,462
355030825000043,1,145,73,125,125,127,377
355030825000044,1,81,41,78,78,91,247
355030825000045,1,106,59,97,97,105,299
355030825000046,1,177,114,162,162,192,516
355030825000047,1,191,105,180,180,115,475
355030825000048,1,84,34,100,100,66,266
355030825000049,1,136,43,149,149,105,403
355030825000050,1,70,32,71,71,31,173
355030825000051,1,144,67,146,146,126,418
355030825000052,1,219,134,220,220,165,605
355030825000053,1,123,38,86,86,48,220
355030825000054,1,123,72,138,138,97,373
355030825000055,1,149,79,146,146,112,404
355030825000056,1,261,104,217,217,147,581
355030825000057,1,144,71,117,117,104,338
355030825000058,1,153,63,161,161,90,412
355030825000059,1,154,54,132,132,120,384
355030825000060,1,275,135,227,227,144,598
355030825000061,1,210,113,164,164,108,436
355030825000063,1,96,38,84,84,68,236
355030825000064,1,163,52,144,144,114,402
355030825000065,1,160,66,151,151,128,430
355030825000066,1,102,36,90,90,85,265
355030825000067,1,308,123,243,243,137,623
355030825000068,1,89,43,82,82,52,216
355030825000069,1,157,93,156,156,119,431
355030825000070,1,140,36,162,162,88,412
355030825000071,1,116,57,104,104,76,284
355030825000072,1,100,36,109,109,71,289
355030825000073,1,159,71,212,212,117,541
355030825000074,1,147,56,151,151,80,382
355030825000075,1,197,93,188,188,102,478
355030825000076,1,243,116,187,187,127,501
355030825000077,1,327,149,253,253,143,649
355030825000078,1,359,163,269,269,135,673
355030825000079,1,96,45,87,87,75,249
355030825000080,1,97,39,89,89,32,210
355030825000081,1,293,97,192,192,81,465
355030825000082,1,145,58,128,128,55,311
355030825000083,1,135,48,105,105,56,266
355030825000084,1,117,45,110,110,92,312
355030825000085,1,213,123,172,172,91,435
355030825000086,1,153,74,130,130,69,329
355030825000087,1,200,106,180,180,72,432
355030825000088,1,277,103,226,226,127,579
355030825000089,1,220,99,213,213,197,623
355030825000090,1,119,58,114,114,120,348
355030825000091,1,110,31,109,109,83,301
355030825000092,1,115,64,83,83,45,211
355030825000093,1,233,79,143,143,63,349
355030825000094,1,205,71,135,135,81,351
355030825000095,1,126,62,111,111,46,268
355030825000096,1,173,85,117,117,86,320
355030825000097,1,239,87,213,213,143,569
355030825000098,1,86,38,87,87,86,260
355030825000099,1,169,72,154,154,189,497
355030825000100,1,98,53,86,86,106,278
355030825000101,1,118,81,112,112,117,341
355030825000102,1,112,43,110,110,85,305
355030825000103,1,88,44,70,70,77,217
355030825000104,1,179,79,180,180,165,525
355030825000105,1,196,78,202,202,99,503
355030825000106,1,195,75,171,171,102,444
355030825000107,1,246,96,219,219,130,568
355030825000108,1,252,103,224,224,128,576
355030825000109,1,101,42,92,92,59,243
355030825000110,1,163,68,147,147,80,374
355030825000111,1,214,87,191,191,124,506
355030825000112,1,93,36,61,61,61,183
355030825000113,1,26,9,25,25,33,83
355030825000114,1,201,120,220,220,157,597
355030825000115,1,76,43,86,86,95,267
355030825000116,1,90,28,100,100,56,256
355030825000117,1,180,114,184,184,142,510
355030825000118,1,136,49,128,128,90,346
355030825000119,1,150,50,126,126,96,348
355030825000120,1,116,65,119,119,111,349
355030825000121,1,149,58,146,146,105,397
355030825000122,1,160,74,149,149,104,402
355030825000123,1,243,120,230,230,133,593
355030825000124,1,186,72,167,167,138,472
355030825000125,1,129,52,149,149,69,367
355030825000126,1,194,64,179,179,115,473
355030825000127,1,167,65,249,249,75,573
355030825000128,1,196,63,204,204,161,569
355030825000129,1,209,79,199,199,132,530
355030825000130,1,203,85,230,230,155,615
355030825000131,1,180,71,210,210,135,555
355030825000132,1,160,55,169,169,80,418
355030825000133,1,172,65,150,150,111,411
355030825000134,1,188,91,200,200,134,534
355030825000135,1,138,61,148,148,109,405
355030825000136,1,85,55,64,64,81,209
355030825000137,1,320,131,246,246,135,627
355030825000138,1,108,42,91,91,38,220
355030825000139,1,151,95,128,128,109,365
355030825000140,1,141,31,111,111,68,290
355030825000141,1,152,40,124,124,86,334
355030825000142,1,192,97,186,186,108,480
355030825000143,1,231,84,224,224,111,559
355030825000144,1,137,53,146,146,105,397
355030825000145,1,163,59,149,149,132,430
355030825000146,1,241,84,222,222,133,577
355030825000147,1,105,52,97,97,63,257
355030825000148,1,104,36,97,97,59,253
355030825000149,1,152,67,136,136,89,361
355030825000150,1,137,65,167,167,106,440
355030825000151,1,121,43,119,119,101,339
355030825000152,1,110,54,118,118,66,302
355030825000153,1,192,79,182,182,147,511
355030825000154,1,230,97,212,212,134,558
355030825000155,1,40,19,41,41,36,118
355030825000156,1,148,97,164,164,129,457
355030825000157,1,158,67,107,107,74,288
355030825000158,1,164,60,183,183,99,465
355030825000159,1,204,114,199,199,131,529
355030825000160,1,143,73,152,152,97,401
355030825000161,1,174,91,173,173,97,443
355030825000162,1,114,52,79,79,79,237
355030825000163,1,147,36,124,124,63,311
355030825000164,1,186,66,153,153,96,402
355030825000165,1,134,45,107,107,92,306
355030825000166,1,158,80,161,161,118,440
355030825000167,1,124,88,123,123,128,374
355030825000168,1,127,65,104,104,68,276
355030825000169,1,114,64,104,104,54,262
355030825000170,1,159,80,125,125,86,336
355030825000171,1,132,36,113,113,65,291
355030825000172,1,121,46,113,113,79,305
355030825000173,1,127,73,167,167,116,450
355030825000174,1,152,83,138,138,156,432
355030825000175,1,96,57,85,85,115,285
355030825000176,1,110,39,105,105,105,315
355030825000177,2,455,165,306,306,147,759
355030825000178,1,264,111,227,227,110,564
355030825000179,1,206,110,208,208,138,554
355030825000180,1,186,103,212,212,150,574
355030825000181,1,126,62,118,118,88,324
355030825000182,1,148,89,140,140,125,405
355030825000183,1,122,75,156,156,34,346
355030825000184,1,137,50,172,172,84,428
355030825000185,1,185,102,179,179,88,446
355030825000186,1,288,126,260,260,119,639
355030825000187,1,188,60,138,138,47,323
355030825000188,1,238,119,178,178,93,449
355030825000189,1,178,73,178,178,90,446
355030825000190,1,165,77,169,169,125,463
355030825000191,1,177,91,172,172,87,431
355030825000192,1,151,74,139,139,74,352
355030825000193,1,206,94,186,186,90,462
355030825000194,1,201,71,190,190,91,471
355030825000195,1,244,110,191,191,81,463
355030825000196,1,385,161,318,318,175,811
355030825000197,1,144,110,142,142,120,404
355030825000198,1,292,121,279,279,155,713
355030825000199,1,433,132,304,304,123,731
355030825000200,1,450,165,402,402,152,956
355030825000201,1,159,76,109,109,77,295
355030825000202,1,383,172,287,287,192,766
355030825000203,1,236,115,187,187,103,477
355030825000204,8,0,0,0,0,0,0
355030825000205,1,150,84,168,168,172,508
355030825000206,1,161,62,154,154,102,410
355030825000207,1,148,66,150,150,103,403
355030825000208,2,151,70,120,120,116,356
355030825000209,1,93,35,59,59,70,188
355030825000210,1,160,50,130,130,61,321
355030825000211,1,174,87,164,164,111,439
355030825000212,1,121,42,101,101,55,257
355030825000213,1,132,59,125,125,92,342
355030825000214,1,130,58,141,141,111,393
355030825000215,1,143,61,128,128,131,387
355030825000216,1,215,88,183,183,148,514
355030825000217,1,86,31,82,82,84,248
355030825000218,1,81,30,93,93,70,256
355030825000219,1,164,79,153,153,119,425
355030825000220,1,118,72,113,113,124,350
355030825000221,1,167,99,156,156,162,474
355030825000222,1,276,123,255,255,205,715
355030825000223,1,165,58,146,146,132,424
355030825000224,1,188,75,174,174,110,458
355030825000225,1,74,27,89,89,49,227
355030825000226,1,97,57,122,122,85,329
355030825000227,1,76,36,68,68,60,196
355030825000228,1,188,64,157,157,121,435
355030825000229,1,161,78,110,110,91,311
355030825000230,1,227,86,189,189,146,524
355030825000231,1,106,48,84,84,90,258
355030825000232,1,210,79,149,149,123,421
355030825000233,4,22,3,12,12,2,26
355030825000234,1,97,39,76,76,61,213
355030825000235,1,118,50,119,119,69,307
355030825000236,1,149,66,114,114,101,329
355030825000237,1,371,89,225,225,96,546
355030825000238,1,109,65,86,86,81,253
355030825000239,1,118,64,104,104,93,301
355030825000240,1,104,50,99,99,54,252
355030825000241,1,351,133,186,186,93,465
355030825000242,1,120,55,133,133,66,332
355030825000243,1,129,52,148,148,90,386
355030825000244,1,183,127,187,187,144,518
355030825000245,1,123,66,95,95,67,257
355030825000246,1,47,21,36,36,13,85
355030825000247,1,408,148,285,285,130,700
355030825000248,1,308,120,240,240,99,579
355030825000249,1,182,70,145,145,53,343
355030825000250,1,152,34,122,122,47,291
355030825000251,1,202,76,183,183,70,436
355030825000252,1,113,54,142,142,77,361
355030825000253,1,244,84,198,198,123,519
355030825000254,1,113,72,119,119,70,308
355030825000255,2,74,45,56,56,72,184
355030825000256,2,12,2,6,6,4,16
355030825000257,2,141,57,119,119,52,290
355030825000258,1,194,108,165,165,136,466
355030825000259,1,88,51,74,74,44,192
355030825000260,1,95,44,67,67,77,211
355030825000261,1,106,53,81,81,104,266
355030825000262,1,165,76,153,153,109,415
355030825000263,1,203,94,154,154,84,392
355030825000264,2,81,31,64,64,31,159
355030825000265,2,3,0,6,6,2,14
355030825000266,2,122,57,105,105,62,272
355030825000267,2,32,16,24,24,6,54
355030825000268,1,69,39,63,63,40,166
355030825000269,1,126,49,87,87,34,208
355030825000270,1,93,48,82,82,48,212
355030825000271,1,198,103,152,152,79,383
355030825000272,1,118,46,81,81,33,195
355030825000273,1,115,46,102,102,50,254
355030825000274,1,177,76,116,116,52,284
355030825000275,1,147,52,106,106,41,253
355030825000276,1,107,43,74,74,55,203
355030825000277,1,193,96,133,133,74,340
355030825000278,1,152,74,144,144,103,391
355030825000279,8,53,26,53,53,51,157
355030825000281,2,74,31,100,100,26,226
355030825000282,1,127,53,98,98,104,300
355030825000283,1,205,77,190,190,110,490
355030825000284,1,140,62,111,111,119,341
355030825000285,1,162,61,131,131,56,318
355030825000286,1,131,56,120,120,103,343
355030825000287,1,192,82,155,155,53,363
355030825000288,1,142,52,106,106,47,259
355030825000289,1,261,124,254,254,101,609
355030825000290,1,292,108,231,231,103,565
355030825000291,1,158,68,132,132,58,322
355030825000292,1,186,92,172,172,98,442
355030825000293,8,78,24,39,39,12,90
355030825000294,1,125,59,114,114,61,289
355030825000295,8,0,0,0,0,0,0
355030825000297,8,10,7,9,9,6,24
355030825000298,2,159,51,156,156,55,367
355030825000299,1,74,38,72,72,83,227
355030825000300,1,166,81,115,115,107,337
355030825000301,1,132,48,102,102,61,265
355030825000302,1,137,78,115,115,100,330
355030825000303,1,0,0,0,0,0,0
355030825000304,1,58,31,64,64,68,196
355030825000305,1,53,27,61,61,28,150
355030825000306,1,104,47,114,114,56,284
355030825000307,1,103,56,97,97,70,264
355030825000308,1,228,98,182,182,93,457
355030825000309,2,145,42,136,136,47,319
355030825000310,2,166,73,136,136,56,328
355030825000311,2,238,75,166,166,60,392
355030825000312,2,171,59,145,145,65,355
355030825000314,1,155,63,132,132,109,373
355030825000315,1,64,27,52,52,32,136
355030825000316,1,120,59,97,97,33,227
355030825000318,1,164,73,189,189,80,458
355030825000319,1,191,76,201,201,101,503
355030825000321,1,168,61,161,161,86,408
355030825000322,1,107,43,112,112,34,258
355030825000323,1,96,51,131,131,53,315
355030825000324,1,186,83,181,181,110,472
355030825000325,1,158,51,174,174,82,430
355030825000326,1,118,47,138,138,57,333
355030825000327,1,403,107,223,223,85,531
355030825000328,1,10,1,8,8,4,20
355030825000329,1,69,27,46,46,20,112
355030825000332,1,230,77,165,165,44,374
355030825000333,1,62,27,26,26,24,76
355030825000334,1,98,23,57,57,15,129
355030825000335,1,70,28,45,45,14,104
355030825000336,1,238,81,143,143,44,330
355030825000337,1,58,30,39,39,17,95
355030825000338,1,178,66,95,95,53,243
355030825000339,1,128,30,59,59,26,144
355030826000001,1,53,36,99,99,91,289
355030826000002,1,45,24,74,74,101,249
355030826000003,1,52,25,78,78,75,231
355030826000004,1,34,20,78,78,82,238
355030826000005,1,38,32,80,80,85,245
355030826000006,1,73,57,117,117,188,422
355030826000007,1,42,27,76,76,96,248
355030826000008,1,29,18,84,84,79,247
355030826000009,1,58,22,93,93,98,284
355030826000010,1,43,31,80,80,107,267
355030826000011,1,41,30,97,97,104,298
355030826000012,1,29,40,75,75,71,221
355030826000013,1,33,42,65,65,102,232
355030826000014,1,23,30,80,80,49,209
355030826000015,1,33,51,122,122,100,344
355030826000016,1,49,33,126,126,96,348
355030826000017,1,51,54,138,138,134,410
355030826000018,1,43,39,109,109,102,320
355030826000019,1,85,55,186,186,231,603
355030826000020,1,41,32,107,107,99,313
355030826000021,1,53,49,91,91,95,277
355030826000022,1,64,41,105,105,129,339
355030826000023,1,42,42,78,78,100,256
355030826000024,1,20,38,55,55,59,169
355030826000025,1,53,36,105,105,129,339
355030826000026,1,31,22,62,62,66,190
355030826000027,1,11,87,56,56,57,169
355030826000028,1,27,77,81,81,133,295
355030826000029,1,30,64,83,83,101,267
355030826000030,1,49,67,104,104,96,304
355030826000031,1,25,51,57,57,85,199
355030826000032,1,31,83,95,95,107,297
355030826000033,1,36,95,116,116,97,329
355030826000034,1,17,35,67,67,68,202
355030826000035,1,13,45,105,105,64,274
355030826000036,1,33,48,117,117,97,331
355030826000037,1,29,34,93,93,101,287
355030826000038,1,16,12,63,63,45,171
355030826000039,1,20,22,110,110,79,299
355030826000041,1,62,27,82,82,105,269
355030826000042,1,77,66,147,147,214,508
355030826000043,1,51,27,142,142,106,390
355030826000044,1,51,20,81,81,98,260
355030826000045,1,20,29,39,39,64,142
355030826000046,1,42,63,108,108,109,325
355030826000047,1,27,29,64,64,81,209
355030826000048,1,52,38,97,97,80,274
355030826000049,1,17,43,81,81,85,247
355030826000050,1,27,28,100,100,80,280
355030826000051,1,60,62,99,99,133,331
355030826000052,1,52,57,126,126,123,375
355030826000053,1,24,17,29,29,41,99
355030826000054,1,48,44,113,113,122,348
355030826000055,1,49,55,115,115,100,330
355030826000056,1,30,26,61,61,96,218
355030826000057,1,14,18,50,50,42,142
355030826000058,1,23,46,112,112,76,300
355030826000059,1,15,9,70,70,30,170
355030826000060,1,6,87,24,24,29,77
355030826000061,1,36,34,106,106,71,283
355030826000062,1,26,41,84,84,65,233
355030826000063,1,31,62,114,114,77,305
355030826000064,1,33,50,92,92,95,279
355030826000065,1,17,32,68,68,51,187
355030826000066,1,48,31,112,112,81,305
355030826000067,1,29,48,183,183,97,463
355030826000068,1,33,62,160,160,110,430
355030826000069,1,16,50,126,126,96,348
355030826000070,1,44,35,119,119,83,321
355030826000071,1,29,25,84,84,102,270
355030826000072,1,53,52,98,98,91,287
355030826000073,1,36,39,93,93,104,290
355030826000074,1,25,49,89,89,69,247
355030826000075,1,58,48,122,122,128,372
355030826000076,1,19,45,85,85,93,263
355030826000077,1,33,13,79,79,80,238
355030826000078,1,23,56,85,85,68,238
355030826000079,1,6,42,56,56,38,150
355030826000080,1,20,43,99,99,69,267
355030826000081,1,13,63,55,55,50,160
355030826000082,1,14,85,70,70,36,176
355030826000083,1,26,23,108,108,84,300
355030826000084,1,20,17,69,69,35,173
355030826000085,1,18,23,130,130,80,340
355030826000086,1,12,19,111,111,42,264
355030826000087,1,33,40,120,120,88,328
355030826000088,1,9,15,70,70,37,177
355030826000089,1,20,12,106,106,75,287
355030826000090,1,33,47,139,139,101,379
355030826000091,1,20,32,123,123,92,338
355030826000092,1,32,18,78,78,82,238
355030826000093,1,103,48,133,133,153,419
355030826000094,1,48,27,118,118,68,304
355030826000095,1,68,59,158,158,147,463
355030826000096,1,35,26,80,80,57,217
355030826000097,1,68,43,119,119,127,365
355030826000098,1,34,30,94,94,63,251
355030826000099,1,24,30,97,97,71,265
355030826000100,1,37,43,108,108,82,298
355030826000101,1,11,24,67,67,36,170
355030826000102,1,29,30,118,118,55,291
355030826000104,1,17,44,79,79,80,238
355030826000105,1,19,8,41,41,15,97
355030826000106,1,21,21,75,75,65,215
355030826000107,1,15,25,73,73,70,216
355030826000108,1,6,26,34,34,22,90
355030826000109,1,10,27,83,83,60,226
355030826000110,1,67,53,114,114,133,361
355030826000111,1,20,24,58,58,66,182
355030826000112,1,42,23,81,81,82,244
355030826000113,1,34,20,47,47,65,159
355030826000114,1,34,28,74,74,87,235
355030826000115,1,33,29,54,54,83,191
355030826000116,1,25,24,58,58,72,188
355030826000117,1,36,21,51,51,77,179
355030826000118,1,34,39,77,77,67,221
355030826000119,1,35,21,90,90,77,257
355030826000120,1,35,16,68,68,68,204
355030826000121,1,8,24,23,23,27,73
355030826000122,1,26,24,58,58,28,144
355030826000123,1,23,34,94,94,51,239
355030826000124,1,11,31,43,43,25,111
355030826000125,1,24,30,84,84,72,240
355030826000126,1,40,103,92,92,64,248
355030826000127,1,10,37,48,48,51,147
355030826000128,1,9,13,40,40,32,112
355030826000129,1,2,6,20,20,5,45
355030826000130,1,8,8,62,62,26,150
355030826000131,1,7,10,56,56,45,157
355030826000132,1,9,7,59,59,34,152
355030826000133,1,14,18,62,62,50,174
355030826000134,1,23,15,37,37,54,128
355030826000135,1,61,50,93,93,111,297
355030826000136,1,1,26,31,31,20,82
355030826000137,1,22,28,63,63,58,184
355030826000138,1,3,33,7,7,8,22
355030826000139,1,20,15,94,94,54,242
355030826000140,1,0,17,37,37,5,79
355030826000141,1,26,17,38,38,39,115
355030826000142,1,7,24,40,40,14,94
355030826000143,1,7,28,60,60,39,159
355030826000144,1,43,34,82,82,78,242
355030826000145,1,5,11,55,55,27,137
355030826000146,1,6,15,40,40,26,106
355030826000147,1,7,12,52,52,26,130
355030827000001,1,56,45,88,88,105,281
355030827000002,1,70,48,134,134,153,421
355030827000003,1,45,24,80,80,78,238
355030827000004,1,187,94,220,220,177,617
355030827000005,1,110,57,143,143,201,487
355030827000006,1,54,32,117,117,111,345
355030827000007,1,41,17,61,61,71,193
355030827000008,1,64,28,123,123,142,388
355030827000009,1,57,53,129,129,136,394
355030827000010,1,48,28,82,82,126,290
355030827000011,1,90,41,152,152,176,480
355030827000012,1,77,43,142,142,148,432
355030827000013,1,312,149,245,245,152,642
355030827000014,1,65,46,123,123,155,401
355030827000015,1,91,45,157,157,167,481
355030827000016,1,172,70,272,272,247,791
355030827000017,1,53,38,79,79,125,283
355030827000018,1,75,73,123,123,177,423
355030827000019,1,78,34,117,117,129,363
355030827000020,1,81,66,118,118,152,388
355030827000021,1,90,43,74,74,66,214
355030827000022,1,90,35,105,105,76,286
355030827000023,1,94,58,138,138,132,408
355030827000024,1,113,76,184,184,202,570
355030827000025,1,88,48,172,172,170,514
355030827000026,1,70,55,106,106,149,361
355030827000027,1,88,73,174,174,216,564
355030827000028,1,108,51,150,150,117,417
355030827000029,1,62,46,159,159,101,419
355030827000030,1,132,53,237,237,188,662
355030827000031,1,61,45,128,128,151,407
355030827000032,1,90,48,137,137,126,400
355030827000033,1,104,55,186,186,130,502
355030827000034,1,48,31,73,73,80,226
355030827000035,1,107,81,160,160,150,470
355030827000036,1,80,38,109,109,103,321
355030827000037,1,41,22,63,63,52,178
355030827000038,1,81,50,130,130,139,399
355030827000039,1,98,63,138,138,150,426
355030827000040,1,110,64,152,152,116,420
355030827000041,1,87,54,112,112,98,322
355030827000042,1,76,35,100,100,104,304
355030827000043,1,107,58,144,144,152,440
355030827000044,1,94,42,137,137,123,397
355030827000045,1,77,43,215,215,128,558
355030827000046,1,59,33,133,133,150,416
355030827000047,1,111,56,170,170,119,459
355030827000048,1,146,36,213,213,172,598
355030827000049,1,45,26,87,87,99,273
355030827000050,1,64,35,132,132,107,371
355030827000051,1,44,33,68,68,76,212
355030827000052,1,62,32,89,89,108,286
355030827000053,1,87,51,152,152,152,456
355030827000054,1,89,41,120,120,83,323
355030827000055,1,123,61,176,176,133,485
355030827000056,1,93,52,133,133,154,420
355030827000057,1,115,58,132,132,113,377
355030827000058,1,113,53,136,136,83,355
355030827000059,1,84,42,143,143,119,405
355030827000060,1,40,30,54,54,50,158
355030827000061,1,106,61,128,128,125,381
355030827000062,1,76,29,142,142,129,413
355030827000063,1,57,58,134,134,144,412
355030827000064,1,132,84,169,169,100,438
355030827000065,1,128,82,119,119,63,301
355030827000066,1,130,82,123,123,80,326
355030827000067,1,91,57,145,145,134,424
355030827000068,1,62,36,99,99,123,321
355030827000069,1,58,30,128,128,132,388
355030827000070,1,58,52,137,137,125,399
355030827000071,1,43,36,101,101,98,300
355030827000072,1,45,33,74,74,109,257
355030827000073,1,74,50,211,211,148,570
355030827000074,1,79,60,181,181,129,491
355030827000075,1,78,54,160,160,149,469
355030827000076,1,55,42,119,119,113,351
355030827000077,1,85,31,100,100,101,301
355030827000078,1,147,77,230,230,156,616
355030827000079,1,89,62,169,169,140,478
355030827000080,1,145,70,142,142,149,433
355030827000081,1,46,35,93,93,90,276
355030827000082,1,66,65,148,148,153,449
355030827000083,1,125,72,189,189,179,557
355030827000084,1,91,53,132,132,134,398
355030827000085,1,108,70,137,137,106,380
355030827000086,1,71,44,139,139,146,424
355030827000087,1,54,43,90,90,110,290
355030827000088,1,85,42,146,146,80,372
355030827000089,1,131,72,203,203,169,575
355030827000090,1,93,52,245,245,175,665
355030827000091,1,20,26,67,67,68,202
355030827000092,1,91,43,189,189,151,529
355030827000093,1,65,41,175,175,110,460
355030827000094,1,88,78,150,150,215,515
355030827000095,1,67,42,172,172,104,448
355030827000096,1,88,53,222,222,189,633
355030827000097,1,87,39,176,176,152,504
355030827000098,1,62,32,111,111,98,320
355030827000099,1,96,41,115,115,81,311
355030827000100,1,139,66,166,166,127,459
355030827000101,1,105,59,167,167,122,456
355030827000102,1,145,57,145,145,50,340
355030827000103,1,141,89,188,188,152,528
355030827000104,1,149,76,239,239,132,610
355030827000105,1,99,36,139,139,109,387
355030827000106,1,141,74,158,158,132,448
355030827000107,1,138,81,200,200,163,563
355030827000108,1,25,16,47,47,65,159
355030827000109,1,66,35,125,125,132,382
355030827000110,1,62,34,155,155,102,412
355030827000111,1,59,35,143,143,107,393
355030827000112,1,28,31,94,94,154,342
355030827000113,1,84,63,145,145,151,441
355030827000114,1,43,31,114,114,139,367
355030827000115,1,65,51,135,135,126,396
355030827000116,1,125,66,161,161,125,447
355030827000117,1,130,53,148,148,129,425
355030827000118,1,332,160,499,499,280,1278
355030827000119,1,202,99,261,261,154,676
355030827000120,1,78,44,133,133,121,387
355030827000121,1,124,73,228,228,217,673
355030827000122,1,90,45,127,127,109,363
355030827000123,1,96,52,124,124,80,328
355030827000124,1,58,27,84,84,66,234
355030827000125,1,28,23,63,63,68,194
355030827000126,1,47,19,79,79,71,229
355030827000127,1,56,29,132,132,91,355
355030827000128,1,47,34,68,68,53,189
355030827000129,1,63,28,120,120,102,342
355030827000130,1,41,32,104,104,122,330
355030827000131,1,35,14,73,73,81,227
355030827000132,1,85,79,151,151,172,474
355030827000133,1,184,79,211,211,100,522
355030827000134,1,31,27,49,49,76,174
355030827000135,1,94,52,228,228,167,623
355030827000136,1,99,76,208,208,219,635
355030827000137,1,89,41,117,117,122,356
355030827000138,1,72,41,147,147,128,422
355030827000139,1,74,43,151,151,101,403
355030827000140,4,6,2,4,4,11,19
355030827000143,1,85,37,133,133,148,414
355030827000144,1,74,40,117,117,102,336
355030827000145,1,72,48,95,95,120,310
355030827000146,1,105,37,184,184,107,475
355030827000147,1,72,45,176,176,107,459
355030827000148,1,27,33,64,64,95,223
355030827000149,1,199,55,128,128,37,293
355030827000150,1,45,15,234,234,53,521
355030827000151,1,487,201,422,422,135,979
355030827000152,1,120,44,68,68,25,161
355030827000153,1,52,33,97,97,112,306
355030827000154,1,40,16,91,91,66,248
355030827000155,1,107,62,132,132,110,374
355030827000156,1,19,11,30,30,47,107
355030827000157,1,107,52,140,140,113,393
355030827000158,1,69,42,83,83,92,258
355030827000159,1,99,50,146,146,104,396
355030827000160,1,68,50,79,79,75,233
355030827000161,1,46,46,87,87,109,283
355030827000162,1,86,27,115,115,84,314
355030827000163,1,68,49,98,98,68,264
355030827000164,1,120,54,131,131,120,382
355030827000165,1,83,65,122,122,124,368
355030827000166,1,79,59,126,126,119,371
355030827000167,1,59,27,84,84,70,238
355030827000168,1,46,40,86,86,95,267
355030827000169,1,66,33,139,139,101,379
355030827000170,1,76,54,111,111,97,319
355030827000171,1,78,47,106,106,114,326
355030827000172,1,28,16,51,51,77,179
355030827000173,1,47,16,91,91,72,254
355030827000174,1,39,22,87,87,52,226
355030827000175,1,166,63,316,316,175,807
355030827000176,1,92,44,98,98,59,255
355030827000177,1,76,29,193,193,62,448
355030827000178,1,55,38,111,111,88,310
355030827000179,1,83,43,125,125,111,361
355030827000180,1,33,16,41,41,30,112
355030827000181,1,37,19,30,30,18,78
355030827000182,1,67,48,93,93,50,236
355030827000183,1,100,38,86,86,40,212
355030827000184,1,85,46,98,98,21,217
355030828000001,1,171,75,208,208,156,572
355030828000002,1,158,80,210,210,152,572
355030828000003,1,134,81,147,147,115,409
355030828000004,1,129,75,148,148,121,417
355030828000005,1,134,74,136,136,103,375
355030828000006,1,112,50,118,118,101,337
355030828000007,1,52,21,66,66,50,182
355030828000008,1,98,55,98,98,88,284
355030828000009,1,117,61,132,132,128,392
355030828000010,1,147,62,149,149,151,449
355030828000011,1,204,73,158,158,83,399
355030828000012,1,88,57,116,116,105,337
355030828000013,1,95,39,104,104,85,293
355030828000014,1,117,63,125,125,72,322
355030828000015,1,168,67,129,129,93,351
355030828000016,1,41,21,64,64,31,159
355030828000017,1,93,51,106,106,71,283
355030828000018,1,168,91,165,165,86,416
355030828000019,1,211,102,187,187,127,501
355030828000020,1,116,59,105,105,116,326
355030828000021,1,88,40,115,115,65,295
355030828000022,1,57,33,90,90,65,245
355030828000023,1,111,49,129,129,106,364
355030828000024,1,105,68,173,173,141,487
355030828000025,1,95,69,127,127,100,354
355030828000026,1,89,54,132,132,96,360
355030828000027,1,160,62,251,251,139,641
355030828000028,1,40,25,66,66,45,177
355030828000029,1,165,72,174,174,120,468
355030828000030,1,198,113,329,329,218,876
355030828000031,1,135,61,190,190,150,530
355030828000032,1,144,83,182,182,140,504
355030828000033,1,98,30,101,101,111,313
355030828000034,1,93,67,130,130,99,359
355030828000035,1,73,55,138,138,103,379
355030828000036,1,125,64,143,143,148,434
355030828000037,1,72,45,104,104,104,312
355030828000038,1,71,30,61,61,36,158
355030828000039,1,209,86,192,192,84,468
355030828000040,1,123,72,111,111,63,285
355030828000041,1,43,33,57,57,43,157
355030828000042,1,164,90,165,165,133,463
355030828000043,1,131,59,127,127,96,350
355030828000044,1,178,118,207,207,189,603
355030828000045,1,116,57,140,140,104,384
355030828000046,1,74,36,106,106,83,295
355030828000047,1,154,78,186,186,122,494
355030828000048,1,163,71,135,135,131,401
355030828000049,1,122,65,153,153,123,429
355030828000050,1,89,58,134,134,104,372
355030828000051,1,135,72,163,163,162,488
355030828000052,1,153,73,165,165,122,452
355030828000053,1,79,36,155,155,86,396
355030828000054,1,145,75,205,205,152,562
355030828000055,1,174,84,166,166,152,484
355030828000056,1,76,54,100,100,114,314
355030828000057,1,197,84,212,212,181,605
355030828000058,1,130,56,166,166,139,471
355030828000059,1,122,48,146,146,109,401
355030828000060,1,70,45,101,101,109,311
355030828000061,1,158,85,209,209,178,596
355030828000062,1,182,96,211,211,167,589
355030828000063,1,111,87,157,157,89,403
355030828000064,1,121,61,154,154,107,415
355030828000065,1,131,56,168,168,84,420
355030828000066,1,171,77,223,223,144,590
355030828000067,1,106,64,157,157,105,419
355030828000068,1,133,54,175,175,89,439
355030828000069,1,123,64,135,135,112,382
355030828000070,1,232,83,242,242,131,615
355030828000071,1,171,82,150,150,83,383
355030828000072,1,236,76,204,204,120,528
355030828000073,1,223,101,233,233,170,636
355030828000074,1,210,102,248,248,167,663
355030828000075,1,66,44,113,113,109,335
355030828000076,1,105,53,121,121,101,343
355030828000077,1,221,86,195,195,166,556
355030828000078,1,100,60,129,129,93,351
355030828000079,1,77,48,93,93,88,274
355030828000080,1,140,46,178,178,148,504
355030828000081,1,52,29,54,54,57,165
355030828000082,1,130,62,158,158,131,447
355030828000083,1,91,58,114,114,113,341
355030828000084,1,83,54,125,125,109,359
355030828000085,1,27,23,56,56,67,179
355030828000086,1,78,47,102,102,109,313
355030828000087,1,111,55,151,151,127,429
355030828000088,1,90,40,173,173,62,408
355030828000089,1,71,35,90,90,95,275
355030828000090,1,63,36,102,102,86,290
355030828000091,1,81,53,111,111,89,311
355030828000092,1,37,20,54,54,41,149
355030828000093,1,172,77,195,195,121,511
355030828000094,1,153,70,193,193,125,511
355030828000095,1,97,43,126,126,73,325
355030828000096,1,158,82,172,172,118,462
355030828000097,1,95,65,111,111,99,321
355030828000098,1,161,99,170,170,123,463
355030828000099,1,98,45,119,119,70,308
355030828000100,1,170,68,194,194,139,527
355030828000101,1,163,79,207,207,142,556
355030828000102,1,56,36,78,78,58,214
355030828000103,1,95,54,130,130,128,388
355030828000104,1,294,88,234,234,209,677
355030828000105,1,210,131,236,236,176,648
355030828000106,1,120,58,135,135,78,348
355030828000107,1,65,49,110,110,85,305
355030828000108,1,98,81,167,167,124,458
355030828000109,1,105,41,133,133,84,350
355030828000110,1,91,37,103,103,98,304
355030828000111,1,106,46,152,152,112,416
355030828000112,1,78,44,98,98,86,282
355030828000113,1,152,59,183,183,115,481
355030828000114,1,205,102,255,255,163,673
355030828000115,1,246,119,271,271,144,686
355030828000116,1,204,98,237,237,135,609
355030828000117,1,146,96,193,193,127,513
355030828000118,1,177,113,211,211,164,586
355030828000119,1,206,96,242,242,182,666
355030828000120,1,113,69,104,104,63,271
355030828000121,1,280,135,441,441,235,1117
355030828000122,1,176,92,157,157,140,454
355030828000123,1,92,37,114,114,70,298
355030828000124,1,141,86,170,170,91,431
355030828000125,1,162,68,218,218,150,586
355030828000126,1,242,148,249,249,178,676
355030828000127,1,222,139,245,245,190,680
355030828000128,1,99,90,126,126,106,358
355030828000129,1,190,97,189,189,146,524
355030828000130,1,208,81,202,202,87,491
355030828000131,1,77,43,114,114,79,307
355030828000132,1,184,75,207,207,87,501
355030828000133,1,199,62,311,311,96,718
355030828000134,1,138,80,212,212,151,575
355030828000135,1,85,34,139,139,68,346
355030828000136,1,335,137,504,504,217,1225
355030828000137,1,327,176,353,353,200,906
355030828000138,1,199,99,199,199,123,521
355030828000140,1,197,74,183,183,71,437
355030828000141,1,162,68,179,179,89,447
355030828000142,1,149,58,164,164,56,384
355030828000143,1,234,94,253,253,98,604
355030828000144,1,66,49,81,81,76,238
355030828000145,1,90,37,92,92,71,255
355030828000146,1,99,50,86,86,83,255
355030828000147,1,100,54,137,137,113,387
355030828000148,1,96,55,96,96,124,316
355030828000149,1,99,68,130,130,80,340
355030828000150,1,101,53,120,120,92,332
355030828000151,1,123,50,148,148,60,356
355030828000152,1,157,61,160,160,51,371
355030828000153,1,113,56,137,137,99,373
355030828000154,1,158,66,111,111,100,322
355030828000155,1,60,22,88,88,63,239
355030828000156,1,82,67,121,121,93,335
355030828000157,1,57,19,67,67,32,166
355030828000158,1,39,20,54,54,42,150
355030828000159,1,70,30,71,71,32,174
355030828000160,1,119,45,132,132,29,293
355030828000161,1,113,49,145,145,56,346
355030828000162,1,307,107,302,302,106,710
355030828000163,1,6,1,4,4,4,12
355030828000164,1,68,17,117,117,41,275
355030828000165,1,78,30,125,125,89,339
355030828000166,1,184,77,179,179,73,431
355030828000167,1,37,16,29,29,14,72
355030828000168,1,65,28,73,73,34,180
355030828000169,1,105,53,72,72,51,195
355030828000170,1,81,33,59,59,65,183
355030828000171,1,86,30,93,93,63,249
355030828000172,1,63,32,62,62,28,152
355030828000173,1,104,50,104,104,48,256
355030828000174,1,198,117,198,198,134,530
355030828000175,1,31,22,42,42,29,113
355030828000176,1,81,34,84,84,38,206
355030828000177,1,72,33,65,65,20,150
355030828000178,1,134,45,131,131,76,338
355030829000001,1,113,61,166,166,142,474
355030829000002,1,97,54,167,167,133,467
355030829000003,1,81,43,127,127,140,394
355030829000004,1,135,88,193,193,183,569
355030829000005,1,95,40,133,133,129,395
355030829000006,1,144,88,223,223,193,639
355030829000007,1,123,89,151,151,217,519
355030829000008,1,115,72,195,195,135,525
355030829000009,1,154,91,317,317,223,857
355030829000010,1,139,70,197,197,179,573
355030829000011,1,92,52,167,167,114,448
355030829000012,1,108,50,146,146,130,422
355030829000013,1,129,69,221,221,193,635
355030829000014,1,125,89,182,182,181,545
355030829000015,1,53,30,95,95,98,288
355030829000016,1,86,54,150,150,143,443
355030829000017,1,67,50,117,117,122,356
355030829000018,1,87,65,154,154,209,517
355030829000019,1,17,8,36,36,28,100
355030829000020,1,109,57,158,158,157,473
355030829000021,1,36,28,64,64,97,225
355030829000022,1,100,83,175,175,185,535
355030829000023,1,82,37,225,225,134,584
355030829000024,1,90,62,128,128,228,484
355030829000025,1,123,49,196,196,178,570
355030829000026,1,64,38,105,105,52,262
355030829000027,1,57,28,88,88,70,246
355030829000028,1,148,72,208,208,175,591
355030829000029,1,170,111,250,250,214,714
355030829000030,1,122,75,168,168,195,531
355030829000031,1,130,62,193,193,180,566
355030829000032,1,55,31,75,75,86,236
355030829000033,1,108,63,180,180,145,505
355030829000034,1,67,45,85,85,101,271
355030829000035,1,108,51,162,162,131,455
355030829000036,1,137,80,168,168,144,480
355030829000037,1,108,52,176,176,141,493
355030829000038,1,96,52,127,127,60,314
355030829000039,1,135,86,166,166,159,491
355030829000040,1,92,38,133,133,84,350
355030829000041,1,92,53,129,129,136,394
355030829000042,1,156,92,202,202,192,596
355030829000043,1,74,35,69,69,107,245
355030829000044,1,50,31,76,76,108,260
355030829000045,1,67,14,88,88,76,252
355030829000046,1,96,49,175,175,152,502
355030829000047,1,53,24,77,77,95,249
355030829000048,1,106,61,203,203,209,615
355030829000049,1,98,74,109,109,154,372
355030829000050,1,106,73,157,157,230,544
355030829000051,1,120,74,196,196,195,587
355030829000052,1,206,97,298,298,210,806
355030829000053,1,63,41,110,110,111,331
355030829000054,1,114,52,154,154,125,433
355030829000055,1,73,39,105,105,100,310
355030829000056,1,119,65,169,169,133,471
355030829000057,1,107,76,170,170,174,514
355030829000058,1,80,40,108,108,98,314
355030829000059,1,73,38,89,89,80,258
355030829000060,1,129,63,157,157,150,464
355030829000061,1,127,84,174,174,131,479
355030829000062,1,87,45,112,112,105,329
355030829000063,1,86,47,127,127,129,383
355030829000064,1,65,53,88,88,111,287
355030829000065,1,81,46,121,121,104,346
355030829000066,1,142,76,174,174,146,494
355030829000067,1,54,39,98,98,96,292
355030829000068,1,75,41,91,91,103,285
355030829000069,1,90,42,119,119,111,349
355030829000070,1,108,64,164,164,172,500
355030829000071,1,123,50,192,192,139,523
355030829000072,1,137,63,190,190,130,510
355030829000073,1,163,105,244,244,159,647
355030829000074,1,130,72,178,178,108,464
355030829000075,1,207,105,224,224,132,580
355030829000076,1,114,67,141,141,144,426
355030829000077,1,133,65,172,172,118,462
355030829000078,1,47,31,81,81,80,242
355030829000079,1,170,66,250,250,211,711
355030829000080,1,95,61,169,169,161,499
355030829000081,1,47,19,77,77,59,213
355030829000082,1,195,107,322,322,294,938
355030829000083,1,84,35,130,130,170,430
355030829000084,1,84,39,175,175,157,507
355030829000085,1,114,88,207,207,259,673
355030829000086,1,110,59,172,172,124,468
355030829000087,1,36,22,71,71,53,195
355030829000088,1,123,66,149,149,148,446
355030829000089,1,50,41,97,97,102,296
355030829000090,1,103,53,123,123,111,357
355030829000091,1,63,39,86,86,99,271
355030829000092,1,83,55,103,103,92,298
355030829000093,1,104,44,122,122,113,357
355030829000094,1,166,89,204,204,216,624
355030829000095,1,102,68,154,154,155,463
355030829000096,1,104,60,104,104,133,341
355030829000097,1,110,58,123,123,110,356
355030829000098,1,74,52,83,83,80,246
355030829000099,1,181,85,199,199,158,556
355030829000100,1,136,69,150,150,123,423
355030829000101,1,73,29,102,102,57,261
355030829000102,1,145,77,188,188,153,529
355030829000103,1,112,43,195,195,139,529
355030829000104,1,101,44,147,147,159,453
355030829000105,1,127,76,146,146,106,398
355030829000106,1,71,38,83,83,61,227
355030829000107,1,34,30,61,61,96,218
355030829000108,1,138,87,204,204,161,569
355030829000109,1,118,51,161,161,144,466
355030829000110,1,141,81,201,201,158,560
355030829000111,1,100,50,132,132,86,350
355030829000112,1,49,56,213,213,59,485
355030829000113,1,91,54,117,117,92,326
355030829000114,1,103,55,156,156,124,436
355030829000115,1,162,84,232,232,256,720
355030829000116,1,172,81,180,180,133,493
355030829000117,1,121,69,170,170,132,472
355030829000118,1,112,79,146,146,140,432
355030829000119,1,123,93,175,175,163,513
355030829000120,1,131,53,183,183,159,525
355030829000121,1,244,105,267,267,88,622
355030829000122,1,101,45,163,163,144,470
355030829000123,1,73,44,118,118,87,323
355030829000124,1,66,33,59,59,47,165
355030829000125,1,154,63,170,170,88,428
355030829000126,1,70,29,78,78,96,252
355030829000127,1,187,85,214,214,147,575
355030829000128,1,194,90,188,188,122,498
355030829000129,1,303,150,268,268,180,716
355030829000130,1,165,88,242,242,162,646
355030829000131,1,118,59,187,187,121,495
355030829000132,1,130,50,128,128,110,366
355030829000133,1,90,35,123,123,93,339
355030829000134,1,128,47,147,147,114,408
355030829000135,1,113,57,158,158,127,443
355030829000136,1,92,43,120,120,104,344
355030829000137,1,89,44,153,153,146,452
355030829000138,1,103,61,154,154,140,448
355030829000139,1,192,95,232,232,172,636
355030829000140,1,158,64,182,182,129,493
355030829000141,1,95,66,145,145,144,434
355030829000142,1,120,84,128,128,110,366
355030829000143,1,128,62,185,185,148,518
355030829000144,1,176,102,206,206,180,592
355030829000145,1,97,61,116,116,80,312
355030829000146,1,266,132,273,273,208,754
355030829000147,1,103,58,156,156,95,407
355030829000148,1,140,56,170,170,147,487
355030829000149,1,120,68,152,152,122,426
355030829000150,1,137,74,116,116,89,321
355030829000151,1,171,79,193,193,165,551
355030829000152,1,94,49,120,120,108,348
355030829000153,1,96,69,125,125,141,391
355030829000154,1,40,24,58,58,42,158
355030829000155,1,132,71,191,191,146,528
355030829000156,1,125,68,143,143,150,436
355030829000157,1,122,51,137,137,103,377
355030829000158,1,100,55,109,109,108,326
355030829000159,1,144,100,185,185,123,493
355030829000160,1,75,38,109,109,91,309
355030829000161,1,182,110,187,187,145,519
355030829000162,1,239,106,239,239,165,643
355030829000163,1,369,101,503,503,193,1199
355030829000164,1,55,32,88,88,78,254
355030829000165,1,51,22,93,93,70,256
355030829000166,1,144,59,249,249,143,641
355030829000167,1,48,19,68,68,68,204
355030829000168,1,98,64,107,107,77,291
355030829000169,1,111,65,124,124,126,374
355030829000170,1,85,24,121,121,105,347
355030829000171,1,94,44,162,162,84,408
355030829000172,1,239,77,192,192,132,516
355030829000173,1,39,15,72,72,32,176
355030829000174,1,94,48,161,161,105,427
355030829000175,1,52,46,103,103,74,280
355030829000176,1,59,39,104,104,107,315
355030829000177,1,56,30,87,87,88,262
355030829000178,1,37,26,63,63,65,191
355030829000179,1,60,52,108,108,115,331
355030829000180,1,84,50,85,85,110,280
355030829000181,1,40,16,79,79,56,214
355030829000182,1,58,36,94,94,84,272
355030829000183,1,84,39,98,98,94,290
355030829000184,1,89,44,138,138,124,400
355030829000185,1,104,49,184,184,139,507
355030829000186,1,87,89,117,117,163,397
355030829000187,1,36,22,74,74,65,213
355030829000188,1,72,39,95,95,90,280
355030829000189,1,142,52,268,268,157,693
355030829000190,1,69,30,76,76,66,218
355030829000191,1,32,22,46,46,43,135
355030829000192,1,58,47,97,97,85,279
355030829000193,1,66,34,89,89,72,250
355030829000194,1,56,38,94,94,72,260
355030829000195,1,119,73,198,198,135,531
355030829000196,1,74,36,88,88,102,278
355030829000197,1,44,18,71,71,68,210
355030829000198,1,72,36,79,79,91,249
355030829000199,1,39,29,89,89,94,272
355030829000200,1,94,33,95,95,71,261
355030829000201,1,108,35,175,175,92,442
355030829000202,1,54,26,60,60,64,184
355030829000203,1,122,77,151,151,132,434
355030829000204,1,61,29,79,79,81,239
355030829000205,1,84,52,103,103,97,303
355030829000206,1,108,46,140,140,130,410
355030829000207,1,134,68,162,162,79,403
355030829000208,1,35,28,57,57,74,188
355030829000209,1,99,55,106,106,85,297
355030829000210,1,18,18,42,42,34,118
355030829000211,1,80,37,80,80,59,219
355030829000212,1,49,29,59,59,63,181
355030829000213,1,62,45,91,91,101,283
355030829000214,1,30,23,47,47,33,127
355030829000215,1,73,45,119,119,96,334
355030829000216,1,127,48,146,146,113,405
355030829000217,1,155,62,283,283,88,654
355030829000218,1,86,27,162,162,32,356
355030829000219,1,142,91,179,179,152,510
355030829000220,1,47,27,90,90,46,226
355030829000221,1,1,1,3,3,2,8
355030829000222,1,83,29,163,163,53,379
355030829000226,1,53,24,80,80,49,209
355030829000227,1,85,54,136,136,80,352
355030829000228,1,27,10,83,83,29,195
355030829000230,1,15,0,19,19,4,42
355030829000233,8,11,3,8,8,2,18
355030829000234,1,39,18,30,30,13,73
355030830000001,1,224,103,214,214,151,579
355030830000002,1,144,72,182,182,101,465
355030830000003,1,153,86,164,164,104,432
355030830000004,1,127,55,134,134,57,325
355030830000005,1,40,15,28,28,15,71
355030830000006,1,87,39,82,82,45,209
355030830000007,1,140,55,161,161,69,391
355030830000008,1,319,114,294,294,102,690
355030830000009,1,119,61,117,117,112,346
355030830000010,1,261,97,186,186,136,508
355030830000011,1,171,90,174,174,146,494
355030830000012,1,158,48,152,152,50,354
355030830000013,1,156,55,177,177,109,463
355030830000014,1,198,97,293,293,172,758
355030830000015,1,22,16,56,56,25,137
355030830000016,1,66,38,110,110,65,285
355030830000017,1,103,40,125,125,77,327
355030830000018,1,44,16,60,60,45,165
355030830000019,1,128,53,164,164,81,409
355030830000020,1,212,66,334,334,173,841
355030830000021,1,115,48,139,139,111,389
355030830000022,1,175,76,232,232,141,605
355030830000023,1,93,37,67,67,74,208
355030830000024,1,193,121,173,173,123,469
355030830000025,1,265,115,242,242,115,599
355030830000026,1,51,25,45,45,37,127
355030830000027,1,68,37,86,86,59,231
355030830000028,1,156,96,133,133,94,360
355030830000029,1,199,93,227,227,192,646
355030830000030,1,215,96,194,194,191,579
355030830000031,1,177,86,175,175,106,456
355030830000032,1,438,100,262,262,186,710
355030830000033,2,165,85,151,151,81,383
355030830000034,1,115,58,128,128,90,346
355030830000035,1,69,26,96,96,34,226
355030830000036,1,227,101,237,237,140,614
355030830000037,1,216,97,229,229,166,624
355030830000038,1,115,47,121,121,110,352
355030830000039,1,117,66,140,140,137,417
355030830000040,1,182,66,155,155,93,403
355030830000041,1,159,88,146,146,93,385
355030830000042,1,343,145,404,404,141,949
355030830000043,1,77,28,55,55,38,148
355030830000044,1,234,95,207,207,102,516
355030830000045,1,230,98,232,232,141,605
355030830000046,1,204,84,220,220,116,556
355030830000047,1,205,97,220,220,154,594
355030830000048,1,142,71,142,142,127,411
355030830000049,1,274,156,326,326,215,867
355030830000050,1,115,63,108,108,75,291
355030830000051,1,108,37,114,114,78,306
355030830000052,1,156,82,194,194,121,509
355030830000053,1,106,46,93,93,60,246
355030830000054,1,42,15,51,51,21,123
355030830000055,1,245,89,201,201,85,487
355030830000056,1,169,71,158,158,89,405
355030830000057,1,290,106,216,216,145,577
355030830000058,1,238,111,223,223,148,594
355030830000059,1,92,68,101,101,127,329
355030830000060,1,150,60,147,147,103,397
355030830000061,1,189,156,177,177,72,426
355030830000062,1,115,52,106,106,65,277
355030830000063,1,220,94,201,201,177,579
355030830000064,1,139,116,178,178,167,523
355030830000065,1,202,73,193,193,101,487
355030830000066,1,86,41,115,115,83,313
355030830000067,1,91,33,96,96,54,246
355030830000068,1,308,158,358,358,185,901
355030830000069,1,157,88,179,179,87,445
355030830000070,1,233,137,277,277,223,777
355030830000071,1,254,117,206,206,126,538
355030830000072,1,208,76,152,152,76,380
355030830000073,1,718,295,641,641,306,1588
355030830000074,2,951,348,848,848,288,1984
355030830000075,1,153,72,188,188,67,443
355030830000076,1,191,88,198,198,143,539
355030830000077,1,224,115,210,210,187,607
355030830000078,1,218,106,275,275,165,715
355030830000079,1,127,52,126,126,92,344
355030830000080,1,68,32,67,67,24,158
355030830000081,1,208,103,220,220,87,527
355030830000082,1,283,123,244,244,104,592
355030830000083,1,142,58,141,141,75,357
355030830000084,1,180,89,192,192,135,519
355030830000085,1,236,117,235,235,145,615
355030830000086,1,76,40,61,61,45,167
355030830000087,1,160,79,147,147,129,423
355030830000088,1,260,162,291,291,192,774
355030830000089,1,251,117,205,205,131,541
355030830000090,1,301,131,293,293,200,786
355030830000091,1,200,111,224,224,117,565
355030830000092,1,89,29,112,112,71,295
355030830000093,1,154,96,198,198,113,509
355030830000094,1,99,27,104,104,55,263
355030830000095,1,119,45,107,107,52,266
355030830000096,1,142,56,146,146,74,366
355030830000097,1,156,77,179,179,88,446
355030830000098,1,328,148,348,348,168,864
355030830000099,1,169,72,173,173,127,473
355030830000100,1,84,42,106,106,75,287
355030830000101,1,62,48,78,78,68,224
355030830000102,1,193,79,203,203,112,518
355030830000103,1,118,45,119,119,72,310
355030830000104,1,270,114,216,216,100,532
355030830000105,1,208,96,259,259,125,643
355030830000106,1,209,98,229,229,147,605
355030830000107,1,155,82,193,193,104,490
355030830000108,1,226,108,238,238,135,611
355030830000109,1,324,166,344,344,189,877
355030830000110,1,180,71,163,163,60,386
355030830000111,1,196,81,182,182,95,459
355030830000112,1,113,79,140,140,116,396
355030830000113,1,130,71,152,152,125,429
355030830000114,1,199,85,224,224,146,594
355030830000115,1,230,95,243,243,167,653
355030830000116,1,251,94,305,305,113,723
355030830000117,1,240,98,248,248,129,625
355030830000118,1,287,97,283,283,135,701
355030830000119,1,367,158,324,324,158,806
355030830000120,1,229,99,228,228,98,554
355030830000121,1,283,106,236,236,119,591
355030830000122,1,242,124,208,208,110,526
355030830000123,1,247,117,250,250,93,593
355030830000124,1,195,105,197,197,92,486
355030830000125,1,98,35,84,84,37,205
355030830000126,1,263,116,237,237,123,597
355030830000127,1,404,179,353,353,164,870
355030830000128,1,177,74,164,164,70,398
355030830000129,1,171,95,149,149,102,400
355030830000130,1,67,25,100,100,91,291
355030830000131,1,186,110,161,161,106,428
355030830000132,1,265,141,266,266,165,697
355030830000133,1,80,24,68,68,73,209
355030830000134,1,224,83,175,175,139,489
355030830000135,1,289,114,255,255,144,654
355030830000136,1,152,93,213,213,104,530
355030830000137,1,29,20,46,46,24,116
355030830000138,1,192,105,221,221,136,578
355030830000139,1,53,14,49,49,20,118
355030830000140,1,133,87,132,132,98,362
355030830000141,1,264,119,310,310,179,799
355030830000142,1,284,121,267,267,150,684
355030830000143,1,231,98,220,220,112,552
355030830000144,1,349,174,374,374,229,977
355030830000145,1,256,131,215,215,153,583
355030830000146,1,316,149,277,277,171,725
355030830000147,1,204,103,216,216,118,550
355030830000148,1,223,127,213,213,157,583
355030830000149,1,197,95,211,211,133,555
355030830000150,1,154,92,173,173,100,446
355030830000151,1,207,98,187,187,121,495
355030830000152,1,228,112,246,246,177,669
355030830000153,1,128,72,131,131,97,359
355030830000154,1,153,76,228,228,150,606
355030830000155,1,157,81,212,212,160,584
355030830000156,1,152,83,252,252,129,633
355030830000157,1,177,122,223,223,195,641
355030830000158,1,149,54,208,208,159,575
355030830000159,1,189,137,250,250,259,759
355030830000160,1,14,6,14,14,4,32
355030830000161,1,79,36,82,82,27,191
355030830000162,1,167,95,147,147,128,422
355030830000163,1,333,168,321,321,141,783
355030830000164,1,60,34,70,70,45,185
355030830000165,1,144,52,140,140,51,331
355030830000166,1,151,97,179,179,88,446
355030830000167,1,199,80,195,195,109,499
355030830000168,1,125,60,131,131,77,339
355030830000169,1,161,65,171,171,91,433
355030830000170,1,154,63,176,176,67,419
355030830000171,1,220,102,232,232,132,596
355030830000172,1,181,92,185,185,100,470
355030830000173,1,119,75,135,135,88,358
355030830000174,1,238,130,261,261,154,676
355030830000175,1,244,108,241,241,146,628
355030830000176,1,142,67,166,166,118,450
355030830000177,1,117,64,119,119,88,326
355030830000178,1,97,55,113,113,91,317
355030830000179,1,248,126,308,308,154,770
355030830000180,1,101,45,124,124,67,315
355030830000181,1,253,102,200,200,128,528
355030830000182,1,333,153,323,323,147,793
355030830000183,1,125,37,90,90,72,252
355030830000184,1,271,110,227,227,149,603
355030830000185,1,72,24,50,50,36,136
355030830000186,1,208,101,232,232,166,630
355030830000187,1,260,144,269,269,213,751
355030830000188,1,262,128,278,278,152,708
355030830000189,1,104,41,103,103,54,260
355030830000190,1,130,55,164,164,118,446
355030830000191,1,173,94,234,234,141,609
355030830000192,1,138,69,157,157,109,423
355030830000193,1,427,196,396,396,176,968
355030830000194,1,389,187,342,342,134,818
355030830000195,1,462,225,418,418,190,1026
355030830000196,1,324,115,271,271,79,621
355030830000197,1,197,100,185,185,106,476
355030830000198,1,396,182,352,352,141,845
355030830000199,1,269,126,254,254,135,643
355030830000200,1,222,116,251,251,154,656
355030830000201,1,146,96,159,159,110,428
355030830000202,1,148,82,148,148,85,381
355030830000203,1,225,96,191,191,125,507
355030830000204,1,243,124,276,276,145,697
355030830000205,1,199,109,201,201,135,537
355030830000206,1,354,169,317,317,156,790
355030830000207,1,96,54,99,99,76,274
355030830000208,1,197,96,175,175,110,460
355030830000209,1,115,60,102,102,53,257
355030830000210,1,256,90,202,202,112,516
355030830000211,1,281,95,254,254,104,612
355030830000212,1,252,75,211,211,123,545
355030830000213,1,282,121,214,214,100,528
355030830000214,1,187,116,198,198,149,545
355030830000215,1,147,86,199,199,113,511
355030830000216,1,210,87,204,204,113,521
355030830000217,1,255,115,229,229,133,591
355030830000218,1,77,30,55,55,32,142
355030830000219,1,178,78,187,187,97,471
355030830000220,1,74,36,69,69,56,194
355030830000221,1,134,75,145,145,91,381
355030830000222,1,140,65,176,176,115,467
355030830000223,1,86,42,106,106,54,266
355030830000224,1,71,49,81,81,63,225
355030830000225,1,245,120,196,196,129,521
355030830000226,1,136,81,149,149,71,369
355030830000227,1,30,14,32,32,11,75
355030830000228,1,236,86,297,297,161,755
355030830000229,1,127,51,111,111,85,307
355030830000230,1,127,56,142,142,116,400
355030830000231,1,159,107,205,205,232,642
355030830000232,1,153,73,164,164,150,478
355030830000233,1,201,108,188,188,214,590
355030830000234,1,66,24,68,68,54,190
355030830000235,1,163,79,156,156,116,428
355030830000236,1,281,130,253,253,153,659
355030830000237,1,203,130,204,204,155,563
355030830000238,1,249,118,266,266,177,709
355030830000239,1,179,86,185,185,133,503
355030830000240,1,166,102,207,207,137,551
355030830000241,1,151,87,212,212,132,556
355030830000242,1,340,162,327,327,174,828
355030830000243,1,271,126,308,308,168,784
355030830000244,1,430,180,441,441,121,1003
355030830000245,1,126,75,144,144,124,412
355030830000246,1,145,80,207,207,151,565
355030830000247,1,297,164,404,404,254,1062
355030830000248,1,114,64,205,205,107,517
355030830000249,1,160,63,189,189,114,492
355030830000250,1,243,107,252,252,122,626
355030830000251,1,146,57,97,97,81,275
355030830000252,1,30,12,36,36,18,90
355030830000253,1,140,83,159,159,74,392
355030830000254,1,164,82,257,257,147,661
355030830000255,1,144,69,166,166,119,451
355030830000256,1,164,106,174,174,122,470
355030830000257,1,58,31,71,71,42,184
355030830000258,1,36,20,33,33,33,99
355030830000259,1,212,93,188,188,113,489
355030830000260,1,99,63,156,156,113,425
355030830000261,1,100,39,107,107,77,291
355030830000262,1,166,73,170,170,126,466
355030830000263,1,145,77,142,142,117,401
355030830000264,1,174,66,204,204,117,525
355030830000265,1,40,23,44,44,47,135
355030830000266,1,219,87,159,159,91,409
355030830000267,1,121,60,135,135,103,373
355030830000268,1,356,171,317,317,238,872
355030830000269,1,140,92,158,158,133,449
355030830000270,1,187,107,218,218,182,618
355030830000271,1,149,81,179,179,144,502
355030830000272,1,132,74,158,158,150,466
355030830000273,1,87,39,102,102,49,253
355030830000274,1,234,147,238,238,185,661
355030830000275,1,134,83,137,137,88,362
355030830000276,1,436,188,364,364,119,847
355030830000277,1,327,135,288,288,75,651
355030830000278,1,84,45,119,119,100,338
355030830000279,1,169,76,232,232,148,612
355030830000280,1,25,13,27,27,14,68
355030830000281,1,428,156,309,309,105,723
355030830000282,1,139,60,173,173,144,490
355030830000283,1,62,33,120,120,55,295
355030830000284,1,129,62,164,164,129,457
355030830000285,1,130,66,162,162,143,467
355030830000286,1,56,42,80,80,68,228
355030830000287,1,178,73,196,196,158,550
355030830000288,1,194,94,219,219,193,631
355030830000289,1,151,77,137,137,137,411
355030830000290,1,264,123,257,257,169,683
355030830000291,1,197,92,167,167,90,424
355030830000292,1,194,77,151,151,55,357
355030830000293,1,356,149,296,296,147,739
355030830000294,1,151,91,133,133,81,347
355030830000295,1,127,49,120,120,51,291
355030830000296,1,132,61,170,170,134,474
355030830000297,1,229,121,300,300,224,824
355030830000298,1,121,72,153,153,129,435
355030830000299,1,128,64,154,154,139,447
355030830000300,1,180,89,265,265,197,727
355030830000301,1,48,30,69,69,62,200
355030830000302,1,226,74,198,198,99,495
355030830000303,1,289,134,281,281,178,740
355030830000304,1,178,63,158,158,105,421
355030830000305,1,277,118,283,283,176,742
355030830000306,1,0,0,0,0,0,0
355030830000307,1,199,86,183,183,77,443
355030830000308,1,418,171,434,434,150,1018
355030830000309,1,37,11,32,32,5,69
355030830000310,1,139,65,117,117,45,279
355030830000311,1,524,237,556,556,234,1346
355030830000312,1,297,128,307,307,108,722
355030830000313,3,47,21,28,28,25,81
355030830000314,1,274,107,395,395,123,913
355030830000315,1,163,45,142,142,52,336
355030830000316,1,171,76,152,152,69,373
355030830000317,1,371,156,290,290,139,719
355030830000318,1,135,45,125,125,64,314
355030830000319,1,565,209,524,524,245,1293
355030830000320,1,93,48,90,90,58,238
355030830000321,1,236,103,185,185,94,464
355030830000322,1,96,40,112,112,58,282
355030830000323,1,182,63,133,133,71,337
355030830000324,2,309,138,302,302,145,749
355030830000325,2,300,143,268,268,130,666
355030830000326,8,48,19,49,49,45,143
355030830000327,3,162,82,129,129,110,368
355030830000329,8,341,135,245,245,146,636
355030830000330,4,214,105,193,193,116,502
355030830000331,4,286,113,275,275,147,697
355030830000332,1,355,147,321,321,152,794
355030830000333,1,161,87,138,138,145,421
355030830000334,1,129,62,234,234,98,566
355030830000335,8,13,2,15,15,7,37
355030830000336,3,39,24,48,48,39,135
355030830000337,1,34,15,32,32,23,87
355030830000338,8,0,0,0,0,0,0
355030830000339,1,156,73,146,146,90,382
355030830000340,1,167,86,169,169,101,439
355030830000341,1,147,67,146,146,93,385
355030830000342,1,197,79,208,208,134,550
355030830000343,1,81,45,97,97,89,283
355030830000344,1,155,76,140,140,119,399
355030830000345,1,246,95,266,266,113,645
355030830000346,1,96,55,82,82,54,218
355030830000347,1,85,65,89,89,98,276
355030830000348,1,137,82,132,132,93,357
355030830000349,1,184,78,208,208,114,530
355030830000350,1,194,116,204,204,120,528
355030830000351,1,61,33,52,52,33,137
355030830000352,1,66,35,41,41,35,117
355030830000353,1,255,121,270,270,136,676
355030830000354,1,86,26,42,42,18,102
355030830000355,1,36,25,35,35,12,82
355030830000356,1,188,83,210,210,81,501
355030830000357,1,93,58,105,105,76,286
355030830000358,1,97,48,92,92,65,249
355030830000359,1,28,16,26,26,23,75
355030830000360,1,109,58,95,95,71,261
355030830000361,1,99,46,95,95,39,229
355030830000362,1,132,61,152,152,40,344
355030830000363,1,134,52,116,116,56,288
355030830000364,1,196,105,212,212,106,530
355030830000365,1,188,96,185,185,148,518
355030830000366,1,86,40,68,68,33,169
355030830000367,1,345,149,310,310,97,717
355030830000368,1,120,45,151,151,45,347
355030830000369,1,151,85,169,169,65,403
355030830000370,1,404,168,312,312,140,764
355030830000371,1,166,81,141,141,74,356
355030830000372,1,196,89,198,198,86,482
355030830000373,1,134,66,107,107,78,292
355030830000374,1,221,90,198,198,82,478
355030830000375,1,33,21,38,38,31,107
355030830000376,1,76,23,60,60,20,140
355030830000377,1,319,132,322,322,119,763
355030830000378,1,92,44,88,88,51,227
355030830000379,1,478,171,353,353,121,827
355030830000380,1,12,4,8,8,0,16
355030830000381,1,119,52,104,104,56,264
355030830000382,1,44,24,62,62,55,179
355030830000383,4,0,0,0,0,0,0
355030830000384,1,117,53,136,136,91,363
355030830000385,1,177,73,171,171,73,415
355030830000386,1,307,122,281,281,125,687
355030830000387,1,180,69,164,164,57,385
355030830000388,1,205,88,252,252,111,615
355030830000389,1,186,104,186,186,94,466
355030830000390,1,239,94,183,183,71,437
355030830000391,1,197,85,155,155,59,369
355030830000392,1,84,33,80,80,48,208
355030830000393,1,400,163,266,266,182,714
355030830000394,8,23,12,19,19,9,47
355030830000395,1,139,73,138,138,97,373
355030830000396,4,91,55,90,90,74,254
355030830000397,1,168,82,137,137,123,397
355030830000398,1,183,86,169,169,124,462
355030830000399,1,89,36,104,104,84,292
355030830000400,1,135,101,138,138,133,409
355030830000401,1,64,21,79,79,48,206
355030830000402,1,165,78,181,181,134,496
355030830000403,1,291,117,289,289,153,731
355030830000404,1,97,62,95,95,88,278
355030830000405,1,61,29,72,72,67,211
355030830000406,1,198,121,194,194,149,537
355030830000407,1,147,79,152,152,86,390
355030830000408,1,74,34,72,72,53,197
355030830000409,1,122,57,144,144,105,393
355030830000410,1,99,60,105,105,77,287
355030830000411,1,168,73,162,162,90,414
355030830000412,1,60,32,40,40,28,108
355030830000413,1,196,74,204,204,66,474
355030830000414,1,98,51,106,106,89,301
355030830000415,1,76,45,103,103,78,284
355030830000416,1,160,99,190,190,139,519
355030830000417,1,106,47,153,153,69,375
355030830000418,1,252,98,221,221,124,566
355030830000419,1,112,74,127,127,84,338
355030830000420,1,170,89,160,160,139,459
355030830000421,1,22,9,22,22,8,52
355030830000422,1,96,58,135,135,90,360
355030830000423,1,128,53,162,162,147,471
355030830000424,4,54,16,68,68,44,180
355030830000425,1,201,89,182,182,91,455
355030830000426,4,112,49,134,134,85,353
355030830000427,8,23,8,18,18,23,59
355030830000430,1,44,35,38,38,26,102
355030830000431,1,105,57,111,111,78,300
355030830000432,1,9,10,8,8,7,23
355030830000434,1,66,19,59,59,33,151
355030830000435,1,27,15,52,52,26,130
355030830000436,1,15,10,22,22,9,53
355030830000437,8,66,36,64,64,38,166
355030830000438,4,135,69,133,133,89,355
355030830000439,1,14,6,12,12,12,36
355030830000441,1,166,50,162,162,77,401
355030830000442,1,258,96,176,176,80,432
355030830000443,1,34,17,37,37,19,93
355030830000445,1,0,0,0,0,0,0
355030830000446,8,10,4,11,11,6,28
355030830000448,8,140,53,137,137,25,299
355030830000450,8,8,3,12,12,3,27
355030830000451,4,837,396,677,677,431,1785
355030830000452,4,34,7,32,32,29,93
355030830000453,1,8,4,11,11,9,31
355030830000454,8,56,21,85,85,29,199
355030830000455,4,44,22,53,53,34,140
355030830000456,1,30,12,32,32,20,84
355030830000458,4,6,3,7,7,7,21
355030830000459,8,15,5,15,15,6,36
355030830000460,4,7,1,10,10,3,23
355030830000461,8,6,6,7,7,3,17
355030830000462,4,0,0,0,0,0,0
355030830000463,1,0,0,0,0,0,0
355030830000468,4,47,28,45,45,38,128
355030830000469,2,56,25,72,72,46,190
355030830000471,8,13,0,9,9,4,22
355030830000472,4,45,15,37,37,31,105
355030830000473,8,0,0,0,0,0,0
355030830000477,8,0,0,0,0,0,0
355030830000479,1,107,45,96,96,69,261
355030830000480,1,335,113,311,311,107,729
355030830000481,3,132,60,129,129,70,328
355030830000482,1,133,38,126,126,45,297
355030830000483,3,217,102,180,180,124,484
355030830000484,8,27,10,25,25,19,69
355030830000488,8,46,11,30,30,15,75
355030830000490,1,164,92,179,179,87,445
355030830000491,1,109,67,83,83,68,234
355030830000492,1,30,9,24,24,13,61
355030830000493,8,0,0,0,0,0,0
355030830000494,8,4,1,2,2,0,4
355030830000495,8,0,0,0,0,0,0
355030830000497,8,0,0,0,0,0,0
355030830000499,1,106,62,109,109,84,302
355030830000500,8,0,0,0,0,0,0
355030830000504,8,0,0,0,0,0,0
355030830000505,8,31,10,22,22,20,64
355030830000506,8,7,2,4,4,7,15
355030830000509,8,66,34,55,55,46,156
355030830000513,8,0,0,0,0,0,0
355030830000517,8,34,17,30,30,32,92
355030830000519,8,0,0,0,0,0,0
355030830000520,3,168,54,113,113,59,285
355030830000521,8,0,0,0,0,0,0
355030830000522,8,39,9,21,21,5,47
355030830000523,8,16,15,9,9,15,33
355030830000527,8,0,0,0,0,0,0
355030830000528,8,23,8,24,24,17,65
355030830000529,8,4,1,1,1,6,8
355030830000530,8,5,6,6,6,7,19
355030830000531,8,12,10,18,18,14,50
355030830000532,8,3,2,3,3,2,8
355030830000533,8,51,32,47,47,42,136
355030830000534,8,78,21,44,44,27,115
355030830000537,8,2,0,4,4,4,12
355030830000538,3,28,10,18,18,16,52
355030830000541,8,0,1,2,2,5,9
355030830000542,8,6,3,6,6,5,17
355030830000543,8,0,0,0,0,0,0
355030830000544,8,4,3,6,6,1,13
355030830000545,8,0,0,0,0,0,0
355030830000546,8,0,0,0,0,0,0
355030830000547,8,0,0,0,0,0,0
355030830000548,8,0,0,0,0,0,0
355030830000550,8,0,0,0,0,0,0
355030830000551,8,0,0,0,0,0,0
355030830000554,8,11,8,13,13,5,31
355030830000555,8,0,0,0,0,0,0
355030830000557,8,0,0,0,0,0,0
355030830000558,8,0,0,0,0,0,0
355030830000559,8,13,11,16,16,15,47
355030830000561,8,0,0,0,0,0,0
355030830000562,8,0,0,0,0,0,0
355030830000563,8,0,0,0,0,0,0
355030830000564,8,0,0,0,0,0,0
355030830000565,8,56,18,43,43,30,116
355030830000567,8,134,53,93,93,108,294
355030830000568,3,12,12,16,16,15,47
355030830000569,8,0,0,0,0,0,0
355030830000570,8,0,0,0,0,0,0
355030830000571,8,0,0,0,0,0,0
355030830000572,8,11,5,6,6,9,21
355030830000574,8,0,0,0,0,0,0
355030830000576,8,0,0,0,0,0,0
355030830000578,8,35,24,31,31,29,91
355030830000579,8,17,6,7,7,8,22
355030830000580,8,3,1,5,5,9,19
355030830000581,8,3,1,1,1,4,6
355030830000582,8,4,3,6,6,4,16
355030830000586,2,0,0,0,0,0,0
355030830000587,2,3,0,3,3,3,9
355030830000588,2,0,0,0,0,0,0
355030830000589,8,4,7,6,6,4,16
355030830000590,8,39,13,25,25,16,66
355030830000591,8,15,8,8,8,12,28
355030830000592,8,7,7,5,5,4,14
355030830000594,8,9,3,10,10,8,28
355030830000595,8,22,5,20,20,11,51
355030830000596,8,9,1,11,11,4,26
355030830000599,8,21,7,17,17,6,40
355030830000601,4,17,7,14,14,4,32
355030830000602,1,97,42,84,84,81,249
355030830000603,4,8,8,14,14,10,38
355030830000604,8,0,0,0,0,0,0
355030830000605,8,12,9,11,11,14,36
355030830000607,4,16,5,18,18,11,47
355030830000611,4,53,18,30,30,21,81
355030830000613,1,99,47,89,89,35,213
355030830000614,1,139,67,116,116,98,330
355030830000615,1,14,6,19,19,15,53
355030830000616,1,37,14,43,43,33,119
355030830000617,1,12,2,4,4,5,13
355030830000618,1,15,22,37,37,23,97
355030830000619,1,119,70,194,194,119,507
355030830000620,1,43,31,46,46,27,119
355030830000623,1,6,4,12,12,10,34
355030830000624,1,77,29,82,82,58,222
355030830000636,1,50,25,46,46,39,131
355030830000637,1,87,32,54,54,45,153
355030830000638,1,43,20,44,44,25,113
355030830000639,1,50,24,57,57,29,143
355030830000640,1,34,17,35,35,21,91
355030830000641,1,57,31,43,43,26,112
355030830000642,1,56,30,75,75,27,177
355030830000643,1,56,28,67,67,26,160
355030830000644,1,16,9,27,27,19,73
355030830000645,1,53,20,42,42,46,130
355030830000646,1,62,21,62,62,31,155
355030830000647,1,32,13,30,30,17,77
355030830000648,1,15,12,17,17,5,39
355030830000649,1,27,24,29,29,21,79
355030830000650,1,30,19,41,41,29,111
355030830000651,1,64,44,66,66,38,170
355030830000652,1,44,26,32,32,27,91
355030830000653,1,50,29,57,57,39,153
355030830000654,1,92,60,75,75,54,204
355030830000655,1,48,25,46,46,24,116
355030830000656,1,101,47,111,111,47,269
355030830000657,1,113,46,93,93,65,251
355030830000658,1,63,22,60,60,39,159
355030830000659,1,28,12,27,27,14,68
355030830000660,1,70,48,80,80,52,212
355030830000661,1,103,31,66,66,32,164
355030830000662,1,10,11,19,19,28,66
355030830000663,1,20,7,18,18,16,52
355030830000664,1,84,38,83,83,50,216
355030830000665,1,51,24,48,48,25,121
355030830000666,1,84,41,93,93,50,236
355030830000667,1,77,29,65,65,25,155
355030830000668,1,50,11,27,27,14,68
355030830000669,1,113,61,96,96,75,267
355030830000670,1,56,19,57,57,29,143
355030830000671,1,66,20,75,75,40,190
355030830000672,1,51,15,34,34,17,85
355030830000673,1,34,14,29,29,18,76
355030830000674,1,45,26,49,49,27,125
355030830000675,1,207,76,177,177,70,424
355030830000676,1,82,35,87,87,32,206
355030830000677,1,114,46,126,126,59,311
355030830000678,1,60,54,89,89,23,201
355030830000679,1,29,14,37,37,14,88
355030830000680,1,157,58,110,110,31,251
355030830000681,1,68,28,63,63,50,176
355030830000682,1,93,55,85,85,60,230
355030830000683,1,177,86,138,138,99,375
355030830000684,1,308,154,266,266,178,710
355030830000685,1,19,14,22,22,21,65
355030830000686,1,10,5,25,25,5,55
355030831000001,1,152,74,171,171,132,474
355030831000002,1,79,44,90,90,54,234
355030831000003,1,64,41,73,73,56,202
355030831000004,1,198,97,189,189,117,495
355030831000005,1,143,81,133,133,86,352
355030831000006,1,81,46,117,117,77,311
355030831000007,1,112,55,103,103,85,291
355030831000008,1,103,53,97,97,46,240
355030831000009,1,130,59,147,147,122,416
355030831000010,1,178,93,254,254,131,639
355030831000011,1,352,151,421,421,239,1081
355030831000012,1,84,28,104,104,73,281
355030831000013,1,354,134,278,278,113,669
355030831000014,1,224,109,225,225,130,580
355030831000015,1,126,87,153,153,76,382
355030831000016,1,192,92,184,184,92,460
355030831000017,1,135,41,106,106,88,300
355030831000018,1,109,52,106,106,87,299
355030831000019,1,90,52,106,106,71,283
355030831000020,1,105,44,96,96,70,262
355030831000021,1,182,93,229,229,112,570
355030831000022,1,152,73,188,188,128,504
355030831000023,1,98,72,112,112,66,290
355030831000024,1,172,76,256,256,88,600
355030831000025,1,76,30,78,78,36,192
355030831000026,1,100,64,114,114,102,330
355030831000027,1,115,54,122,122,63,307
355030831000028,1,153,79,141,141,96,378
355030831000029,1,59,34,71,71,50,192
355030831000030,1,81,30,77,77,29,183
355030831000031,1,163,84,148,148,98,394
355030831000032,1,165,80,149,149,97,395
355030831000033,1,209,98,195,195,115,505
355030831000034,1,164,74,162,162,118,442
355030831000035,1,30,17,23,23,25,71
355030831000036,1,95,48,74,74,79,227
355030831000037,1,111,39,101,101,76,278
355030831000038,1,115,58,127,127,102,356
355030831000039,1,200,84,219,219,127,565
355030831000040,1,139,62,142,142,75,359
355030831000041,1,63,59,93,93,83,269
355030831000042,1,78,48,109,109,51,269
355030831000043,1,101,44,88,88,70,246
355030831000044,1,261,127,271,271,121,663
355030831000045,1,157,88,161,161,137,459
355030831000046,1,151,63,160,160,111,431
355030831000047,1,166,72,146,146,99,391
355030831000048,1,78,32,89,89,58,236
355030831000049,1,59,32,77,77,48,202
355030831000050,1,191,81,191,191,128,510
355030831000051,1,68,30,57,57,23,137
355030831000052,1,94,53,84,84,53,221
355030831000053,1,145,78,158,158,100,416
355030831000054,1,207,89,207,207,128,542
355030831000055,1,117,65,149,149,109,407
355030831000056,1,152,72,150,150,104,404
355030831000057,1,64,22,66,66,66,198
355030831000058,1,128,71,113,113,103,329
355030831000059,1,152,72,171,171,107,449
355030831000060,1,176,95,202,202,118,522
355030831000061,1,185,102,179,179,133,491
355030831000062,1,207,86,166,166,119,451
355030831000063,1,153,70,120,120,86,326
355030831000064,1,117,64,122,122,79,323
355030831000065,1,91,64,110,110,62,282
355030831000066,1,211,111,233,233,112,578
355030831000067,1,201,100,217,217,111,545
355030831000068,1,134,72,120,120,72,312
355030831000069,1,126,53,110,110,81,301
355030831000070,1,158,66,173,173,110,456
355030831000071,1,296,127,278,278,120,676
355030831000072,1,110,36,57,57,23,137
355030831000073,1,141,81,117,117,96,330
355030831000074,1,140,70,139,139,84,362
355030831000075,1,226,113,234,234,194,662
355030831000076,1,204,87,210,210,161,581
355030831000077,1,142,50,147,147,98,392
355030831000078,1,258,76,133,133,65,331
355030831000079,1,133,65,138,138,108,384
355030831000080,1,229,101,230,230,164,624
355030831000081,1,121,71,141,141,101,383
355030831000082,1,101,49,110,110,73,293
355030831000083,1,138,96,138,138,120,396
355030831000084,1,172,69,188,188,99,475
355030831000085,1,118,56,111,111,123,345
355030831000086,1,28,23,32,32,41,105
355030831000087,1,151,55,130,130,70,330
355030831000088,1,206,101,228,228,165,621
355030831000089,1,221,93,235,235,180,650
355030831000090,1,138,56,122,122,93,337
355030831000091,1,143,72,133,133,113,379
355030831000092,1,105,64,124,124,61,309
355030831000093,1,270,125,323,323,151,797
355030831000094,1,231,103,289,289,118,696
355030831000095,1,128,49,101,101,79,281
355030831000096,1,172,81,152,152,137,441
355030831000097,1,150,76,143,143,112,398
355030831000098,1,124,54,127,127,78,332
355030831000099,1,131,73,142,142,89,373
355030831000100,1,133,58,120,120,109,349
355030831000101,1,146,60,157,157,133,447
355030831000102,1,143,70,151,151,144,446
355030831000103,1,88,46,107,107,85,299
355030831000104,1,59,26,87,87,66,240
355030831000105,1,101,69,87,87,109,283
355030831000106,1,29,14,31,31,36,98
355030831000107,1,245,96,234,234,138,606
355030831000108,1,158,76,139,139,131,409
355030831000109,1,106,48,75,75,103,253
355030831000110,1,178,89,161,161,139,461
355030831000111,1,164,61,137,137,105,379
355030831000112,1,132,72,112,112,119,343
355030831000113,1,128,68,146,146,97,389
355030831000114,1,104,50,78,78,49,205
355030831000115,1,130,66,148,148,116,412
355030831000116,1,222,106,250,250,159,659
355030831000117,1,160,91,179,179,99,457
355030831000118,1,409,150,399,399,170,968
355030831000119,1,192,93,170,170,122,462
355030831000120,1,417,166,377,377,154,908
355030831000121,1,356,162,316,316,139,771
355030831000122,2,18,13,16,16,13,45
355030831000123,8,14,2,6,6,1,13
355030831000124,1,180,65,171,171,110,452
355030831000125,1,92,49,97,97,83,277
355030831000126,1,189,83,192,192,129,513
355030831000127,1,133,70,135,135,71,341
355030831000128,1,94,54,96,96,90,282
355030831000129,1,91,34,95,95,55,245
355030831000130,1,111,59,112,112,79,303
355030831000131,1,139,48,120,120,62,302
355030831000132,1,51,26,57,57,32,146
355030831000133,1,88,57,96,96,62,254
355030831000134,1,80,36,88,88,48,224
355030831000135,1,270,138,230,230,144,604
355030831000136,1,108,81,128,128,113,369
355030831000137,1,108,53,90,90,56,236
355030831000138,1,115,70,115,115,55,285
355030831000139,1,104,53,95,95,76,266
355030831000140,1,103,62,88,88,65,241
355030831000141,1,55,27,67,67,59,193
355030831000142,1,112,65,123,123,74,320
355030831000143,1,101,44,93,93,77,263
355030831000144,1,128,47,135,135,89,359
355030831000145,1,73,20,60,60,63,183
355030831000146,1,111,56,96,96,66,258
355030831000147,1,118,46,118,118,66,302
355030831000148,1,208,138,220,220,166,606
355030831000149,1,99,42,102,102,40,244
355030831000150,1,68,27,69,69,45,183
355030831000151,1,84,37,105,105,80,290
355030831000152,1,117,57,142,142,76,360
355030831000153,1,89,40,93,93,36,222
355030831000154,1,34,14,23,23,18,64
355030831000155,1,95,58,90,90,91,271
355030831000156,1,54,28,75,75,38,188
355030831000157,1,92,38,106,106,106,318
355030831000158,1,76,52,107,107,61,275
355030831000159,1,115,51,118,118,77,313
355030831000160,1,193,105,196,196,127,519
355030831000161,1,166,63,129,129,35,293
355030831000162,2,5,2,6,6,4,16
355030831000163,2,8,1,9,9,3,21
355030831000164,1,332,123,300,300,73,673
355030831000165,1,24,8,16,16,7,39
355030831000166,1,497,201,439,439,181,1059
355030831000167,1,114,32,80,80,63,223
355030831000168,1,62,25,45,45,8,98
355030831000169,1,68,40,63,63,29,155
355030831000170,1,95,33,68,68,49,185
355030831000171,1,37,28,43,43,22,108
355030832000001,1,58,47,131,131,159,421
355030832000002,1,80,63,160,160,221,541
355030832000003,1,35,28,45,45,68,158
355030832000004,1,38,21,95,95,101,291
355030832000005,1,69,38,175,175,151,501
355030832000006,1,67,36,170,170,141,481
355030832000007,1,23,21,84,84,82,250
355030832000008,1,49,48,80,80,109,269
355030832000009,1,61,19,119,119,88,326
355030832000010,1,61,24,122,122,137,381
355030832000011,1,36,17,45,45,70,160
355030832000012,1,48,37,102,102,121,325
355030832000013,1,56,32,124,124,115,363
355030832000014,1,53,22,67,67,97,231
355030832000015,1,21,15,59,59,56,174
355030832000016,1,35,34,172,172,145,489
355030832000017,1,35,15,105,105,73,283
355030832000018,1,22,14,107,107,78,292
355030832000019,1,33,31,119,119,90,328
355030832000020,1,74,27,164,164,121,449
355030832000021,1,45,33,111,111,116,338
355030832000022,1,61,28,156,156,129,441
355030832000023,1,21,20,102,102,95,299
355030832000024,1,82,32,191,191,127,509
355030832000025,1,34,24,113,113,113,339
355030832000026,1,71,32,156,156,131,443
355030832000027,1,45,29,108,108,127,343
355030832000028,1,54,25,126,126,105,357
355030832000029,1,31,5,88,88,53,229
355030832000030,1,45,16,100,100,77,277
355030832000031,1,63,37,99,99,105,303
355030832000032,1,45,23,122,122,102,346
355030832000033,1,49,28,116,116,98,330
355030832000034,1,91,34,134,134,113,381
355030832000035,1,101,60,167,167,218,552
355030832000036,1,107,51,185,185,202,572
355030832000037,1,50,30,98,98,118,314
355030832000038,1,21,13,82,82,77,241
355030832000039,1,39,24,131,131,109,371
355030832000040,1,58,18,95,95,82,272
355030832000041,1,33,29,103,103,126,332
355030832000042,1,38,27,150,150,105,405
355030832000043,1,71,29,189,189,125,503
355030832000044,1,154,57,193,193,195,581
355030832000045,1,36,22,169,169,91,429
355030832000046,1,20,17,63,63,75,201
355030832000047,1,4,9,106,106,68,280
355030832000048,1,73,46,216,216,166,598
355030832000049,1,67,23,174,174,107,455
355030832000050,1,27,21,117,117,84,318
355030832000051,1,75,46,204,204,176,584
355030832000052,1,9,4,68,68,40,176
355030832000053,1,16,18,99,99,78,276
355030832000054,1,32,42,97,97,114,308
355030832000055,1,36,20,85,85,95,265
355030832000056,1,25,19,61,61,74,196
355030832000057,1,43,36,135,135,129,399
355030832000058,1,60,33,126,126,144,396
355030832000059,1,70,37,191,191,169,551
355030832000060,1,94,52,183,183,147,513
355030832000061,1,68,50,226,226,132,584
355030832000062,1,86,45,196,196,140,532
355030832000063,1,116,57,180,180,205,565
355030832000064,1,73,41,120,120,127,367
355030832000065,1,27,4,49,49,64,162
355030832000066,1,74,30,174,174,133,481
355030832000067,1,19,15,57,57,54,168
355030832000068,1,37,19,85,85,67,237
355030832000069,1,33,45,121,121,126,368
355030832000070,1,6,13,73,73,63,209
355030832000071,1,36,20,98,98,91,287
355030832000072,1,86,51,120,120,141,381
355030832000073,1,109,42,229,229,161,619
355030832000074,1,14,22,138,138,76,352
355030832000075,1,29,20,125,125,133,383
355030832000076,1,166,55,266,266,187,719
355030832000077,1,10,21,86,86,51,223
355030832000078,1,116,59,162,162,180,504
355030832000079,1,63,53,129,129,179,437
355030832000080,1,79,21,161,161,103,425
355030832000081,1,42,25,102,102,105,309
355030832000082,1,11,7,73,73,42,188
355030832000083,1,33,24,112,112,128,352
355030832000084,1,20,19,56,56,56,168
355030832000085,1,38,28,117,117,107,341
355030832000086,1,37,28,94,94,91,279
355030832000087,1,16,16,110,110,77,297
355030832000088,1,51,26,144,144,118,406
355030832000089,1,24,30,88,88,109,285
355030832000090,1,50,31,133,133,112,378
355030832000091,1,39,36,161,161,132,454
355030832000092,1,125,59,176,176,178,530
355030832000093,1,42,33,79,79,102,260
355030832000094,1,99,34,198,198,104,500
355030832000095,1,124,47,207,207,104,518
355030832000096,1,69,24,171,171,109,451
355030832000097,1,12,20,85,85,73,243
355030832000098,1,28,25,136,136,69,341
355030832000099,1,60,32,139,139,137,415
355030832000100,1,45,23,143,143,99,385
355030832000101,1,53,46,157,157,131,445
355030832000102,1,33,21,94,94,69,257
355030832000103,1,28,21,120,120,82,322
355030832000104,1,55,36,121,121,100,342
355030832000105,1,57,33,121,121,122,364
355030832000106,1,47,30,108,108,117,333
355030832000107,1,40,31,76,76,104,256
355030832000108,1,62,42,112,112,129,353
355030832000109,1,92,64,151,151,189,491
355030832000110,1,69,40,155,155,152,462
355030832000111,1,88,36,131,131,152,414
355030832000112,1,48,39,130,130,153,413
355030832000113,1,17,10,103,103,50,256
355030832000114,1,41,23,135,135,120,390
355030832000115,1,32,21,124,124,74,322
355030832000116,1,34,22,134,134,116,384
355030832000117,1,17,12,73,73,62,208
355030832000118,1,50,27,155,155,125,435
355030832000119,1,25,19,89,89,90,268
355030832000120,1,29,27,73,73,85,231
355030832000121,1,28,18,108,108,90,306
355030832000122,1,16,18,67,67,51,185
355030832000123,1,61,40,153,153,121,427
355030832000124,1,73,29,166,166,174,506
355030832000125,1,42,23,86,86,74,246
355030832000126,1,53,42,152,152,151,455
355030832000127,1,53,30,166,166,96,428
355030832000128,1,53,26,164,164,117,445
355030832000129,1,23,20,91,91,73,255
355030832000130,1,59,35,128,128,135,391
355030832000131,1,74,32,119,119,146,384
355030832000132,1,83,38,187,187,143,517
355030832000133,1,86,47,146,146,156,448
355030832000134,1,81,39,195,195,148,538
355030832000135,1,54,30,117,117,113,347
355030832000136,1,25,11,78,78,84,240
355030832000137,1,41,34,76,76,83,235
355030832000138,1,39,15,86,86,60,232
355030832000139,1,54,47,98,98,136,332
355030832000140,1,83,47,168,168,135,471
355030832000141,1,49,17,126,126,51,303
355030832000142,1,25,21,100,100,54,254
355030832000143,1,28,7,86,86,38,210
355030832000144,1,12,5,72,72,15,159
355030832000145,1,176,47,275,275,107,657
355030832000146,1,7,18,80,80,46,206
355030832000147,1,21,16,112,112,63,287
355030832000148,1,22,16,56,56,40,152
355030832000149,1,55,46,118,118,123,359
355030832000150,1,34,23,93,93,41,227
355030832000151,1,19,26,82,82,94,258
355030832000152,1,21,17,134,134,65,333
355030832000153,1,22,23,49,49,49,147
355030832000154,1,11,8,64,64,43,171
355030832000155,1,36,35,96,96,101,293
355030832000156,1,26,9,65,65,44,174
355030832000157,1,90,50,183,183,187,553
355030832000158,1,3,3,46,46,13,105
355030832000159,1,33,17,50,50,66,166
355030832000160,1,50,35,111,111,64,286
355030832000161,1,41,8,127,127,62,316
355030832000162,1,33,13,86,86,49,221
355030832000163,1,38,15,98,98,87,283
355030832000164,1,92,70,119,119,155,393
355030832000166,1,26,32,128,128,105,361
355030832000167,1,25,15,49,49,63,161
355030832000168,1,8,10,57,57,71,185
355030832000169,1,83,39,160,160,100,420
355030832000170,1,50,22,125,125,81,331
355030832000171,1,58,16,158,158,68,384
355030832000172,1,17,5,70,70,23,163
355030832000173,1,10,17,110,110,46,266
355030832000174,1,22,9,76,76,50,202
355030832000175,1,127,61,168,168,173,509
355030832000176,1,19,7,53,53,64,170
355030832000177,1,5,13,29,29,47,105
355030833000001,1,176,85,192,192,109,493
355030833000002,1,120,57,130,130,89,349
355030833000003,1,197,111,241,241,151,633
355030833000004,1,204,121,223,223,221,667
355030833000005,1,104,50,103,103,100,306
355030833000006,1,127,79,145,145,107,397
355030833000007,1,69,32,71,71,57,199
355030833000008,1,189,89,211,211,146,568
355030833000009,1,85,45,91,91,62,244
355030833000010,1,176,87,177,177,115,469
355030833000011,1,53,22,52,52,49,153
355030833000012,1,220,74,192,192,72,456
355030833000013,1,199,105,250,250,176,676
355030833000014,1,99,60,132,132,102,366
355030833000015,1,162,65,188,188,130,506
355030833000016,1,85,47,104,104,62,270
355030833000017,1,121,61,111,111,73,295
355030833000018,1,165,88,177,177,113,467
355030833000019,1,140,69,134,134,82,350
355030833000020,1,101,29,112,112,93,317
355030833000021,1,163,56,147,147,87,381
355030833000022,1,210,98,201,201,150,552
355030833000023,1,199,121,233,233,186,652
355030833000024,1,171,73,247,247,155,649
355030833000025,1,175,90,196,196,136,528
355030833000026,1,50,18,42,42,29,113
355030833000027,1,75,38,110,110,86,306
355030833000028,1,125,66,87,87,97,271
355030833000029,1,111,64,118,118,122,358
355030833000030,1,81,31,102,102,79,283
355030833000031,1,108,71,114,114,89,317
355030833000032,1,197,102,255,255,175,685
355030833000033,1,123,59,113,113,120,346
355030833000034,1,264,143,274,274,223,771
355030833000035,1,281,145,313,313,204,830
355030833000036,1,92,32,112,112,87,311
355030833000037,1,125,62,175,175,152,502
355030833000038,1,161,82,164,164,126,454
355030833000039,1,110,33,119,119,48,286
355030833000040,1,197,110,229,229,149,607
355030833000041,1,155,71,236,236,172,644
355030833000042,1,162,57,176,176,100,452
355030833000043,1,108,48,133,133,64,330
355030833000044,1,93,49,99,99,73,271
355030833000045,1,140,77,134,134,93,361
355030833000046,1,104,73,106,106,81,293
355030833000047,1,115,68,142,142,99,383
355030833000048,1,199,77,160,160,86,406
355030833000049,1,114,49,102,102,86,290
355030833000050,1,137,53,141,141,118,400
355030833000051,1,153,80,198,198,139,535
355030833000052,1,143,69,114,114,73,301
355030833000053,1,231,119,273,273,194,740
355030833000054,1,125,76,102,102,102,306
355030833000055,1,84,52,103,103,92,298
355030833000056,1,130,43,124,124,94,342
355030833000057,1,126,69,134,134,93,361
355030833000058,1,133,69,110,110,129,349
355030833000059,1,83,55,86,86,92,264
355030833000060,1,138,69,162,162,104,428
355030833000061,1,287,142,237,237,141,615
355030833000062,1,151,51,172,172,97,441
355030833000063,1,176,99,214,214,142,570
355030833000064,1,105,57,142,142,90,374
355030833000065,1,159,102,185,185,135,505
355030833000066,1,173,84,161,161,131,453
355030833000067,1,223,104,239,239,140,618
355030833000068,1,152,60,179,179,65,423
355030833000069,1,289,147,278,278,160,716
355030833000070,1,133,65,129,129,89,347
355030833000071,1,158,74,135,135,70,340
355030833000072,1,205,104,218,218,157,593
355030833000073,1,230,125,228,228,165,621
355030833000074,1,206,129,223,223,154,600
355030833000075,1,129,82,124,124,93,341
355030833000076,1,209,133,180,180,140,500
355030833000077,1,203,111,205,205,135,545
355030833000078,1,238,165,212,212,130,554
355030833000079,1,184,112,150,150,142,442
355030833000080,1,230,135,210,210,111,531
355030833000081,1,187,90,173,173,109,455
355030833000082,1,174,115,184,184,118,486
355030833000083,1,150,92,176,176,114,466
355030833000084,1,166,83,169,169,96,434
355030833000085,1,165,87,170,170,139,479
355030833000086,1,165,92,140,140,125,405
355030833000087,1,176,105,185,185,164,534
355030833000088,1,161,109,147,147,137,431
355030833000089,1,117,75,94,94,104,292
355030833000090,1,149,93,143,143,109,395
355030833000091,1,262,139,279,279,171,729
355030833000092,1,194,88,189,189,129,507
355030833000093,1,164,80,147,147,123,417
355030833000094,1,119,93,136,136,135,407
355030833000095,1,235,106,225,225,141,591
355030833000096,1,211,101,170,170,123,463
355030833000097,1,224,111,191,191,165,547
355030833000098,1,125,67,131,131,100,362
355030833000099,1,144,101,154,154,116,424
355030833000100,4,113,65,81,81,69,231
355030833000101,1,287,141,249,249,170,668
355030833000102,1,195,121,208,208,115,531
355030833000103,1,160,82,145,145,119,409
355030833000104,1,256,82,196,196,54,446
355030833000105,1,44,32,23,23,17,63
355030833000106,1,244,96,221,221,77,519
355030833000107,4,13,4,7,7,10,24
355030833000108,4,94,49,86,86,60,232
355030833000109,1,19,3,16,16,7,39
355030833000110,1,49,14,38,38,11,87
355030833000111,1,472,208,403,403,167,973
355030833000112,1,118,52,89,89,89,267
355030833000113,1,31,17,26,26,14,66
355030833000114,1,395,194,358,358,250,966
355030833000115,1,131,49,120,120,48,288
355030833000116,1,228,108,204,204,134,542
355030833000117,1,324,153,334,334,179,847
355030833000118,1,176,97,190,190,119,499
355030833000119,1,223,109,210,210,136,556
355030833000120,1,284,111,294,294,134,722
355030833000121,1,271,121,202,202,132,536
355030833000122,1,598,237,520,520,266,1306
355030833000123,1,155,74,150,150,95,395
355030833000124,8,27,15,14,14,14,42
355030833000125,1,261,115,239,239,186,664
355030833000126,1,162,71,164,164,127,455
355030833000127,1,115,61,118,118,123,359
355030833000128,1,213,112,215,215,144,574
355030833000129,8,17,8,10,10,8,28
355030833000130,1,97,45,78,78,59,215
355030833000131,1,69,23,62,62,42,166
355030833000132,1,101,60,124,124,65,313
355030833000133,1,142,40,140,140,37,317
355030833000134,1,145,54,123,123,67,313
355030833000135,1,165,53,148,148,55,351
355030833000136,1,122,43,112,112,57,281
355030833000137,1,237,102,214,214,89,517
355030833000138,1,300,87,251,251,72,574
355030833000139,1,299,111,264,264,95,623
355030833000140,1,186,53,165,165,53,383
355030833000141,1,129,32,135,135,42,312
355030833000142,1,103,21,127,127,37,291
355030833000143,1,130,57,165,165,49,379
355030833000144,1,161,49,183,183,45,411
355030833000145,1,163,53,174,174,65,413
355030833000146,1,134,57,127,127,86,340
355030833000147,1,222,93,158,158,115,431
355030833000148,1,269,119,268,268,159,695
355030833000149,1,426,176,410,410,132,952
355030833000150,1,254,95,237,237,125,599
355030833000151,1,254,113,206,206,109,521
355030833000152,1,229,129,231,231,137,599
355030833000153,1,186,91,182,182,126,490
355030833000154,1,175,88,161,161,78,400
355030833000156,1,98,49,104,104,77,285
355030833000157,2,12,9,9,9,8,26
355030833000158,1,42,23,42,42,30,114
355030833000159,4,65,31,35,35,25,95
355030833000164,1,3,4,2,2,3,7
355030833000165,8,88,35,86,86,34,206
355030833000166,1,5,3,7,7,0,14
355030833000169,8,44,14,31,31,14,76
355030833000172,1,151,100,147,147,122,416
355030833000173,8,191,58,109,109,60,278
355030833000175,8,2,2,2,2,1,5
355030833000176,8,157,51,103,103,60,266
355030833000177,8,349,141,263,263,147,673
355030833000182,1,65,33,65,65,57,187
355030833000183,1,54,12,42,42,25,109
355030833000184,1,143,80,135,135,88,358
355030833000185,1,215,95,189,189,128,506
355030833000187,4,65,34,54,54,33,141
355030833000189,1,97,33,69,69,53,191
355030833000191,8,36,20,30,30,16,76
355030833000192,1,170,48,130,130,56,316
355030833000196,8,59,20,49,49,20,118
355030833000200,4,61,40,39,39,46,124
355030833000201,8,21,8,20,20,16,56
355030833000203,1,214,67,178,178,67,423
355030833000204,1,389,140,362,362,123,847
355030833000205,1,396,141,386,386,127,899
355030833000206,1,277,80,235,235,63,533
355030833000207,1,282,108,244,244,67,555
355030833000208,1,203,80,171,171,64,406
355030833000209,1,138,45,127,127,60,314
355030833000210,1,37,20,51,51,36,138
355030833000213,1,70,29,91,91,31,213
355030833000214,1,51,17,37,37,24,98
355030833000215,1,48,26,44,44,29,117
355030833000216,1,7,1,7,7,2,16
355030833000217,1,57,21,42,42,14,98
355030833000218,1,67,30,50,50,23,123
355030834000001,1,51,18,100,100,108,308
355030834000002,1,99,72,205,205,197,607
355030834000003,1,18,18,49,49,57,155
355030834000004,1,38,28,90,90,79,259
355030834000005,1,47,33,97,97,112,306
355030834000006,1,47,34,87,87,111,285
355030834000007,1,23,12,56,56,85,197
355030834000008,1,56,35,93,93,122,308
355030834000009,1,81,58,157,157,189,503
355030834000010,1,41,32,153,153,139,445
355030834000011,1,97,35,216,216,112,544
355030834000012,1,69,24,107,107,90,304
355030834000013,1,30,10,83,83,88,254
355030834000014,1,96,59,178,178,195,551
355030834000015,1,79,42,124,124,125,373
355030834000016,1,88,58,168,168,148,484
355030834000017,1,48,34,127,127,129,383
355030834000018,1,81,36,122,122,100,344
355030834000019,1,120,62,211,211,175,597
355030834000021,1,78,51,156,156,163,475
355030834000022,1,58,51,118,118,175,411
355030834000023,1,112,65,156,156,187,499
355030834000024,1,58,42,124,124,117,365
355030834000025,1,6,1,12,12,6,30
355030834000026,1,86,53,104,104,173,381
355030834000027,1,40,43,91,91,140,322
355030834000028,1,44,41,126,126,119,371
355030834000029,1,69,24,114,114,90,318
355030834000030,1,78,50,154,154,128,436
355030834000031,1,42,31,106,106,118,330
355030834000032,1,101,64,193,193,211,597
355030834000033,1,103,73,228,228,208,664
355030834000034,1,38,29,80,80,97,257
355030834000035,1,76,61,122,122,177,421
355030834000036,1,118,63,186,186,191,563
355030834000037,1,101,60,155,155,124,434
355030834000038,1,96,54,175,175,150,500
355030834000039,1,0,0,0,0,0,0
355030834000040,1,105,71,212,212,188,612
355030834000041,1,89,47,152,152,171,475
355030834000042,1,85,53,183,183,187,553
355030834000043,1,82,52,144,144,176,464
355030834000044,1,92,60,131,131,144,406
355030834000045,1,52,16,40,40,42,122
355030834000046,1,158,83,219,219,188,626
355030834000047,1,61,43,121,121,111,353
355030834000048,1,113,54,222,222,161,605
355030834000049,1,86,60,136,136,125,397
355030834000050,1,85,56,131,131,134,396
355030834000051,1,65,20,82,82,81,245
355030834000052,1,100,56,143,143,129,415
355030834000053,1,12,4,44,44,21,109
355030834000054,1,53,47,101,101,112,314
355030834000055,1,74,57,124,124,182,430
355030834000056,1,84,40,150,150,186,486
355030834000057,1,50,20,84,84,119,287
355030834000058,1,161,68,308,308,158,774
355030834000059,1,112,72,191,191,194,576
355030834000060,1,56,28,92,92,97,281
355030834000061,1,60,50,118,118,144,380
355030834000062,1,100,63,154,154,155,463
355030834000063,1,58,45,104,104,114,322
355030834000064,1,85,60,131,131,134,396
355030834000065,1,115,68,181,181,144,506
355030834000066,1,117,74,211,211,169,591
355030834000067,1,71,45,123,123,141,387
355030834000068,1,76,50,160,160,147,467
355030834000069,1,58,51,102,102,161,365
355030834000070,1,119,59,287,287,195,769
355030834000071,1,102,61,199,199,215,613
355030834000072,1,39,28,101,101,87,289
355030834000073,1,125,79,189,189,152,530
355030834000074,1,86,51,208,208,114,530
355030834000075,1,122,69,256,256,137,649
355030834000076,1,35,16,19,19,28,66
355030834000077,1,106,75,174,174,150,498
355030834000078,1,75,58,112,112,91,315
355030834000079,1,61,44,88,88,89,265
355030834000080,1,92,32,133,133,93,359
355030834000081,1,78,31,190,190,108,488
355030834000082,1,80,40,95,95,96,286
355030834000083,1,60,41,139,139,164,442
355030834000084,1,86,39,135,135,132,402
355030834000085,1,41,27,89,89,85,263
355030834000086,1,49,44,184,184,105,473
355030834000087,1,64,71,154,154,157,465
355030834000088,1,45,41,83,83,74,240
355030834000089,1,85,46,168,168,122,458
355030834000090,1,111,78,217,217,203,637
355030834000091,1,67,30,150,150,110,410
355030834000092,1,84,55,185,185,216,586
355030834000093,1,80,33,124,124,158,406
355030834000094,1,68,44,127,127,119,373
355030834000095,1,178,67,234,234,150,618
355030834000096,1,49,19,173,173,27,373
355030834000097,1,77,49,119,119,95,333
355030834000098,1,56,37,110,110,78,298
355030834000099,1,71,49,138,138,128,404
355030834000100,1,91,55,98,98,128,324
355030834000101,1,78,44,118,118,91,327
355030834000102,1,41,22,60,60,61,181
355030834000103,1,62,37,121,121,96,338
355030834000104,1,44,19,215,215,81,511
355030834000105,1,55,34,67,67,103,237
355030834000106,1,141,79,251,251,216,718
355030834000107,1,71,43,129,129,134,392
355030834000108,1,91,57,174,174,181,529
355030834000109,1,36,26,57,57,46,160
355030834000110,1,137,83,231,231,144,606
355030834000111,1,107,52,129,129,115,373
355030834000112,1,125,66,147,147,113,407
355030834000113,1,125,59,131,131,71,333
355030834000114,1,251,139,335,335,220,890
355030834000115,1,353,211,337,337,122,796
355030834000116,1,215,88,167,167,88,422
355030834000117,1,247,127,242,242,83,567
355030834000118,1,184,99,168,168,63,399
355030834000119,1,123,69,136,136,49,321
355030834000121,1,364,146,376,376,100,852
355030834000122,1,286,167,349,349,170,868
355030834000123,1,155,89,171,171,48,390
355030834000124,1,488,214,503,503,146,1152
355030834000125,1,147,79,236,236,207,679
355030834000126,1,135,76,241,241,187,669
355030834000127,1,80,45,143,143,134,420
355030834000128,1,99,53,173,173,139,485
355030834000129,1,97,41,141,141,117,399
355030834000130,1,89,56,140,140,137,417
355030834000131,1,77,62,165,165,126,456
355030834000132,1,109,77,160,160,106,426
355030834000133,1,45,34,100,100,69,269
355030834000134,1,185,102,241,241,195,677
355030834000135,1,223,88,215,215,81,511
355030834000136,1,201,97,206,206,63,475
355030834000137,1,132,90,142,142,130,414
355030834000138,1,216,131,230,230,155,615
355030834000139,1,233,115,300,300,129,729
355030834000140,1,97,41,157,157,114,428
355030834000141,1,112,72,153,153,121,427
355030834000142,1,33,15,50,50,63,163
355030834000143,1,66,40,170,170,154,494
355030834000144,1,185,66,319,319,166,804
355030834000145,1,92,27,185,185,80,450
355030834000146,1,22,27,68,68,93,229
355030834000147,1,67,38,116,116,139,371
355030834000148,1,96,36,217,217,120,554
355030834000149,1,19,15,120,120,64,304
355030834000150,1,68,42,129,129,148,406
355030834000151,1,26,10,119,119,69,307
355030834000152,1,104,64,145,145,188,478
355030834000155,1,32,19,110,110,48,268
355030834000156,1,0,0,0,0,0,0
355030834000157,1,89,50,121,121,105,347
355030834000158,1,70,49,123,123,157,403
355030834000159,1,148,55,183,183,125,491
355030834000160,1,56,48,72,72,64,208
355030834000161,1,63,34,139,139,85,363
355030834000162,1,208,83,255,255,93,603
355030834000163,1,127,63,170,170,73,413
355030834000164,1,136,50,130,130,41,301
355030834000165,1,116,26,215,215,64,494
355030834000166,1,219,77,159,159,49,367
355030834000167,1,156,61,88,88,30,206
355030835000001,1,20,54,140,140,99,379
355030835000002,1,48,38,143,143,147,433
355030835000003,1,13,25,73,73,48,194
355030835000004,1,35,23,93,93,98,284
355030835000005,1,28,40,75,75,52,202
355030835000006,1,29,16,60,60,54,174
355030835000007,1,20,21,91,91,56,238
355030835000008,1,7,7,12,12,17,41
355030835000009,1,40,44,187,187,110,484
355030835000010,1,24,40,114,114,120,348
355030835000011,1,29,34,197,197,100,494
355030835000012,1,18,50,47,47,44,138
355030835000013,1,44,58,158,158,147,463
355030835000014,1,84,63,177,177,170,524
355030835000015,1,80,34,180,180,169,529
355030835000016,1,81,44,246,246,141,633
355030835000017,1,43,29,102,102,115,319
355030835000018,1,28,23,144,144,93,381
355030835000019,1,12,13,55,55,57,167
355030835000020,1,15,8,37,37,61,135
355030835000021,1,6,7,87,87,31,205
355030835000022,1,68,47,159,159,104,422
355030835000023,1,22,28,81,81,79,241
355030835000024,1,26,10,116,116,74,306
355030835000025,1,27,15,120,120,69,309
355030835000026,1,5,9,33,33,30,96
355030835000027,1,38,21,97,97,81,275
355030835000028,1,62,42,148,148,163,459
355030835000029,1,41,24,97,97,116,310
355030835000030,1,40,29,78,78,122,278
355030835000031,1,86,48,191,191,137,519
355030835000032,1,60,27,125,125,123,373
355030835000033,1,42,18,112,112,57,281
355030835000034,1,11,10,22,22,19,63
355030835000035,1,60,34,128,128,125,381
355030835000036,1,97,46,77,77,49,203
355030835000037,1,74,19,291,291,87,669
355030835000038,1,0,0,0,0,0,0
355030835000039,1,29,21,65,65,58,188
355030835000040,1,16,14,52,52,56,160
355030835000041,1,57,47,157,157,139,453
355030835000042,1,32,31,155,155,134,444
355030835000043,1,15,7,46,46,49,141
355030835000044,1,25,12,108,108,69,285
355030835000045,1,36,14,150,150,82,382
355030835000046,1,11,10,34,34,33,101
355030835000047,1,72,28,126,126,114,366
355030835000048,1,57,37,118,118,99,335
355030835000049,1,42,31,107,107,218,432
355030835000050,1,78,29,133,133,122,388
355030835000051,1,49,20,111,111,85,307
355030835000052,1,64,38,153,153,129,435
355030835000053,1,93,44,208,208,150,566
355030835000054,1,32,12,101,101,60,262
355030835000055,1,25,9,60,60,60,180
355030835000056,1,15,4,36,36,23,95
355030835000057,1,124,71,370,370,179,919
355030835000058,1,91,29,113,113,115,341
355030835000059,1,30,9,81,81,62,224
355030835000060,1,49,41,99,99,102,300
355030835000061,1,41,30,140,140,107,387
355030835000062,1,11,6,52,52,45,149
355030835000063,1,27,11,82,82,83,247
355030835000064,1,7,6,58,58,42,158
355030835000065,1,26,23,91,91,150,332
355030835000066,1,23,14,66,66,68,200
355030835000067,1,30,19,114,114,78,306
355030835000068,1,80,50,155,155,152,462
355030835000069,1,52,31,110,110,121,341
355030835000070,1,44,36,171,171,144,486
355030835000071,1,59,37,147,147,127,421
355030835000072,1,89,45,147,147,134,428
355030835000073,1,65,34,133,133,70,336
355030835000074,1,102,31,212,212,84,508
355030835000075,1,51,31,140,140,88,368
355030835000076,1,72,36,138,138,129,405
355030835000077,1,36,29,106,106,87,299
355030835000078,1,31,15,117,117,83,317
355030835000079,1,24,27,92,92,101,285
355030835000080,1,31,11,97,97,75,269
355030835000081,1,15,12,88,88,71,247
355030835000082,1,36,22,101,101,77,279
355030835000083,1,20,9,93,93,52,238
355030835000084,1,12,11,55,55,44,154
355030835000085,1,36,33,143,143,96,382
355030835000086,1,37,33,134,134,106,374
355030835000087,1,28,25,146,146,66,358
355030835000088,1,29,26,91,91,73,255
355030835000089,1,54,13,116,116,70,302
355030835000090,1,41,28,82,82,92,256
355030835000091,1,34,23,83,83,100,266
355030835000092,1,78,24,167,167,144,478
355030835000093,1,25,13,96,96,57,249
355030835000094,1,85,38,168,168,181,517
355030835000095,1,40,13,104,104,47,255
355030835000096,1,79,59,162,162,147,471
355030835000097,1,44,24,111,111,118,340
355030835000098,1,58,38,140,140,140,420
355030835000099,1,45,25,73,73,78,224
355030835000100,1,45,27,84,84,69,237
355030835000101,1,61,50,184,184,134,502
355030835000102,1,32,16,57,57,58,172
355030835000103,1,16,11,59,59,35,153
355030835000104,1,23,16,48,48,57,153
355030835000105,1,28,18,52,52,56,160
355030835000106,1,30,25,140,140,100,380
355030835000107,1,13,11,80,80,49,209
355030835000108,1,22,19,62,62,71,195
355030835000109,1,12,9,87,87,51,225
355030835000110,1,23,14,107,107,85,299
355030835000111,1,11,9,57,57,59,173
355030835000112,1,238,83,425,425,258,1108
355030835000113,1,25,14,131,131,56,318
355030835000114,1,36,22,168,168,98,434
355030835000115,1,76,54,207,207,182,596
355030835000116,1,66,35,147,147,133,427
355030835000117,1,52,28,102,102,113,317
355030835000118,1,149,104,237,237,197,671
355030835000119,1,71,45,127,127,106,360
355030835000120,1,38,24,162,162,114,438
355030835000121,1,29,19,111,111,68,290
355030835000122,1,41,16,78,78,59,215
355030835000123,1,54,34,148,148,135,431
355030835000124,1,42,16,69,69,83,221
355030835000125,1,48,26,96,96,112,304
355030835000126,1,17,20,93,93,168,354
355030835000127,1,116,69,220,220,204,644
355030835000128,1,72,39,160,160,183,503
355030835000129,1,127,39,255,255,127,637
355030835000130,1,18,22,85,85,94,264
355030835000131,1,35,13,96,96,79,271
355030835000132,1,26,12,92,92,54,238
355030835000133,1,39,32,74,74,65,213
355030835000134,1,74,43,140,140,123,403
355030835000135,1,56,14,98,98,83,279
355030835000136,1,69,33,105,105,84,294
355030835000137,1,21,9,62,62,49,173
355030835000138,1,47,28,98,98,99,295
355030835000139,1,24,75,123,123,100,346
355030835000140,1,45,34,89,89,110,288
355030835000141,1,26,17,80,80,88,248
355030835000142,1,45,24,92,92,105,289
355030835000143,1,69,34,157,157,141,455
355030835000144,1,44,24,149,149,107,405
355030835000145,1,78,34,190,190,136,516
355030835000146,1,35,23,99,99,88,286
355030835000147,1,60,43,127,127,135,389
355030835000148,1,46,24,121,121,80,322
355030835000149,1,49,24,183,183,122,488
355030835000150,1,44,21,103,103,90,296
355030835000151,1,74,59,120,120,156,396
355030835000152,1,39,59,116,116,146,378
355030835000153,1,65,42,137,137,134,408
355030835000154,1,55,29,102,102,83,287
355030835000155,1,35,39,101,101,103,305
355030835000156,1,84,49,159,159,140,458
355030835000157,1,25,20,87,87,72,246
355030835000158,1,0,0,0,0,0,0
355030835000160,1,27,27,139,139,66,344
355030835000161,1,40,36,83,83,83,249
355030835000162,1,38,24,181,181,52,414
355030835000163,1,12,12,69,69,56,194
355030835000164,1,15,15,66,66,55,187
355030835000165,1,22,24,142,142,83,367
355030835000166,1,51,33,184,184,97,465
355030835000167,1,17,26,184,184,38,406
355030835000168,1,21,39,72,72,79,223
355030835000169,1,27,21,100,100,52,252
355030835000170,1,36,24,79,79,56,214
355030835000171,1,16,20,78,78,53,209
355030835000172,1,56,53,182,182,119,483
355030835000173,1,15,22,133,133,36,302
355030835000174,1,6,5,54,54,27,135
355030835000175,1,35,33,71,71,79,221
355030835000176,1,24,16,92,92,72,256
355030835000177,1,34,16,46,46,59,151
355030835000178,1,45,33,111,111,122,344
355030835000179,1,47,34,134,134,95,363
355030835000180,1,6,7,80,80,10,170
355030835000181,1,70,29,267,267,81,615
355030835000182,1,29,14,121,121,78,320
355030835000183,1,39,31,140,140,111,391
355030835000184,1,17,23,78,78,85,241
355030835000185,1,32,26,115,115,89,319
355030835000186,1,37,21,85,85,67,237
355030835000187,1,31,20,192,192,92,476
355030835000188,1,44,36,125,125,107,357
355030835000189,1,42,29,107,107,106,320
355030835000190,1,45,17,109,109,38,256
355030835000191,1,23,8,49,49,38,136
355030835000192,1,20,15,119,119,65,303
355030835000193,1,16,8,85,85,59,229
355030835000194,1,0,0,0,0,0,0
355030835000195,1,0,0,1,1,1,3
355030835000196,1,92,17,206,206,90,502
355030835000197,1,80,48,160,160,168,488
355030835000198,1,18,16,62,62,39,163
355030835000199,1,55,19,93,93,82,268
355030835000200,1,15,23,87,87,11,185
355030835000201,1,10,10,59,59,33,151
355030835000202,1,33,13,110,110,46,266
355030835000203,1,25,11,84,84,58,226
355030835000204,1,82,19,196,196,102,494
355030835000205,1,13,16,125,125,50,300
355030835000206,1,55,21,118,118,90,326
355030835000207,1,2,0,15,15,7,37
355030835000208,1,28,15,58,58,64,180
355030836000001,1,106,43,124,124,78,326
355030836000002,1,123,50,164,164,93,421
355030836000003,1,140,68,146,146,99,391
355030836000004,1,138,88,172,172,109,453
355030836000005,1,167,94,179,179,108,466
355030836000006,1,165,66,156,156,110,422
355030836000007,1,149,81,170,170,125,465
355030836000008,1,135,71,160,160,101,421
355030836000009,1,234,98,213,213,116,542
355030836000010,1,204,114,184,184,155,523
355030836000011,1,159,75,144,144,97,385
355030836000012,1,89,48,98,98,58,254
355030836000013,1,162,70,165,165,113,443
355030836000014,1,215,88,188,188,105,481
355030836000015,1,118,78,129,129,92,350
355030836000016,1,332,147,269,269,175,713
355030836000017,1,47,19,46,46,32,124
355030836000018,1,158,83,163,163,143,469
355030836000019,1,163,74,119,119,100,338
355030836000020,1,164,78,214,214,144,572
355030836000021,1,217,122,231,231,173,635
355030836000022,1,121,49,144,144,103,391
355030836000023,1,116,75,124,124,137,385
355030836000024,1,111,53,125,125,71,321
355030836000025,1,89,40,97,97,58,252
355030836000026,1,210,103,212,212,154,578
355030836000027,1,150,78,135,135,100,370
355030836000028,1,207,115,193,193,160,546
355030836000029,1,112,92,149,149,97,395
355030836000030,1,111,41,90,90,54,234
355030836000031,1,283,79,283,283,73,639
355030836000032,1,169,71,169,169,154,492
355030836000033,1,130,37,98,98,75,271
355030836000034,1,125,76,125,125,98,348
355030836000035,1,118,75,140,140,133,413
355030836000036,1,100,58,103,103,81,287
355030836000037,1,96,31,122,122,40,284
355030836000038,1,223,80,187,187,113,487
355030836000039,1,157,78,146,146,96,388
355030836000040,1,90,47,103,103,81,287
355030836000041,1,138,68,152,152,92,396
355030836000042,1,166,71,152,152,81,385
355030836000043,1,185,107,177,177,145,499
355030836000044,1,136,71,116,116,72,304
355030836000045,1,131,57,119,119,129,367
355030836000046,1,232,118,192,192,157,541
355030836000047,1,193,85,169,169,111,449
355030836000048,1,148,87,170,170,91,431
355030836000049,1,204,118,203,203,118,524
355030836000050,1,118,51,125,125,68,318
355030836000051,1,126,87,139,139,119,397
355030836000052,1,193,103,174,174,145,493
355030836000053,1,91,54,79,79,75,233
355030836000054,1,215,94,188,188,131,507
355030836000055,1,195,114,204,204,162,570
355030836000056,1,81,38,83,83,51,217
355030836000057,1,132,67,138,138,144,420
355030836000058,1,189,83,176,176,117,469
355030836000059,1,229,118,188,188,150,526
355030836000060,1,59,37,71,71,61,203
355030836000061,1,133,64,121,121,64,306
355030836000062,1,52,24,65,65,54,184
355030836000063,1,75,47,120,120,89,329
355030836000064,1,108,58,93,93,89,275
355030836000065,1,117,62,142,142,125,409
355030836000066,1,107,60,137,137,131,405
355030836000067,1,85,36,102,102,76,280
355030836000068,1,69,34,64,64,55,183
355030836000069,1,377,147,257,257,104,618
355030836000070,1,57,33,73,73,41,187
355030836000071,1,159,87,193,193,112,498
355030836000072,1,76,38,100,100,57,257
355030836000073,1,73,46,97,97,81,275
355030836000074,1,230,95,224,224,141,589
355030836000075,1,178,94,143,143,88,374
355030836000076,1,150,75,134,134,44,312
355030836000077,1,282,118,207,207,104,518
355030836000078,1,118,59,128,128,74,330
355030836000079,1,181,81,173,173,115,461
355030836000080,1,197,87,171,171,113,455
355030836000081,1,188,99,211,211,105,527
355030836000082,1,153,85,140,140,103,383
355030836000083,1,135,49,126,126,88,340
355030836000084,1,90,46,78,78,47,203
355030836000085,1,107,55,99,99,60,258
355030836000086,1,71,31,68,68,46,182
355030836000087,1,81,40,67,67,55,189
355030836000088,1,69,30,74,74,37,185
355030836000089,1,117,58,105,105,78,288
355030836000090,1,294,127,293,293,182,768
355030836000091,1,117,66,121,121,134,376
355030836000092,1,214,71,174,174,70,418
355030836000093,1,251,117,205,205,103,513
355030836000094,1,229,90,193,193,105,491
355030836000095,1,256,119,331,331,206,868
355030836000096,1,199,132,228,228,136,592
355030836000097,1,115,74,137,137,103,377
355030836000098,1,76,60,115,115,83,313
355030836000099,1,105,50,133,133,103,369
355030836000100,1,168,86,222,222,133,577
355030836000101,1,99,53,129,129,114,372
355030836000102,1,118,35,150,150,89,389
355030836000103,1,53,32,68,68,82,218
355030836000104,1,100,47,157,157,107,421
355030836000105,1,87,40,97,97,75,269
355030836000106,1,179,62,175,175,131,481
355030836000107,1,101,56,110,110,90,310
355030836000108,1,165,73,179,179,118,476
355030836000109,1,73,36,86,86,40,212
355030836000110,1,158,59,132,132,119,383
355030836000111,1,158,88,162,162,117,441
355030836000112,1,137,56,136,136,69,341
355030836000113,1,91,46,103,103,63,269
355030836000114,1,179,81,186,186,103,475
355030836000115,1,92,32,108,108,78,294
355030836000116,1,108,69,131,131,91,353
355030836000117,1,184,102,201,201,124,526
355030836000118,1,75,47,70,70,31,171
355030836000119,1,172,81,116,116,46,278
355030836000120,1,259,135,251,251,174,676
355030836000121,1,218,108,178,178,100,456
355030836000122,1,190,82,171,171,102,444
355030836000123,1,183,78,163,163,92,418
355030836000124,1,178,83,159,159,99,417
355030836000125,1,263,122,210,210,183,603
355030836000126,1,230,128,207,207,181,595
355030836000127,1,215,100,212,212,132,556
355030836000128,1,161,70,158,158,72,388
355030836000129,1,189,67,199,199,80,478
355030836000130,1,99,49,91,91,41,223
355030836000131,1,54,34,65,65,56,186
355030836000132,1,240,119,231,231,110,572
355030836000133,1,203,114,180,180,106,466
355030836000134,1,202,118,184,184,105,473
355030836000135,1,181,79,178,178,128,484
355030836000136,1,127,61,151,151,91,393
355030836000137,1,151,58,141,141,97,379
355030836000138,1,182,62,156,156,86,398
355030836000139,1,118,55,113,113,67,293
355030836000140,1,120,47,63,63,29,155
355030836000141,1,198,90,213,213,135,561
355030836000142,1,140,71,157,157,119,433
355030836000143,1,167,81,195,195,100,490
355030836000144,1,183,77,170,170,121,461
355030836000145,1,86,41,90,90,61,241
355030836000146,1,163,74,178,178,97,453
355030836000147,1,104,45,110,110,51,271
355030836000148,1,220,115,250,250,213,713
355030836000149,1,107,55,116,116,148,380
355030836000150,1,92,40,125,125,80,330
355030836000151,1,83,32,110,110,70,290
355030836000152,1,84,54,129,129,102,360
355030836000153,1,90,35,107,107,120,334
355030836000154,1,81,41,115,115,112,342
355030836000155,1,46,38,72,72,75,219
355030836000156,1,115,60,159,159,110,428
355030836000157,1,63,19,67,67,75,209
355030836000158,1,101,55,115,115,62,292
355030836000159,1,167,56,156,156,87,399
355030836000160,1,132,88,154,154,162,470
355030836000161,1,131,49,104,104,81,289
355030836000162,1,114,42,102,102,67,271
355030836000163,1,181,85,212,212,123,547
355030836000164,1,156,67,184,184,149,517
355030836000165,1,124,56,154,154,98,406
355030836000166,1,84,41,80,80,62,222
355030836000167,1,116,43,113,113,78,304
355030836000168,1,150,77,156,156,94,406
355030836000169,1,151,69,154,154,117,425
355030836000170,1,9,4,21,21,11,53
355030836000171,1,186,82,151,151,151,453
355030836000172,1,220,110,174,174,162,510
355030836000173,1,92,56,93,93,71,257
355030836000174,1,205,82,168,168,90,426
355030836000175,1,230,87,186,186,112,484
355030836000176,1,160,74,164,164,120,448
355030836000177,1,355,178,277,277,227,781
355030836000178,1,187,94,175,175,153,503
355030836000179,1,119,64,108,108,101,317
355030836000180,1,196,80,169,169,83,421
355030836000181,1,146,79,189,189,94,472
355030836000182,1,161,71,184,184,90,458
355030836000183,1,270,111,248,248,134,630
355030836000184,1,124,70,117,117,67,301
355030836000185,1,139,84,161,161,103,425
355030836000186,1,148,73,146,146,81,373
355030836000187,1,109,45,113,113,73,299
355030836000188,1,290,156,291,291,192,774
355030836000189,1,232,109,281,281,150,712
355030836000190,1,185,85,165,165,125,455
355030836000191,1,110,59,99,99,54,252
355030836000192,1,196,87,223,223,159,605
355030836000193,1,69,46,109,109,70,288
355030836000194,1,94,45,137,137,93,367
355030836000195,1,136,65,156,156,154,466
355030836000196,1,91,54,114,114,115,343
355030836000197,1,68,28,88,88,71,247
355030836000198,1,142,67,143,143,101,387
355030836000199,1,198,89,223,223,150,596
355030836000200,1,161,95,153,153,107,413
355030836000201,1,356,179,330,330,162,822
355030836000202,1,167,85,134,134,95,363
355030836000203,1,102,64,124,124,86,334
355030836000204,1,182,91,220,220,141,581
355030836000205,1,188,112,211,211,138,560
355030836000206,1,157,94,201,201,104,506
355030836000207,1,107,42,135,135,54,324
355030836000208,1,132,69,127,127,113,367
355030836000209,1,97,44,114,114,82,310
355030836000210,1,176,90,170,170,86,426
355030836000211,1,174,76,161,161,141,463
355030836000212,1,160,85,166,166,112,444
355030836000213,1,122,55,123,123,74,320
355030836000214,1,177,66,139,139,106,384
355030836000215,1,207,117,217,217,134,568
355030836000216,1,232,106,195,195,153,543
355030836000217,1,163,74,146,146,88,380
355030836000218,1,202,81,221,221,146,588
355030836000219,1,90,51,91,91,36,218
355030836000220,1,161,71,113,113,70,296
355030836000221,1,215,75,202,202,120,524
355030836000222,1,211,112,205,205,149,559
355030836000223,1,155,75,160,160,112,432
355030836000224,1,189,95,171,171,159,501
355030836000225,1,342,157,246,246,134,626
355030836000226,1,109,59,131,131,73,335
355030836000227,1,155,70,174,174,123,471
355030836000228,1,185,78,211,211,148,570
355030836000229,1,72,33,80,80,78,238
355030836000230,1,66,50,77,77,96,250
355030836000231,1,129,79,162,162,112,436
355030836000232,1,67,46,70,70,67,207
355030836000233,1,140,50,105,105,73,283
355030836000234,1,173,116,176,176,112,464
355030836000235,1,99,47,138,138,135,411
355030836000236,1,177,89,187,187,129,503
355030836000237,1,121,66,143,143,98,384
355030836000238,1,114,56,124,124,84,332
355030836000239,1,211,86,180,180,123,483
355030836000240,1,111,61,110,110,54,274
355030836000241,1,139,75,125,125,93,343
355030836000242,1,131,85,154,154,84,392
355030836000243,1,220,111,219,219,158,596
355030836000244,1,242,120,233,233,160,626
355030836000245,1,122,60,109,109,107,325
355030836000246,1,140,49,143,143,70,356
355030836000247,1,163,85,154,154,149,457
355030836000248,1,165,91,212,212,153,577
355030836000249,1,134,54,132,132,48,312
355030836000250,1,251,92,225,225,109,559
355030836000251,1,123,50,112,112,66,290
355030836000252,1,159,65,149,149,87,385
355030836000253,1,144,69,155,155,90,400
355030836000254,1,132,75,155,155,96,406
355030836000255,1,46,35,63,63,42,168
355030836000256,1,57,31,55,55,59,169
355030836000257,1,116,49,174,174,119,467
355030836000258,1,199,106,211,211,146,568
355030836000259,1,162,111,174,174,203,551
355030836000260,1,112,49,117,117,74,308
355030836000261,1,159,77,156,156,93,405
355030836000262,1,145,48,127,127,68,322
355030836000263,1,36,12,24,24,25,73
355030836000264,1,119,64,86,86,72,244
355030836000265,1,109,65,92,92,96,280
355030836000266,1,155,73,167,167,102,436
355030836000267,1,95,51,80,80,78,238
355030836000268,1,88,98,158,158,83,399
355030836000269,1,141,69,107,107,125,339
355030836000270,1,67,47,45,45,54,144
355030836000271,1,176,81,119,119,104,342
355030836000272,1,127,67,112,112,89,313
355030836000273,1,134,71,154,154,102,410
355030836000274,1,253,71,119,119,55,293
355030836000275,1,225,95,165,165,76,406
355030836000276,1,74,34,59,59,28,146
355030836000277,1,48,26,53,53,23,129
355030836000278,1,125,60,125,125,58,308
355030836000279,1,315,111,305,305,91,701
355030836000280,1,98,68,136,136,118,390
355030836000281,1,38,14,35,35,9,79
355030836000282,1,121,72,125,125,82,332
355030836000283,1,230,111,158,158,118,434
355030836000284,1,140,69,136,136,50,322
355030836000285,1,188,78,183,183,116,482
355030836000286,1,106,52,103,103,72,278
355030836000287,1,84,33,96,96,41,233
355030836000288,1,176,85,174,174,144,492
355030836000289,1,105,54,107,107,68,282
355030836000290,1,83,60,88,88,71,247
355030836000291,1,93,55,100,100,85,285
355030836000292,1,112,44,118,118,77,313
355030836000293,1,124,49,115,115,88,318
355030836000294,1,103,56,108,108,87,303
355030836000295,1,152,71,152,152,108,412
355030836000296,1,86,38,71,71,71,213
355030836000297,1,240,114,205,205,109,519
355030836000298,1,184,71,166,166,85,417
355030836000299,1,50,22,65,65,26,156
355030836000300,1,64,26,113,113,23,249
355030836000301,1,96,39,155,155,67,377
355030836000302,1,120,67,150,150,103,403
355030836000303,1,157,63,202,202,64,468
355030836000304,1,163,64,227,227,91,545
355030836000305,1,89,58,109,109,80,298
355030836000306,1,169,108,171,171,92,434
355030836000307,1,181,83,157,157,89,403
355030836000308,1,130,60,123,123,67,313
355030836000309,1,58,29,55,55,46,156
355030836000310,1,90,38,87,87,59,233
355030836000311,1,248,121,228,228,97,553
355030836000312,1,86,53,92,92,74,258
355030836000313,1,87,39,81,81,67,229
355030836000314,1,255,78,136,136,40,312
355030836000315,1,146,45,150,150,36,336
355030836000316,1,121,44,97,97,47,241
355030836000317,1,131,80,141,141,94,376
355030836000318,1,85,34,99,99,55,253
355030836000319,1,261,104,297,297,149,743
355030836000320,1,230,80,218,218,98,534
355030836000321,1,134,55,162,162,86,410
355030836000322,1,223,87,271,271,97,639
355030836000323,1,195,81,211,211,77,499
355030836000324,1,194,87,174,174,108,456
355030836000325,1,249,76,227,227,125,579
355030836000326,1,107,57,112,112,80,304
355030836000327,1,116,75,110,110,73,293
355030836000328,1,169,79,131,131,85,347
355030836000329,1,141,50,144,144,88,376
355030836000330,1,253,125,193,193,69,455
355030836000332,1,197,73,179,179,92,450
355030836000333,1,128,58,132,132,82,346
355030836000334,1,160,51,145,145,65,355
355030836000335,1,314,137,235,235,124,594
355030836000336,1,233,133,201,201,136,538
355030836000337,1,55,13,56,56,22,134
355030836000338,1,159,71,137,137,108,382
355030836000339,1,320,99,199,199,70,468
355030836000341,1,24,7,15,15,19,49
355030836000342,1,13,8,8,8,4,20
355030836000343,1,144,65,175,175,80,430
355030836000344,1,98,29,67,67,27,161
355030836000345,1,69,40,65,65,29,159
355030836000346,1,132,60,97,97,64,258
355030836000347,1,42,13,35,35,17,87
355030836000348,1,14,4,7,7,7,21
355030836000349,1,5,0,2,2,4,8
355030836000350,1,53,31,37,37,20,94
355030836000351,1,29,14,36,36,18,90
355030836000352,1,13,22,16,16,13,45
355030836000353,1,96,48,74,74,45,193
355030836000354,1,36,24,21,21,30,72
355030836000355,1,100,55,82,82,69,233
355030837000001,1,151,75,230,230,132,592
355030837000002,1,111,55,186,186,118,490
355030837000003,1,134,57,172,172,132,476
355030837000004,1,96,41,97,97,90,284
355030837000005,1,119,53,144,144,116,404
355030837000006,1,75,63,123,123,127,373
355030837000007,1,67,38,92,92,80,264
355030837000008,1,99,41,86,86,76,248
355030837000009,1,101,40,204,204,72,480
355030837000010,1,107,35,203,203,76,482
355030837000011,1,138,59,184,184,150,518
355030837000012,1,172,82,186,186,138,510
355030837000013,1,154,97,191,191,156,538
355030837000014,1,139,96,182,182,178,542
355030837000015,1,76,53,121,121,84,326
355030837000016,1,166,82,125,125,242,492
355030837000017,1,166,86,183,183,174,540
355030837000018,1,80,39,127,127,73,327
355030837000019,1,79,40,80,80,77,237
355030837000020,1,162,107,243,243,193,679
355030837000021,1,97,49,133,133,117,383
355030837000022,1,92,79,156,156,107,419
355030837000023,1,130,46,140,140,116,396
355030837000024,1,98,54,111,111,90,312
355030837000025,1,223,121,276,276,248,800
355030837000026,1,184,95,224,224,193,641
355030837000027,1,163,98,259,259,218,736
355030837000028,1,105,51,157,157,81,395
355030837000029,1,127,64,107,107,70,284
355030837000030,1,330,123,273,273,227,773
355030837000031,1,304,116,284,284,149,717
355030837000032,1,1,0,1,1,1,3
355030837000033,1,126,58,143,143,108,394
355030837000034,1,3,0,3,3,6,12
355030837000035,1,207,95,173,173,167,513
355030837000036,1,68,29,86,86,74,246
355030837000037,1,174,83,207,207,166,580
355030837000038,1,107,50,122,122,81,325
355030837000039,1,102,61,131,131,131,393
355030837000040,1,256,70,404,404,160,968
355030837000041,1,201,91,301,301,163,765
355030837000042,1,75,39,109,109,80,298
355030837000043,1,103,38,106,106,81,293
355030837000044,1,130,57,157,157,121,435
355030837000045,1,49,35,53,53,97,203
355030837000046,1,145,48,146,146,93,385
355030837000047,1,76,36,100,100,86,286
355030837000048,1,275,117,414,414,208,1036
355030837000049,1,143,64,153,153,112,418
355030837000050,1,418,154,439,439,208,1086
355030837000051,1,104,61,133,133,106,372
355030837000052,1,62,44,96,96,68,260
355030837000053,1,164,61,159,159,105,423
355030837000054,1,211,133,201,201,260,662
355030837000055,1,235,108,239,239,166,644
355030837000056,1,342,140,330,330,136,796
355030837000057,1,329,136,307,307,163,777
355030837000058,1,240,116,246,246,112,604
355030837000059,1,316,141,307,307,177,791
355030837000060,1,250,128,276,276,128,680
355030837000061,1,407,176,388,388,156,932
355030837000062,1,254,110,230,230,100,560
355030837000063,1,312,92,256,256,97,609
355030837000064,1,293,129,254,254,95,603
355030837000065,1,97,34,102,102,23,227
355030837000066,1,178,72,186,186,107,479
355030837000067,1,194,102,213,213,155,581
355030837000068,1,206,118,229,229,177,635
355030837000069,1,58,29,59,59,21,139
355030837000070,1,121,73,126,126,106,358
355030837000071,1,251,88,260,260,169,689
355030837000072,1,210,93,266,266,167,699
355030837000073,1,93,64,134,134,74,342
355030837000074,1,100,57,111,111,114,336
355030837000075,1,111,51,159,159,125,443
355030837000076,1,150,69,128,128,115,371
355030837000077,1,123,60,136,136,113,385
355030837000078,1,125,64,152,152,102,406
355030837000079,1,119,44,150,150,94,394
355030837000080,1,123,87,220,220,178,618
355030837000081,1,207,86,195,195,138,528
355030837000082,1,84,55,106,106,67,279
355030837000083,1,107,67,174,174,130,478
355030837000084,1,189,74,196,196,129,521
355030837000085,1,123,63,135,135,96,366
355030837000086,1,225,93,259,259,285,803
355030837000087,1,98,65,141,141,112,394
355030837000088,1,152,60,181,181,140,502
355030837000089,1,167,68,218,218,152,588
355030837000090,1,180,68,169,169,153,491
355030837000091,1,233,130,288,288,122,698
355030837000092,1,104,61,141,141,115,397
355030837000093,1,146,54,179,179,157,515
355030837000094,1,90,48,100,100,94,294
355030837000095,1,161,89,233,233,163,629
355030837000096,1,149,96,195,195,191,581
355030837000097,1,51,24,54,54,55,163
355030837000098,1,144,70,172,172,165,509
355030837000099,1,103,67,119,119,155,393
355030837000100,1,223,90,239,239,101,579
355030837000101,1,237,105,361,361,133,855
355030837000102,1,241,104,245,245,114,604
355030837000103,1,190,114,225,225,96,546
355030837000104,1,129,38,123,123,34,280
355030837000105,1,168,78,214,214,163,591
355030837000106,1,180,97,252,252,174,678
355030837000107,1,172,64,181,181,121,483
355030837000108,1,220,81,172,172,71,415
355030837000109,1,233,90,255,255,183,693
355030837000110,1,156,65,173,173,128,474
355030837000111,1,193,97,274,274,175,723
355030837000112,1,198,89,186,186,168,540
355030837000113,1,0,0,0,0,0,0
355030837000114,1,359,120,508,508,173,1189
355030837000115,1,227,113,333,333,162,828
355030837000116,1,253,99,253,253,140,646
355030837000117,1,123,56,168,168,139,475
355030837000118,1,186,97,242,242,178,662
355030837000119,1,87,40,128,128,77,333
355030837000120,1,188,85,239,239,175,653
355030837000121,1,150,70,164,164,108,436
355030837000122,1,134,70,166,166,98,430
355030837000123,1,116,54,148,148,109,405
355030837000124,1,72,36,106,106,73,285
355030837000125,1,89,49,108,108,121,337
355030837000126,1,134,50,186,186,97,469
355030837000127,1,269,107,418,418,195,1031
355030837000128,1,155,94,195,195,181,571
355030837000129,1,231,120,239,239,171,649
355030837000130,1,171,81,202,202,167,571
355030837000131,1,227,113,263,263,173,699
355030837000132,1,289,77,145,145,58,348
355030837000133,1,143,26,61,61,31,153
355030837000134,1,126,66,194,194,137,525
355030837000135,1,64,52,115,115,95,325
355030837000136,1,139,57,161,161,127,449
355030837000137,1,101,53,141,141,106,388
355030837000138,1,91,51,101,101,82,284
355030837000139,1,117,81,161,161,155,477
355030837000140,1,146,75,136,136,134,406
355030837000141,1,167,73,202,202,134,538
355030837000142,1,94,63,100,100,103,303
355030837000143,1,126,54,132,132,116,380
355030837000144,1,70,54,98,98,76,272
355030837000145,1,108,38,97,97,84,278
355030837000146,1,162,74,175,175,49,399
355030837000147,1,220,103,196,196,101,493
355030837000148,1,200,99,182,182,128,492
355030837000149,1,101,54,103,103,64,270
355030837000150,1,245,100,210,210,96,516
355030837000151,1,172,77,156,156,93,405
355030837000152,1,127,79,106,106,44,256
355030837000153,1,156,56,135,135,92,362
355030837000154,1,169,102,189,189,143,521
355030837000155,1,141,80,167,167,104,438
355030837000156,1,169,80,187,187,116,490
355030837000157,1,168,99,192,192,180,564
355030837000158,1,126,58,156,156,99,411
355030837000159,1,146,77,210,210,142,562
355030837000160,1,119,62,132,132,95,359
355030837000161,1,269,130,377,377,194,948
355030837000162,1,195,104,233,233,169,635
355030837000163,1,181,84,185,185,131,501
355030837000164,1,197,79,203,203,112,518
355030837000165,1,118,59,130,130,88,348
355030837000166,1,154,86,172,172,145,489
355030837000167,1,113,51,121,121,81,323
355030837000168,1,206,103,292,292,142,726
355030837000169,1,104,37,140,140,64,344
355030837000170,1,157,66,187,187,138,512
355030837000171,1,36,22,84,84,74,242
355030837000172,1,80,36,109,109,94,312
355030837000173,1,196,85,228,228,179,635
355030837000174,1,69,40,127,127,103,357
355030837000175,1,181,87,180,180,120,480
355030837000176,1,232,106,290,290,134,714
355030837000177,1,164,107,226,226,152,604
355030837000178,1,185,98,235,235,167,637
355030837000179,1,134,85,148,148,170,466
355030837000180,1,122,50,132,132,84,348
355030837000181,1,105,34,123,123,62,308
355030837000182,1,167,87,190,190,140,520
355030837000183,1,177,80,242,242,184,668
355030837000184,1,134,57,183,183,104,470
355030837000185,1,118,64,88,88,35,211
355030837000186,1,25,19,16,16,9,41
355030837000187,1,156,54,98,98,34,230
355030837000188,1,124,67,134,134,113,381
355030837000189,1,208,105,169,169,100,438
355030837000190,1,140,35,82,82,25,189
355030837000191,1,291,121,180,180,89,449
355030837000192,1,108,36,131,131,75,337
355030837000193,1,204,101,217,217,182,616
355030837000194,1,116,63,132,132,130,394
355030837000195,1,95,74,143,143,103,389
355030837000196,1,167,88,184,184,139,507
355030837000197,1,295,110,287,287,120,694
355030837000198,1,189,133,203,203,107,513
355030837000199,1,209,82,240,240,81,561
355030837000200,1,159,64,141,141,58,340
355030837000201,1,231,98,261,261,115,637
355030837000202,1,160,79,193,193,113,499
355030837000203,1,160,78,170,170,110,450
355030837000204,1,188,94,176,176,125,477
355030837000205,1,184,87,201,201,112,514
355030837000206,1,148,63,172,172,104,448
355030837000207,1,135,60,146,146,100,392
355030837000208,1,99,40,140,140,73,353
355030837000209,1,135,59,147,147,110,404
355030837000210,1,152,72,150,150,123,423
355030837000211,1,208,112,234,234,161,629
355030837000212,1,116,57,132,132,103,367
355030837000213,1,173,50,190,190,88,468
355030837000214,1,150,49,165,165,99,429
355030837000215,1,180,78,252,252,156,660
355030837000216,1,61,26,52,52,54,158
355030837000217,1,179,90,258,258,189,705
355030837000218,1,116,58,159,159,125,443
355030837000219,1,132,66,116,116,83,315
355030837000220,1,155,50,193,193,98,484
355030837000221,1,106,36,132,132,108,372
355030837000222,1,120,62,149,149,117,415
355030837000223,1,151,56,201,201,170,572
355030837000224,1,127,59,143,143,112,398
355030837000225,1,101,44,91,91,110,292
355030837000226,1,147,56,197,197,109,503
355030837000227,1,126,61,134,134,130,398
355030837000228,1,98,36,96,96,80,272
355030837000229,1,75,55,88,88,82,258
355030837000230,1,119,76,158,158,112,428
355030837000231,1,206,101,212,212,246,670
355030837000232,1,374,156,342,342,176,860
355030837000233,1,253,126,250,250,124,624
355030837000234,1,145,68,134,134,108,376
355030837000235,1,107,60,131,131,70,332
355030837000236,1,234,82,227,227,115,569
355030837000237,1,34,40,68,68,44,180
355030837000238,1,289,122,269,269,162,700
355030837000239,1,135,86,146,146,130,422
355030837000240,1,0,0,0,0,0,0
355030837000241,1,83,48,103,103,83,289
355030837000242,1,103,38,140,140,83,363
355030837000243,1,135,68,140,140,125,405
355030837000244,1,150,84,152,152,146,450
355030837000245,1,161,88,173,173,119,465
355030837000246,1,129,57,135,135,72,342
355030837000247,1,156,78,208,208,136,552
355030837000248,1,129,59,142,142,104,388
355030837000249,1,97,54,152,152,71,375
355030837000250,1,117,83,210,210,212,632
355030837000251,1,101,65,146,146,135,427
355030837000252,1,141,68,145,145,106,396
355030837000253,1,245,102,233,233,196,662
355030837000254,1,130,59,151,151,93,395
355030837000255,1,105,46,104,104,85,293
355030837000256,1,183,92,215,215,161,591
355030837000257,1,141,68,163,163,126,452
355030837000258,1,152,73,182,182,151,515
355030837000259,1,120,43,154,154,124,432
355030837000260,1,89,24,140,140,66,346
355030837000261,1,94,29,111,111,65,287
355030837000262,1,113,51,129,129,111,369
355030837000263,1,90,64,110,110,107,327
355030837000264,1,194,127,257,257,219,733
355030837000265,1,112,51,107,107,60,274
355030837000266,1,204,64,176,176,136,488
355030837000267,1,83,67,125,125,87,337
355030837000268,1,76,26,101,101,60,262
355030837000269,1,101,47,113,113,46,272
355030837000270,1,192,114,226,226,158,610
355030837000271,1,126,67,154,154,116,424
355030837000272,1,215,66,376,376,102,854
355030837000273,1,86,41,120,120,41,281
355030837000274,1,40,4,67,67,21,155
355030837000275,1,0,0,0,0,0,0
355030837000278,1,88,36,76,76,37,189
355030837000279,1,133,73,111,111,51,273
355030837000280,1,147,49,122,122,39,283
355030837000281,1,101,55,126,126,38,290
355030837000282,1,81,16,68,68,36,172
355030837000283,1,80,24,66,66,25,157
355030837000284,1,38,13,50,50,19,119
355030837000285,1,25,20,38,38,17,93
355030838000001,1,127,78,164,164,143,471
355030838000002,1,148,70,204,204,174,582
355030838000003,1,76,47,160,160,149,469
355030838000004,1,86,34,140,140,88,368
355030838000005,1,137,62,207,207,160,574
355030838000006,1,219,97,197,197,119,513
355030838000007,1,93,41,107,107,87,301
355030838000008,1,83,47,109,109,88,306
355030838000009,1,77,32,87,87,87,261
355030838000010,1,106,60,148,148,110,406
355030838000011,1,144,79,237,237,282,756
355030838000012,1,107,52,180,180,119,479
355030838000013,1,82,30,190,190,137,517
355030838000014,1,197,76,222,222,145,589
355030838000015,1,164,90,273,273,167,713
355030838000016,1,61,35,49,49,27,125
355030838000017,1,62,30,119,119,101,339
355030838000018,1,83,49,107,107,127,341
355030838000019,1,60,49,133,133,152,418
355030838000020,1,28,11,23,23,21,67
355030838000021,1,148,75,134,134,86,354
355030838000022,1,121,58,171,171,137,479
355030838000023,1,141,54,225,225,89,539
355030838000024,1,58,46,168,168,123,459
355030838000025,1,162,74,339,339,227,905
355030838000027,1,96,57,174,174,166,514
355030838000028,1,83,44,133,133,87,353
355030838000029,1,52,28,66,66,45,177
355030838000030,1,115,60,108,108,40,256
355030838000031,1,131,51,154,154,118,426
355030838000032,1,186,83,232,232,153,617
355030838000033,1,118,51,154,154,133,441
355030838000034,1,169,59,180,180,130,490
355030838000035,1,91,62,161,161,104,426
355030838000036,1,112,58,153,153,104,410
355030838000037,1,51,33,112,112,76,300
355030838000038,1,106,56,123,123,101,347
355030838000039,1,73,42,130,130,118,378
355030838000040,1,113,45,222,222,135,579
355030838000041,1,82,35,142,142,119,403
355030838000042,1,74,37,152,152,86,390
355030838000043,1,278,104,257,257,131,645
355030838000044,1,42,29,92,92,67,251
355030838000045,1,128,66,198,198,222,618
355030838000046,1,121,47,129,129,130,388
355030838000047,1,147,73,232,232,176,640
355030838000048,1,96,60,172,172,174,518
355030838000049,1,62,39,168,168,147,483
355030838000050,1,78,58,131,131,158,420
355030838000051,1,76,49,181,181,150,512
355030838000052,1,42,40,99,99,98,296
355030838000053,1,95,50,94,94,52,240
355030838000054,1,51,29,64,64,65,193
355030838000055,1,86,39,131,131,110,372
355030838000056,1,191,90,215,215,109,539
355030838000057,1,52,19,42,42,17,101
355030838000058,1,26,8,32,32,17,81
355030838000059,1,94,44,111,111,84,306
355030838000060,1,99,51,102,102,102,306
355030838000061,1,94,47,114,114,75,303
355030838000062,1,126,64,176,176,132,484
355030838000063,1,172,127,269,269,157,695
355030838000064,1,125,81,172,172,141,485
355030838000065,1,97,63,125,125,102,352
355030838000066,1,146,49,125,125,82,332
355030838000067,1,77,41,113,113,48,274
355030838000068,1,80,35,117,117,84,318
355030838000069,1,106,58,136,136,94,366
355030838000070,1,164,80,167,167,87,421
355030838000071,1,135,61,195,195,93,483
355030838000072,1,143,74,260,260,149,669
355030838000073,1,67,55,76,76,59,211
355030838000074,1,101,56,161,161,132,454
355030838000075,1,64,47,153,153,108,414
355030838000076,1,165,56,203,203,131,537
355030838000077,1,33,27,39,39,22,100
355030838000078,1,113,48,95,95,46,236
355030838000079,1,255,107,202,202,87,491
355030838000080,1,84,39,60,60,46,166
355030838000081,1,220,118,281,281,215,777
355030838000082,1,61,29,80,80,76,236
355030838000083,1,103,64,233,233,192,658
355030838000084,1,70,62,152,152,125,429
355030838000085,1,118,51,144,144,105,393
355030838000086,1,24,22,85,85,81,251
355030838000087,1,114,77,154,154,110,418
355030838000088,1,65,39,67,67,47,181
355030838000089,1,33,37,113,113,51,277
355030838000090,1,15,16,71,71,56,198
355030838000091,1,29,29,112,112,94,318
355030838000092,1,90,56,143,143,164,450
355030838000093,1,87,61,162,162,169,493
355030838000094,1,84,62,161,161,191,513
355030838000095,1,43,28,94,94,80,268
355030838000096,1,91,61,157,157,124,438
355030838000097,1,48,27,57,57,65,179
355030838000098,1,87,38,134,134,91,359
355030838000099,1,159,88,224,224,153,601
355030838000100,1,83,33,99,99,80,278
355030838000101,1,149,65,263,263,101,627
355030838000102,1,82,49,115,115,104,334
355030838000103,1,148,89,243,243,153,639
355030838000104,1,71,46,109,109,108,326
355030838000105,1,195,86,238,238,164,640
355030838000106,1,188,89,233,233,110,576
355030838000107,1,28,31,43,43,15,101
355030838000108,1,156,69,183,183,96,462
355030838000109,1,193,108,255,255,205,715
355030838000110,1,161,93,208,208,132,548
355030838000111,1,66,38,75,75,59,209
355030838000112,1,80,44,84,84,26,194
355030838000113,1,146,71,180,180,119,479
355030838000114,1,89,58,158,158,148,464
355030838000115,1,104,55,183,183,139,505
355030838000116,1,169,84,152,152,143,447
355030838000117,1,172,63,209,209,125,543
355030838000118,1,136,81,178,178,127,483
355030838000119,1,75,44,118,118,105,341
355030838000120,1,62,33,92,92,78,262
355030838000121,1,79,34,69,69,22,160
355030838000122,1,74,44,187,187,156,530
355030838000123,1,67,36,132,132,114,378
355030838000124,1,71,26,51,51,39,141
355030838000125,1,145,44,110,110,51,271
355030838000127,1,31,25,30,30,23,83
355030838000128,1,119,40,97,97,25,219
355030838000129,1,134,63,151,151,120,422
355030838000130,1,113,84,160,160,137,457
355030838000131,1,168,64,207,207,164,578
355030838000132,1,88,30,136,136,103,375
355030838000133,1,113,47,167,167,163,497
355030838000134,1,105,76,168,168,146,482
355030838000135,1,85,57,142,142,131,415
355030838000136,1,86,52,141,141,127,409
355030838000137,1,53,39,185,185,115,485
355030838000138,1,1,5,6,6,6,18
355030838000139,1,92,59,142,142,165,449
355030838000140,1,38,18,96,96,93,285
355030838000141,1,49,20,191,191,92,474
355030838000142,1,13,8,42,42,28,112
355030838000143,1,61,35,119,119,107,345
355030838000144,1,79,38,153,153,162,468
355030838000145,1,60,34,121,121,106,348
355030838000146,1,29,18,43,43,56,142
355030838000147,1,37,39,72,72,96,240
355030838000148,1,22,29,52,52,84,188
355030838000149,1,71,41,123,123,131,377
355030838000150,1,110,53,214,214,196,624
355030838000151,1,35,11,29,29,18,76
355030838000152,1,123,64,153,153,141,447
355030838000153,1,23,16,27,27,20,74
355030838000154,1,75,35,122,122,96,340
355030838000155,1,165,70,196,196,141,533
355030838000156,1,80,42,110,110,105,325
355030838000157,1,135,67,174,174,128,476
355030838000158,1,99,59,158,158,95,411
355030838000159,1,173,79,159,159,101,419
355030838000160,1,164,76,181,181,137,499
355030838000161,1,114,57,156,156,113,425
355030838000162,1,143,88,154,154,121,429
355030838000163,1,22,8,21,21,12,54
355030838000164,1,161,74,165,165,116,446
355030838000165,1,177,50,252,252,95,599
355030838000166,1,118,41,161,161,82,404
355030838000167,1,200,117,237,237,163,637
355030838000168,1,118,52,127,127,84,338
355030838000169,1,67,34,94,94,52,240
355030838000170,1,240,128,294,294,170,758
355030838000171,1,111,61,122,122,89,333
355030838000172,1,92,58,164,164,126,454
355030838000173,1,89,43,146,146,134,426
355030838000174,1,78,43,167,167,139,473
355030838000175,1,58,29,128,128,109,365
355030838000176,1,82,30,144,144,95,383
355030838000177,1,93,37,135,135,98,368
355030838000178,1,65,37,164,164,153,481
355030838000179,1,55,55,164,164,131,459
355030838000180,1,90,50,143,143,110,396
355030838000181,1,51,42,97,97,116,310
355030838000182,1,59,42,109,109,113,331
355030838000183,1,44,30,106,106,106,318
355030838000184,1,48,46,154,154,133,441
355030838000185,1,41,39,104,104,108,316
355030838000186,1,37,41,95,95,151,341
355030838000187,1,119,76,232,232,199,663
355030838000188,1,104,67,271,271,202,744
355030838000189,1,109,62,149,149,134,432
355030838000190,1,122,65,218,218,186,622
355030838000191,1,49,56,210,210,152,572
355030838000192,1,130,71,186,186,147,519
355030838000193,1,138,72,192,192,154,538
355030838000194,1,83,44,148,148,118,414
355030838000195,1,106,45,137,137,115,389
355030838000196,1,67,37,119,119,108,346
355030838000197,1,118,73,222,222,180,624
355030838000198,4,23,16,21,21,26,68
355030838000199,4,0,0,0,0,0,0
355030838000201,1,68,64,126,126,133,385
355030838000202,1,88,37,96,96,59,251
355030838000203,1,159,59,141,141,84,366
355030838000204,1,133,85,157,157,155,469
355030838000205,1,98,49,159,159,100,418
355030838000206,1,192,91,225,225,160,610
355030838000207,1,113,46,101,101,54,256
355030838000208,1,234,115,228,228,127,583
355030838000209,1,181,96,236,236,138,610
355030838000210,1,152,56,177,177,99,453
355030838000211,1,188,83,210,210,148,568
355030838000212,1,265,71,303,303,105,711
355030838000213,1,137,48,169,169,91,429
355030838000214,1,171,85,212,212,122,546
355030838000215,1,101,38,257,257,177,691
355030838000216,1,78,33,155,155,128,438
355030838000217,1,63,51,197,197,146,540
355030838000218,1,157,91,263,263,258,784
355030838000219,1,44,17,188,188,82,458
355030838000220,1,142,63,351,351,159,861
355030838000221,1,190,54,303,303,176,782
355030838000222,1,77,34,144,144,113,401
355030838000223,1,82,36,182,182,130,494
355030838000224,1,243,66,461,461,199,1121
355030838000225,1,43,23,125,125,98,348
355030838000226,1,100,60,219,219,195,633
355030838000227,1,47,16,96,96,58,250
355030838000228,1,57,51,129,129,134,392
355030838000229,1,29,21,44,44,34,122
355030838000230,1,120,48,107,107,38,252
355030838000231,1,44,22,106,106,84,296
355030838000232,1,34,30,78,78,96,252
355030838000233,1,63,44,150,150,154,454
355030838000234,1,19,23,105,105,58,268
355030838000235,1,93,53,211,211,169,591
355030838000236,1,10,9,48,48,49,145
355030838000237,1,33,31,118,118,81,317
355030838000238,1,58,46,177,177,160,514
355030838000239,1,47,37,134,134,92,360
355030838000240,1,60,28,162,162,90,414
355030838000241,1,93,47,194,194,178,566
355030838000242,1,39,24,80,80,63,223
355030838000243,1,110,68,176,176,173,525
355030838000244,1,128,73,199,199,180,578
355030838000245,1,131,55,158,158,101,417
355030838000246,1,90,36,114,114,89,317
355030838000247,1,88,49,129,129,110,368
355030838000248,1,50,30,87,87,89,263
355030838000249,1,136,54,187,187,157,531
355030838000250,1,122,59,180,180,155,515
355030838000251,1,177,66,274,274,153,701
355030838000252,1,66,43,111,111,102,324
355030838000253,1,111,75,174,174,177,525
355030838000254,1,78,35,141,141,131,413
355030838000255,1,55,49,97,97,120,314
355030838000256,1,73,55,133,133,142,408
355030838000257,1,174,70,202,202,102,506
355030838000258,1,137,71,146,146,84,376
355030838000259,1,103,34,100,100,50,250
355030838000260,1,196,111,211,211,125,547
355030838000261,1,232,127,225,225,127,577
355030838000262,1,278,124,264,264,81,609
355030838000263,1,231,84,194,194,88,476
355030838000264,1,105,57,110,110,39,259
355030838000265,1,127,54,140,140,68,348
355030838000266,1,156,61,137,137,89,363
355030838000267,1,138,75,171,171,103,445
355030838000268,1,140,62,136,136,76,348
355030838000269,1,85,40,86,86,30,202
355030838000270,1,179,112,239,239,131,609
355030838000271,1,90,46,99,99,55,253
355030838000272,1,26,13,61,61,57,179
355030838000273,1,92,66,166,166,183,515
355030838000274,1,37,19,79,79,73,231
355030838000275,1,27,21,97,97,64,258
355030838000276,1,98,48,110,110,97,317
355030838000277,1,98,48,302,302,117,721
355030838000278,1,77,50,115,115,104,334
355030838000279,1,87,46,86,86,35,207
355030838000280,1,96,62,110,110,95,315
355030838000281,1,64,31,72,72,56,200
355030838000282,1,79,25,183,183,103,469
355030838000283,1,86,56,216,216,126,558
355030838000284,1,115,71,108,108,99,315
355030838000285,1,72,70,154,154,142,450
355030838000286,1,101,65,176,176,137,489
355030838000287,1,54,36,103,103,108,314
355030838000288,1,148,82,172,172,117,461
355030838000289,1,228,116,205,205,121,531
355030838000290,1,65,40,94,94,65,253
355030838000291,1,98,34,304,304,108,716
355030838000292,1,33,23,101,101,88,290
355030838000293,1,62,37,117,117,92,326
355030838000294,1,147,57,294,294,136,724
355030838000295,1,115,77,164,164,147,475
355030838000296,1,86,39,158,158,143,459
355030838000297,1,93,31,217,217,109,543
355030838000298,1,69,38,199,199,117,515
355030838000299,1,64,47,102,102,87,291
355030838000300,1,115,63,176,176,134,486
355030838000301,1,151,72,203,203,130,536
355030838000302,1,95,34,185,185,81,451
355030838000303,1,177,82,241,241,147,629
355030838000304,1,18,7,15,15,14,44
355030838000305,1,23,13,40,40,45,125
355030838000306,1,206,90,223,223,125,571
355030838000307,1,111,39,160,160,107,427
355030838000308,1,66,40,93,93,125,311
355030838000309,1,102,40,137,137,92,366
355030838000310,1,52,23,79,79,103,261
355030838000311,1,57,36,52,52,27,131
355030838000312,1,61,30,52,52,31,135
355030838000313,1,145,56,99,99,48,246
355030838000314,1,115,50,80,80,53,213
355030838000315,1,124,52,83,83,36,202
355030838000316,1,129,55,106,106,53,265
355030838000317,1,71,43,78,78,36,192
355030838000318,1,65,41,43,43,23,109
355030838000319,1,54,23,34,34,22,90
355030838000320,1,117,61,107,107,79,293
355030838000321,1,52,19,30,30,36,96
355030838000322,1,29,18,53,53,29,135
355030838000323,1,10,7,21,21,14,56
355030838000324,1,52,10,33,33,9,75
355030838000325,1,20,12,23,23,9,55
355030838000326,1,53,18,45,45,11,101
355030838000327,1,100,47,68,68,21,157
355030838000328,1,135,70,88,88,43,219
355030838000329,1,27,23,36,36,19,91
355030838000330,1,60,35,51,51,21,123
355030838000331,1,67,39,140,140,86,366
355030838000332,1,43,21,45,45,27,117
355030838000333,1,0,0,0,0,0,0
355030838000334,1,108,73,180,180,107,467
355030838000335,1,18,13,40,40,54,134
355030838000336,1,30,28,56,56,66,178
355030838000337,1,85,56,160,160,173,493
355030838000338,1,64,32,70,70,56,196
355030838000339,1,55,33,87,87,75,249
355030838000340,1,143,58,164,164,124,452
355030838000341,1,115,43,130,130,118,378
355030838000342,1,26,24,77,77,61,215
355030838000343,1,96,47,112,112,99,323
355030838000344,1,93,56,149,149,114,412
355030838000345,1,50,17,79,79,69,227
355030838000346,1,59,44,114,114,102,330
355030838000347,1,60,45,85,85,61,231
355030838000348,1,36,22,48,48,43,139
355030838000349,1,41,28,72,72,44,188
355030838000350,1,92,53,172,172,151,495
355030838000351,1,53,55,96,96,147,339
355030838000352,1,53,24,65,65,62,192
355030838000353,1,79,69,113,113,96,322
355030838000354,1,58,28,73,73,58,204
355030838000355,1,166,75,164,164,83,411
355030838000356,1,73,53,99,99,80,278
355030838000357,1,50,38,97,97,82,276
355030838000358,1,64,36,86,86,66,238
355030838000359,1,92,41,99,99,61,259
355030838000360,1,23,5,34,34,28,96
355030838000361,1,45,21,83,83,48,214
355030838000362,1,32,15,84,84,79,247
355030838000363,1,4,1,31,31,8,70
355030838000364,1,19,29,122,122,86,330
355030838000365,1,181,101,321,321,265,907
355030838000366,1,37,24,67,67,64,198
355030838000367,1,321,144,268,268,155,691
355030838000368,4,14,7,15,15,18,48
355030838000370,1,16,9,102,102,54,258
355030838000371,1,83,51,124,124,93,341
355030838000372,1,6,4,13,13,4,30
355030838000373,1,22,11,26,26,20,72
355030838000374,1,13,5,13,13,3,29
355030838000375,1,17,17,25,25,19,69
355030838000376,1,214,110,232,232,130,594
355030838000377,1,37,22,45,45,39,129
355030838000378,1,45,35,53,53,36,142
355030838000379,1,14,3,7,7,11,25
355030838000380,1,12,11,26,26,10,62
355030838000381,1,20,4,14,14,10,38
355030838000382,1,51,14,57,57,29,143
355030838000383,1,8,7,19,19,7,45
355030838000384,1,62,28,94,94,65,253
355030838000385,1,27,20,29,29,15,73
355030838000386,1,88,32,78,78,28,184
355030838000387,1,47,27,56,56,34,146
355030838000388,1,42,22,50,50,48,148
355030838000390,1,57,29,71,71,34,176
355030838000391,1,50,15,47,47,18,112
355030838000392,1,65,33,48,48,45,141
355030838000393,1,23,11,26,26,14,66
355030838000394,1,23,7,29,29,14,72
355030838000395,1,346,122,181,181,85,447
355030838000396,1,22,9,27,27,15,69
355030838000397,1,90,26,68,68,37,173
355030838000398,1,90,49,81,81,36,198
355030838000399,1,53,18,44,44,38,126
355030838000400,1,245,85,167,167,61,395
355030838000401,1,132,55,98,98,46,242
355030838000402,1,26,11,16,16,12,44
355030838000403,1,12,9,15,15,16,46
355030838000404,1,175,86,184,184,108,476
355030838000405,1,67,26,46,46,24,116
355030838000406,1,149,58,156,156,47,359
355030838000407,1,72,17,46,46,16,108
355030838000408,1,66,43,63,63,32,158
355030838000409,1,9,4,9,9,13,31
355030838000410,1,132,49,96,96,54,246
355030838000411,1,13,7,7,7,6,20
355030838000412,1,10,8,11,11,11,33
355030839000001,1,66,51,131,131,110,372
355030839000002,1,124,64,163,163,164,490
355030839000003,1,61,22,85,85,56,226
355030839000004,1,0,0,26,26,93,145
355030839000005,1,80,60,141,141,111,393
355030839000006,1,78,50,123,123,122,368
355030839000007,1,193,98,261,261,235,757
355030839000008,1,102,37,125,125,151,401
355030839000009,1,139,52,137,137,117,391
355030839000010,1,107,77,187,187,161,535
355030839000011,1,140,78,179,179,172,530
355030839000012,1,48,37,79,79,89,247
355030839000013,1,66,45,127,127,116,370
355030839000014,1,62,32,108,108,69,285
355030839000015,1,56,41,98,98,87,283
355030839000016,1,59,28,107,107,87,301
355030839000017,1,72,57,153,153,150,456
355030839000018,1,106,78,205,205,176,586
355030839000019,1,126,62,174,174,166,514
355030839000020,1,182,98,230,230,211,671
355030839000021,1,65,38,102,102,87,291
355030839000022,1,122,76,155,155,151,461
355030839000023,1,4,3,4,4,5,13
355030839000024,1,241,68,176,176,71,423
355030839000026,1,303,143,230,230,104,564
355030839000027,1,124,53,143,143,110,396
355030839000028,1,90,32,49,49,35,133
355030839000029,1,211,108,262,262,173,697
355030839000030,1,66,34,114,114,98,326
355030839000031,1,120,43,124,124,117,365
355030839000032,1,82,58,118,118,106,342
355030839000033,1,66,35,124,124,138,386
355030839000034,1,68,33,104,104,124,332
355030839000035,1,97,66,165,165,167,497
355030839000036,1,41,20,73,73,63,209
355030839000037,1,127,56,206,206,195,607
355030839000038,1,65,50,96,96,113,305
355030839000039,1,63,40,115,115,113,343
355030839000040,1,49,29,68,68,74,210
355030839000041,1,41,21,91,91,74,256
355030839000042,1,150,71,224,224,161,609
355030839000043,1,135,87,214,214,172,600
355030839000044,1,66,39,84,84,72,240
355030839000045,1,103,54,183,183,161,527
355030839000046,1,99,46,185,185,116,486
355030839000047,1,74,38,100,100,100,300
355030839000048,1,98,46,183,183,127,493
355030839000049,1,330,91,206,206,75,487
355030839000050,1,421,163,322,322,147,791
355030839000051,1,23,6,21,21,4,46
355030839000052,1,62,33,59,59,46,164
355030839000053,1,116,70,143,143,82,368
355030839000054,1,157,73,176,176,151,503
355030839000055,1,197,72,192,192,117,501
355030839000056,1,126,78,156,156,100,412
355030839000057,1,46,27,35,35,23,93
355030839000058,1,220,121,245,245,152,642
355030839000059,1,189,79,156,156,107,419
355030839000060,1,118,40,120,120,118,358
355030839000061,1,88,41,125,125,108,358
355030839000062,1,130,67,125,125,127,377
355030839000063,1,81,54,134,134,119,387
355030839000064,1,80,40,99,99,89,287
355030839000065,1,67,37,96,96,75,267
355030839000066,1,39,21,51,51,54,156
355030839000067,1,89,40,134,134,138,406
355030839000068,1,59,19,45,45,21,111
355030839000069,1,120,59,95,95,102,292
355030839000070,1,80,52,111,111,122,344
355030839000071,1,274,100,181,181,92,454
355030839000072,1,233,106,270,270,130,670
355030839000073,1,310,58,154,154,38,346
355030839000074,1,177,74,178,178,147,503
355030839000075,1,141,63,185,185,177,547
355030839000076,1,116,59,133,133,117,383
355030839000077,1,119,48,178,178,133,489
355030839000078,1,175,80,185,185,144,514
355030839000079,1,54,30,75,75,48,198
355030839000080,1,92,61,140,140,123,403
355030839000081,1,100,47,135,135,114,384
355030839000082,1,80,35,87,87,68,242
355030839000083,1,27,19,24,24,20,68
355030839000084,1,150,72,150,150,132,432
355030839000085,1,119,69,122,122,97,341
355030839000086,1,95,43,102,102,72,276
355030839000087,1,31,14,48,48,43,139
355030839000088,1,134,80,168,168,151,487
355030839000089,1,103,46,126,126,89,341
355030839000090,1,167,72,199,199,171,569
355030839000092,1,228,94,177,177,84,438
355030839000093,1,115,55,139,139,114,392
355030839000094,1,262,105,285,285,138,708
355030839000095,1,127,66,157,157,104,418
355030839000096,1,149,77,193,193,153,539
355030839000097,1,164,97,262,262,184,708
355030839000098,1,84,46,111,111,144,366
355030839000099,1,73,50,136,136,128,400
355030839000100,1,99,41,159,159,143,461
355030839000101,1,125,72,172,172,147,491
355030839000102,1,71,45,107,107,88,302
355030839000103,1,222,95,216,216,213,645
355030839000104,1,206,107,198,198,167,563
355030839000105,1,229,67,221,221,107,549
355030839000106,1,117,61,127,127,85,339
355030839000107,1,359,138,305,305,157,767
355030839000108,1,80,38,81,81,17,179
355030839000109,1,63,36,65,65,22,152
355030839000110,1,129,69,136,136,87,359
355030839000111,1,178,64,137,137,90,364
355030839000112,1,175,110,176,176,137,489
355030839000113,1,278,136,213,213,94,520
355030839000114,1,377,185,294,294,169,757
355030839000115,1,8,27,201,201,6,408
355030839000116,1,129,61,162,162,102,426
355030839000117,1,359,169,349,349,196,894
355030839000118,1,561,211,513,513,206,1232
355030839000119,1,211,93,171,171,194,536
355030839000120,1,186,96,232,232,162,626
355030839000121,1,214,99,171,171,149,491
355030839000122,1,196,89,158,158,70,386
355030839000123,1,65,38,76,76,68,220
355030839000124,1,107,51,76,76,40,192
355030839000125,1,210,110,208,208,216,632
355030839000126,1,104,60,125,125,114,364
355030839000127,1,28,29,61,61,86,208
355030839000128,1,122,109,159,159,63,381
355030839000129,1,87,44,103,103,95,301
355030839000130,1,44,42,84,84,66,234
355030839000131,1,62,23,132,132,33,297
355030839000132,1,75,40,132,132,155,419
355030839000133,1,217,90,140,140,104,384
355030839000134,1,135,65,167,167,138,472
355030839000135,1,98,41,115,115,89,319
355030839000136,1,54,32,73,73,77,223
355030839000137,1,42,21,61,61,66,188
355030839000138,1,74,50,98,98,89,285
355030839000139,1,110,44,132,132,108,372
355030839000140,1,103,49,139,139,121,399
355030839000141,1,29,16,34,34,23,91
355030839000143,1,36,13,25,25,33,83
355030839000144,1,44,19,33,33,27,93
355030839000145,1,63,17,69,69,23,161
355030839000146,1,128,61,101,101,52,254
355030839000147,1,49,17,41,41,25,107
355030839000148,1,102,55,85,85,50,220
355030839000149,1,94,119,169,169,79,417
355030839000150,1,110,47,90,90,43,223
355030839000151,1,49,16,47,47,29,123
355030839000152,1,49,21,35,35,14,84
355030840000001,1,118,66,162,162,140,464
355030840000002,1,151,74,285,285,182,752
355030840000003,1,111,70,189,189,180,558
355030840000004,1,120,78,183,183,176,542
355030840000005,1,117,62,141,141,154,436
355030840000006,1,138,63,137,137,90,364
355030840000007,1,112,61,208,208,197,613
355030840000008,1,183,70,286,286,151,723
355030840000009,1,87,54,159,159,134,452
355030840000010,1,108,55,147,147,159,453
355030840000011,1,134,68,220,220,199,639
355030840000012,1,77,39,113,113,77,303
355030840000013,1,166,78,216,216,181,613
355030840000014,1,116,49,181,181,172,534
355030840000015,1,73,51,144,144,114,402
355030840000016,1,113,59,158,158,145,461
355030840000017,1,158,68,227,227,174,628
355030840000018,1,89,34,132,132,103,367
355030840000019,1,144,84,215,215,189,619
355030840000020,1,83,80,130,130,155,415
355030840000021,1,114,59,144,144,135,423
355030840000022,1,138,73,169,169,167,505
355030840000023,1,159,98,205,205,187,597
355030840000024,1,49,15,61,61,55,177
355030840000025,1,65,46,82,82,110,274
355030840000026,1,117,72,193,193,168,554
355030840000027,1,163,70,211,211,195,617
355030840000028,1,91,48,121,121,109,351
355030840000030,1,49,48,76,76,104,256
355030840000031,1,79,46,143,143,104,390
355030840000032,1,160,54,307,307,163,777
355030840000033,1,46,33,67,67,76,210
355030840000034,1,85,57,127,127,127,381
355030840000035,1,48,21,58,58,61,177
355030841000001,1,120,75,174,174,151,499
355030841000002,1,108,56,129,129,121,379
355030841000003,1,404,153,248,248,79,575
355030841000004,1,267,147,287,287,133,707
355030841000005,1,309,132,302,302,176,780
355030841000006,1,152,74,137,137,83,357
355030841000007,1,85,43,78,78,49,205
355030841000008,1,238,113,202,202,80,484
355030841000009,1,124,68,126,126,66,318
355030841000010,1,135,69,135,135,64,334
355030841000011,1,155,114,150,150,73,373
355030841000012,1,207,99,212,212,84,508
355030841000013,1,46,26,57,57,31,145
355030841000014,1,220,90,211,211,93,515
355030841000015,1,80,42,99,99,35,233
355030841000016,1,81,50,99,99,85,283
355030841000017,1,68,18,103,103,69,275
355030841000018,1,35,28,82,82,88,252
355030841000019,1,44,32,77,77,82,236
355030841000020,1,80,58,128,128,92,348
355030841000021,1,54,40,123,123,82,328
355030841000022,1,46,5,102,102,25,229
355030841000023,1,48,22,78,78,77,233
355030841000024,1,41,15,79,79,56,214
355030841000025,1,103,84,186,186,184,556
355030841000026,1,40,17,37,37,34,108
355030841000027,1,250,110,200,200,63,463
355030841000028,1,26,6,48,48,45,141
355030841000029,1,67,32,132,132,70,334
355030841000030,1,31,22,45,45,65,155
355030841000031,1,98,74,114,114,100,328
355030841000033,1,33,24,80,80,65,225
355030841000034,1,54,19,93,93,57,243
355030841000035,1,95,45,149,149,120,418
355030841000036,1,16,20,55,55,77,187
355030841000037,1,44,47,100,100,112,312
355030841000038,1,168,87,416,416,223,1055
355030841000039,1,21,10,75,75,56,206
355030841000040,1,51,28,79,79,83,241
355030841000041,1,32,16,70,70,51,191
355030841000042,1,27,13,57,57,54,168
355030841000043,1,89,56,131,131,138,400
355030841000044,1,117,65,151,151,105,407
355030841000045,1,22,21,61,61,66,188
355030841000046,1,56,30,108,108,90,306
355030841000047,1,29,27,61,61,101,223
355030841000048,1,57,30,58,58,35,151
355030841000049,1,77,36,122,122,111,355
355030841000050,1,97,40,130,130,96,356
355030841000051,1,73,25,283,283,40,606
355030841000052,1,128,50,119,119,32,270
355030841000053,1,139,54,132,132,49,313
355030841000054,1,108,45,95,95,27,217
355030841000055,1,119,48,70,70,23,163
355030841000056,1,97,70,125,125,27,277
355030841000057,1,402,169,303,303,116,722
355030841000058,1,150,76,191,191,118,500
355030841000059,1,86,29,77,77,41,195
355030841000060,1,104,29,89,89,33,211
355030841000061,1,219,101,156,156,53,365
355030841000062,1,129,67,134,134,58,326
355030841000063,1,153,65,147,147,60,354
355030841000064,1,67,42,64,64,56,184
355030841000065,1,79,43,95,95,46,236
355030841000066,1,68,38,75,75,58,208
355030841000067,1,71,49,86,86,94,266
355030841000068,1,75,27,109,109,58,276
355030841000069,1,10,5,46,46,25,117
355030841000070,1,65,16,119,119,47,285
355030841000071,1,51,22,88,88,90,266
355030841000072,1,53,36,109,109,112,330
355030841000073,1,101,65,155,155,113,423
355030841000074,1,31,31,64,64,73,201
355030841000075,1,45,32,70,70,72,212
355030841000076,1,67,23,150,150,51,351
355030841000077,1,31,16,74,74,64,212
355030841000078,1,30,18,76,76,70,222
355030841000079,1,19,26,71,71,79,221
355030841000080,1,36,17,92,92,87,271
355030841000081,1,20,4,52,52,10,114
355030841000082,1,15,1,48,48,7,103
355030841000083,1,84,28,161,161,64,386
355030841000084,1,79,24,168,168,44,380
355030841000085,1,42,17,134,134,40,308
355030841000086,1,57,10,157,157,69,383
355030841000087,1,91,42,86,86,32,204
355030841000088,1,43,20,71,71,78,220
355030841000089,1,60,25,84,84,61,229
355030841000090,1,42,19,71,71,40,182
355030841000091,1,24,15,50,50,63,163
355030841000092,1,59,40,96,96,97,289
355030841000093,1,46,30,106,106,120,332
355030841000094,1,68,40,147,147,106,400
355030841000095,1,33,35,130,130,81,341
355030841000096,1,63,31,123,123,92,338
355030841000097,1,32,25,75,75,60,210
355030841000098,1,185,71,179,179,86,444
355030841000099,1,187,103,149,149,77,375
355030841000100,1,71,56,134,134,101,369
355030841000101,1,32,15,48,48,62,158
355030841000102,1,24,20,55,55,67,177
355030841000103,1,24,11,105,105,28,238
355030841000104,1,52,28,83,83,72,238
355030841000105,1,4,8,16,16,12,44
355030842000001,1,160,72,185,185,119,489
355030842000002,1,123,75,161,161,115,437
355030842000003,1,139,80,233,233,195,661
355030842000004,1,142,37,120,120,82,322
355030842000005,1,256,60,289,289,124,702
355030842000006,1,147,74,188,188,167,543
355030842000007,1,227,93,267,267,201,735
355030842000008,1,330,179,407,407,279,1093
355030842000009,1,158,111,220,220,143,583
355030842000010,1,179,106,221,221,187,629
355030842000011,1,160,67,155,155,128,438
355030842000012,1,153,94,167,167,157,491
355030842000014,1,77,37,71,71,63,205
355030842000015,1,100,62,139,139,96,374
355030842000016,1,62,25,92,92,69,253
355030842000017,1,181,79,247,247,202,696
355030842000018,1,101,63,172,172,116,460
355030842000019,1,283,119,323,323,208,854
355030842000020,1,112,47,104,104,82,290
355030842000021,1,222,88,241,241,159,641
355030842000022,1,134,64,172,172,141,485
355030842000023,1,136,57,195,195,173,563
355030842000024,1,157,78,199,199,159,557
355030842000025,1,144,63,198,198,150,546
355030842000026,1,178,95,197,197,167,561
355030842000027,1,99,60,93,93,161,347
355030842000028,1,133,71,156,156,166,478
355030842000029,1,216,121,279,279,202,760
355030842000030,1,339,164,379,379,280,1038
355030842000031,1,279,183,299,299,276,874
355030842000032,1,68,25,76,76,45,197
355030842000033,1,130,71,156,156,103,415
355030842000034,1,198,90,216,216,118,550
355030842000035,1,191,80,190,190,82,462
355030842000036,1,408,224,359,359,188,906
355030842000037,1,120,41,140,140,79,359
355030842000038,1,178,83,215,215,132,562
355030842000039,1,169,85,181,181,124,486
355030842000040,1,332,160,295,295,206,796
355030842000041,1,106,57,139,139,79,357
355030842000042,1,44,32,62,62,84,208
355030842000043,1,202,96,227,227,187,641
355030842000044,1,147,65,155,155,109,419
355030842000045,1,222,105,193,193,104,490
355030842000046,1,274,97,281,281,159,721
355030842000047,1,117,64,145,145,108,398
355030842000048,1,159,104,217,217,135,569
355030842000049,1,224,111,249,249,165,663
355030842000050,1,216,92,191,191,151,533
355030842000051,1,163,86,165,165,104,434
355030842000053,4,82,40,84,84,67,235
355030842000054,4,115,44,123,123,63,309
355030842000055,4,89,46,154,154,70,378
355030842000056,4,104,47,106,106,61,273
355030842000057,4,126,54,135,135,74,344
355030842000058,1,197,95,209,209,165,583
355030842000059,1,184,95,219,219,181,619
355030842000061,1,147,57,191,191,120,502
355030842000062,1,148,85,162,162,159,483
355030842000063,1,199,116,218,218,160,596
355030842000064,8,0,0,0,0,0,0
355030842000065,1,155,65,123,123,86,332
355030842000066,1,131,74,137,137,71,345
355030842000067,1,178,73,219,219,137,575
355030842000068,1,35,21,49,49,38,136
355030842000069,1,254,95,281,281,219,781
355030842000071,1,170,86,195,195,139,529
355030842000072,1,94,43,113,113,74,300
355030842000073,1,150,66,145,145,112,402
355030842000074,1,270,129,320,320,234,874
355030842000075,1,237,89,165,165,111,441
355030842000076,1,143,55,92,92,54,238
355030842000077,1,167,99,197,197,151,545
355030842000078,1,89,69,124,124,57,305
355030842000079,1,422,153,661,661,356,1678
355030842000080,1,160,78,259,259,134,652
355030842000081,1,200,84,262,262,194,718
355030842000082,1,73,43,86,86,70,242
355030842000083,1,309,134,285,285,192,762
355030842000084,1,231,135,250,250,238,738
355030842000085,1,81,42,135,135,65,335
355030842000086,1,199,94,235,235,148,618
355030842000087,1,42,19,53,53,37,143
355030842000088,1,66,39,55,55,61,171
355030842000089,1,113,63,139,139,120,398
355030842000090,1,153,60,210,210,156,576
355030842000091,1,180,62,169,169,108,446
355030842000092,1,475,182,409,409,153,971
355030842000093,1,223,111,225,225,158,608
355030842000094,1,106,45,133,133,108,374
355030842000095,1,98,48,91,91,69,251
355030842000096,1,199,89,165,165,75,405
355030842000097,1,105,52,125,125,81,331
355030842000099,2,298,127,272,272,118,662
355030842000100,1,297,122,212,212,101,525
355030842000101,1,189,94,159,159,127,445
355030842000102,1,172,102,188,188,239,615
355030842000103,1,61,23,72,72,43,187
355030842000104,1,18,12,22,22,24,68
355030842000105,1,40,20,50,50,43,143
355030842000106,1,163,55,141,141,76,358
355030842000107,1,130,61,142,142,58,342
355030842000108,1,0,0,0,0,0,0
355030842000110,1,110,56,127,127,138,392
355030842000111,1,133,72,167,167,132,466
355030842000112,1,86,51,89,89,143,321
355030842000113,1,94,37,96,96,127,319
355030842000114,1,148,67,181,181,160,522
355030842000115,1,121,41,151,151,136,438
355030842000116,1,118,50,149,149,175,473
355030842000117,1,145,59,170,170,134,474
355030842000118,1,168,87,206,206,186,598
355030842000119,1,63,33,74,74,82,230
355030842000120,1,154,63,207,207,219,633
355030842000121,1,162,55,180,180,166,526
355030842000122,1,115,63,130,130,147,407
355030842000123,1,59,27,58,58,40,156
355030842000124,1,64,38,68,68,66,202
355030842000125,1,69,50,94,94,66,254
355030842000126,1,221,99,279,279,149,707
355030842000127,1,70,20,65,65,34,164
355030842000128,1,46,33,50,50,51,151
355030842000129,1,381,161,451,451,187,1089
355030842000130,1,155,60,202,202,96,500
355030842000131,1,149,69,184,184,102,470
355030842000132,1,218,116,279,279,153,711
355030842000133,1,88,39,99,99,53,251
355030842000134,1,201,96,242,242,122,606
355030842000135,1,227,108,256,256,138,650
355030842000137,1,116,84,188,188,99,475
355030842000138,8,0,0,0,0,0,0
355030842000140,2,627,236,686,686,279,1651
355030842000141,8,26,13,17,17,10,44
355030842000142,8,206,126,231,231,153,615
355030842000143,1,222,127,249,249,202,700
355030842000145,2,77,51,79,79,56,214
355030842000146,1,217,78,205,205,113,523
355030842000147,1,346,137,315,315,204,834
355030842000148,8,16,10,13,13,8,34
355030842000150,8,37,10,9,9,10,28
355030842000151,1,307,207,317,317,344,978
355030842000152,1,226,139,251,251,266,768
355030842000153,1,198,106,206,206,220,632
355030842000154,1,206,130,195,195,210,600
355030842000155,1,254,138,258,258,182,698
355030842000156,1,263,152,282,282,253,817
355030842000158,1,460,227,474,474,404,1352
355030842000159,1,294,133,336,336,242,914
355030842000160,1,90,59,124,124,107,355
355030842000161,1,148,66,175,175,101,451
355030842000162,1,85,58,117,117,86,320
355030842000163,1,143,96,160,160,123,443
355030842000164,1,85,39,124,124,68,316
355030842000165,1,96,48,116,116,118,350
355030842000166,1,160,105,198,198,224,620
355030842000167,1,145,93,212,212,143,567
355030842000168,1,109,80,137,137,140,414
355030842000169,1,0,0,0,0,0,0
355030842000170,2,231,110,160,160,80,400
355030842000171,2,538,221,503,503,185,1191
355030842000172,2,722,380,567,567,352,1486
355030842000173,2,466,163,382,382,122,886
355030842000174,1,475,188,431,431,251,1113
355030842000175,1,505,192,410,410,213,1033
355030842000176,1,123,41,137,137,64,338
355030842000177,1,212,112,245,245,159,649
355030842000178,1,128,68,171,171,111,453
355030842000179,1,158,82,137,137,117,391
355030842000180,1,237,85,243,243,123,609
355030842000181,1,164,87,180,180,130,490
355030842000182,1,186,106,177,177,137,491
355030842000183,1,208,82,170,170,95,435
355030842000184,1,8,6,19,19,6,44
355030842000185,1,104,57,151,151,104,406
355030842000186,1,28,16,38,38,21,97
355030842000187,1,139,79,149,149,153,451
355030842000188,1,91,44,98,98,71,267
355030842000189,1,189,71,183,183,88,454
355030842000190,1,105,55,89,89,58,236
355030842000191,1,110,44,139,139,68,346
355030842000192,1,344,162,407,407,309,1123
355030842000193,1,261,110,381,381,167,929
355030842000194,1,448,173,389,389,374,1152
355030842000195,1,243,104,224,224,158,606
355030842000196,1,329,110,347,347,164,858
355030842000197,1,411,188,345,345,160,850
355030842000202,1,72,15,124,124,21,269
355030842000203,1,46,7,75,75,21,171
355030842000204,1,52,12,100,100,19,219
355030842000205,1,32,9,57,57,5,119
355030842000206,1,61,19,100,100,26,226
355030842000207,1,32,11,56,56,21,133
355030842000208,1,34,13,81,81,14,176
355030842000209,1,12,4,19,19,10,48
355030842000210,1,31,11,49,49,7,105
355030842000211,1,44,8,92,92,27,211
355030842000212,1,32,7,57,57,9,123
355030842000215,1,220,61,268,268,109,645
355030842000218,8,5,6,6,6,4,16
355030842000219,8,0,0,0,0,0,0
355030842000221,1,248,126,306,306,179,791
355030842000225,1,37,15,28,28,18,74
355030842000226,1,220,66,276,276,67,619
355030842000228,1,150,54,89,89,33,211
355030842000229,1,627,274,695,695,338,1728
355030842000230,8,0,0,0,0,0,0
355030842000231,8,23,11,15,15,14,44
355030842000233,1,183,49,265,265,85,615
355030842000234,2,2,0,3,3,1,7
355030842000235,1,0,0,0,0,0,0
355030842000237,2,0,0,4,4,1,9
355030842000239,1,122,38,166,166,50,382
355030842000240,1,148,78,216,216,171,603
355030842000243,2,3,2,1,1,5,7
355030842000245,1,169,47,41,41,15,97
355030842000246,8,4,3,5,5,6,16
355030842000247,1,265,82,164,164,59,387
355030842000248,4,13,10,14,14,23,51
355030842000249,4,10,8,10,10,13,33
355030842000258,1,0,0,1,1,0,2
355030842000259,8,0,0,0,0,0,0
355030842000260,1,250,94,236,236,134,606
355030842000261,4,155,48,119,119,47,285
355030842000262,4,119,47,106,106,40,252
355030842000265,1,2,3,3,3,5,11
355030842000266,1,99,60,87,87,94,268
355030842000267,2,419,131,345,345,128,818
355030842000268,2,543,223,513,513,172,1198
355030842000269,2,385,122,393,393,144,930
355030842000270,1,116,46,101,101,53,255
355030842000271,1,195,78,217,217,206,640
355030842000272,1,623,207,467,467,175,1109
355030842000273,1,677,233,432,432,213,1077
355030842000274,1,410,206,336,336,128,800
355030842000275,1,88,31,87,87,23,197
355030842000276,1,17,3,10,10,7,27
355030842000277,1,229,113,192,192,132,516
355030842000278,1,38,19,34,34,16,84
355030842000279,1,63,23,55,55,13,123
355030842000280,1,106,75,146,146,80,372
355030842000281,1,110,27,94,94,22,210
355030842000282,1,13,8,16,16,6,38
355030842000283,1,100,37,91,91,50,232
355030842000284,1,10,7,12,12,2,26
355030842000285,1,116,65,123,123,62,308
355030842000287,1,29,15,39,39,17,95
355030842000288,1,243,97,203,203,76,482
355030842000289,1,204,102,216,216,143,575
355030842000290,1,235,90,167,167,103,437
355030843000001,1,177,82,178,178,122,478
355030843000002,1,156,70,143,143,122,408
355030843000003,1,253,130,268,268,110,646
355030843000004,1,58,26,70,70,34,174
355030843000005,1,100,41,111,111,95,317
355030843000006,1,323,151,311,311,131,753
355030843000007,1,165,66,152,152,112,416
355030843000008,1,162,93,184,184,92,460
355030843000009,1,124,45,129,129,87,345
355030843000010,1,144,60,111,111,85,307
355030843000011,1,131,69,142,142,103,387
355030843000012,1,59,36,69,69,57,195
355030843000013,1,48,32,48,48,34,130
355030843000014,1,119,60,121,121,123,365
355030843000015,1,169,68,167,167,124,458
355030843000016,1,150,74,139,139,98,376
355030843000017,1,125,41,141,141,55,337
355030843000018,1,143,67,136,136,57,329
355030843000019,1,113,42,103,103,38,244
355030843000020,1,164,84,147,147,83,377
355030843000021,1,256,118,299,299,98,696
355030843000022,1,116,51,102,102,67,271
355030843000023,1,170,95,197,197,135,529
355030843000024,1,80,46,101,101,56,258
355030843000025,1,227,123,278,278,148,704
355030843000026,1,138,83,138,138,93,369
355030843000027,1,155,78,142,142,86,370
355030843000028,1,369,169,392,392,160,944
355030843000029,1,36,25,29,29,20,78
355030843000030,1,259,109,243,243,107,593
355030843000031,1,119,56,118,118,78,314
355030843000032,1,225,75,242,242,132,616
355030843000033,1,150,78,156,156,80,392
355030843000034,1,220,91,255,255,151,661
355030843000035,1,92,54,99,99,54,252
355030843000036,1,197,83,189,189,137,515
355030843000037,1,90,59,90,90,85,265
355030843000038,1,132,52,140,140,93,373
355030843000039,1,257,87,278,278,88,644
355030843000040,1,215,100,196,196,105,497
355030843000041,1,192,95,223,223,97,543
355030843000042,1,130,61,132,132,53,317
355030843000043,1,126,66,88,88,66,242
355030843000044,1,43,24,41,41,7,89
355030843000045,1,86,42,87,87,67,241
355030843000046,1,66,29,83,83,19,185
355030843000047,1,61,22,76,76,50,202
355030843000048,1,107,51,110,110,56,276
355030843000049,1,235,97,231,231,128,590
355030843000050,1,292,122,283,283,143,709
355030843000051,1,5,5,4,4,4,12
355030843000052,1,324,162,313,313,121,747
355030843000053,1,203,85,224,224,144,592
355030843000054,1,111,52,122,122,63,307
355030843000055,1,123,62,130,130,63,323
355030843000056,1,264,117,233,233,144,610
355030843000057,1,152,83,160,160,80,400
355030843000058,1,83,39,83,83,59,225
355030843000059,1,264,118,271,271,156,698
355030843000060,1,412,184,367,367,244,978
355030843000061,1,137,80,195,195,145,535
355030843000062,1,108,65,150,150,110,410
355030843000063,1,215,125,261,261,177,699
355030843000064,1,168,88,186,186,125,497
355030843000065,1,157,100,248,248,151,647
355030843000066,1,71,50,88,88,49,225
355030843000067,1,165,51,186,186,115,487
355030843000068,1,94,55,89,89,69,247
355030843000069,1,96,65,115,115,77,307
355030843000070,1,71,38,77,77,65,219
355030843000071,1,210,87,212,212,127,551
355030843000072,1,340,180,375,375,223,973
355030843000073,1,434,170,373,373,137,883
355030843000074,1,309,164,341,341,143,825
355030843000075,1,334,182,308,308,154,770
355030843000076,1,230,93,187,187,98,472
355030843000077,1,174,100,161,161,105,427
355030843000078,1,107,50,79,79,36,194
355030843000079,1,251,167,292,292,213,797
355030843000080,1,219,95,226,226,126,578
355030843000081,1,158,79,181,181,132,494
355030843000082,1,195,111,217,217,128,562
355030843000083,1,83,25,121,121,58,300
355030843000084,1,153,81,211,211,140,562
355030843000085,1,274,123,271,271,168,710
355030843000086,1,358,166,308,308,158,774
355030843000087,1,596,226,523,523,290,1336
355030843000088,1,370,164,306,306,142,754
355030843000089,1,192,90,216,216,127,559
355030843000090,1,45,14,39,39,21,99
355030843000091,1,217,112,255,255,165,675
355030843000092,1,112,35,122,122,52,296
355030843000093,1,82,50,119,119,68,306
355030843000094,1,256,126,220,220,127,567
355030843000095,1,220,73,172,172,87,431
355030843000096,1,220,125,231,231,73,535
355030843000097,1,617,217,574,574,305,1453
355030843000098,1,264,113,318,318,138,774
355030843000099,1,92,55,94,94,64,252
355030843000100,1,382,174,298,298,148,744
355030843000101,1,276,141,270,270,146,686
355030843000102,1,290,143,298,298,136,732
355030843000103,1,641,249,554,554,238,1346
355030843000104,1,200,78,162,162,72,396
355030843000105,1,150,79,175,175,114,464
355030843000106,1,140,75,142,142,152,436
355030843000107,1,142,54,160,160,124,444
355030843000108,1,88,40,72,72,53,197
355030843000109,1,179,87,220,220,125,565
355030843000110,1,148,64,189,189,114,492
355030843000111,1,100,72,135,135,133,403
355030843000112,1,11,10,24,24,28,76
355030843000113,1,85,37,94,94,66,254
355030843000114,1,224,124,247,247,135,629
355030843000115,1,159,75,190,190,135,515
355030843000116,1,135,47,130,130,57,317
355030843000117,1,286,119,262,262,137,661
355030843000118,1,141,67,120,120,48,288
355030843000119,1,281,173,248,248,142,638
355030843000120,1,360,174,371,371,166,908
355030843000121,1,255,94,261,261,149,671
355030843000122,1,252,90,239,239,69,547
355030843000123,1,202,87,181,181,103,465
355030843000124,1,113,47,114,114,52,280
355030843000125,1,159,67,196,196,117,509
355030843000126,1,273,100,270,270,143,683
355030843000127,1,182,75,190,190,103,483
355030843000128,1,216,91,236,236,115,587
355030843000129,1,325,164,377,377,249,1003
355030843000130,1,301,135,306,306,166,778
355030843000131,1,114,60,111,111,70,292
355030843000132,1,233,125,337,337,171,845
355030843000133,1,200,105,214,214,143,571
355030843000134,1,161,68,145,145,70,360
355030843000135,1,202,90,175,175,62,412
355030843000136,1,178,111,193,193,107,493
355030843000137,1,194,89,246,246,123,615
355030843000138,1,185,88,146,146,97,389
355030843000139,1,149,55,165,165,118,448
355030843000140,1,296,146,298,298,159,755
355030843000141,1,124,48,159,159,106,424
355030843000142,1,226,107,210,210,100,520
355030843000143,1,293,135,316,316,138,770
355030843000144,1,399,180,489,489,194,1172
355030843000145,1,191,80,207,207,117,531
355030843000146,1,226,106,247,247,145,639
355030843000147,1,175,95,206,206,86,498
355030843000148,1,63,26,71,71,46,188
355030843000149,1,134,58,168,168,93,429
355030843000150,1,220,93,262,262,155,679
355030843000151,1,42,13,29,29,19,77
355030843000152,1,125,72,165,165,84,414
355030843000153,1,240,121,203,203,129,535
355030843000154,1,225,107,289,289,167,745
355030843000155,1,191,75,233,233,104,570
355030843000156,1,241,106,254,254,127,635
355030843000157,1,307,134,340,340,189,869
355030843000158,1,191,101,216,216,142,574
355030843000159,1,133,58,137,137,93,367
355030843000160,1,208,107,226,226,121,573
355030843000161,1,84,47,99,99,70,268
355030843000162,1,315,130,311,311,146,768
355030843000163,1,259,138,279,279,188,746
355030843000164,1,140,66,133,133,117,383
355030843000165,1,130,72,149,149,96,394
355030843000166,1,64,23,86,86,42,214
355030843000167,1,298,138,337,337,104,778
355030843000168,1,301,137,288,288,119,695
355030843000169,1,73,38,97,97,70,264
355030843000170,1,194,107,251,251,158,660
355030843000171,1,226,101,264,264,152,680
355030843000172,1,141,77,143,143,98,384
355030843000173,1,142,70,163,163,93,419
355030843000174,1,201,92,256,256,171,683
355030843000175,1,99,46,128,128,78,334
355030843000176,1,113,54,128,128,103,359
355030843000177,1,108,64,129,129,70,328
355030843000178,1,115,59,107,107,38,252
355030843000179,1,204,100,231,231,144,606
355030843000180,1,158,78,197,197,119,513
355030843000181,1,117,54,133,133,108,374
355030843000182,1,227,106,324,324,128,776
355030843000183,1,264,123,371,371,157,899
355030843000184,1,273,120,273,273,146,692
355030843000185,1,315,136,265,265,190,720
355030843000186,1,143,82,151,151,114,416
355030843000187,1,100,48,127,127,85,339
355030843000188,1,109,60,129,129,95,353
355030843000189,1,91,38,111,111,74,296
355030843000190,1,134,79,169,169,110,448
355030843000191,1,116,80,169,169,124,462
355030843000192,1,84,52,124,124,74,322
355030843000193,1,132,61,137,137,64,338
355030843000194,1,236,119,218,218,95,531
355030843000195,1,145,79,196,196,105,497
355030843000196,1,160,84,217,217,142,576
355030843000197,1,135,82,197,197,120,514
355030843000198,1,219,99,205,205,110,520
355030843000199,1,46,36,59,59,45,163
355030843000200,1,302,139,284,284,171,739
355030843000201,1,141,67,164,164,109,437
355030843000202,1,101,50,123,123,51,297
355030843000203,1,242,112,259,259,129,647
355030843000204,1,101,40,84,84,45,213
355030843000205,1,122,47,177,177,122,476
355030843000206,1,100,51,128,128,81,337
355030843000207,1,276,133,256,256,98,610
355030843000208,1,165,73,190,190,117,497
355030843000209,1,90,49,145,145,89,379
355030843000210,1,182,88,195,195,148,538
355030843000211,1,115,64,141,141,101,383
355030843000212,1,182,89,178,178,133,489
355030843000213,1,184,84,209,209,173,591
355030843000214,1,252,93,265,265,202,732
355030843000215,1,260,122,266,266,135,667
355030843000216,1,386,181,391,391,232,1014
355030843000217,1,150,56,121,121,51,293
355030843000218,1,281,133,269,269,100,638
355030843000219,1,152,54,132,132,80,344
355030843000220,1,274,111,274,274,163,711
355030843000221,1,237,128,279,279,110,668
355030843000222,1,196,102,183,183,102,468
355030843000223,1,403,186,353,353,183,889
355030843000224,1,301,105,291,291,142,724
355030843000225,1,80,29,66,66,51,183
355030843000226,1,846,153,337,337,155,829
355030843000227,1,199,96,193,193,111,497
355030843000228,1,140,61,151,151,96,398
355030843000229,1,171,78,180,180,113,473
355030843000230,1,99,39,86,86,43,215
355030843000231,1,163,75,125,125,63,313
355030843000232,1,184,102,220,220,110,550
355030843000233,1,207,94,199,199,143,541
355030843000234,8,63,24,70,70,48,188
355030843000235,2,60,23,46,46,29,121
355030843000236,1,140,64,136,136,51,323
355030843000237,1,558,189,463,463,164,1090
355030843000238,1,740,209,483,483,228,1194
355030843000239,1,308,119,267,267,85,619
355030843000240,1,557,196,499,499,160,1158
355030843000241,1,86,69,121,121,66,308
355030843000242,1,58,14,53,53,31,137
355030843000243,1,457,146,377,377,139,893
355030843000244,1,121,39,85,85,42,212
355030843000245,1,432,155,385,385,101,871
355030843000246,1,96,43,95,95,34,224
355030843000247,1,285,91,212,212,43,467
355030843000248,1,205,80,185,185,68,438
355030843000249,1,138,41,107,107,43,257
355030843000250,1,94,47,93,93,14,200
355030843000251,1,136,46,109,109,50,268
355030843000252,1,73,40,72,72,28,172
355030843000253,1,174,108,133,133,79,345
355030843000254,1,509,229,444,444,178,1066
355030843000255,1,128,35,73,73,44,190
355030843000256,2,130,35,103,103,44,250
355030843000257,1,78,35,67,67,54,188
355030843000258,1,144,55,133,133,54,320
355030843000259,1,229,99,227,227,98,552
355030843000260,1,396,196,360,360,251,971
355030843000261,1,289,106,252,252,197,701
355030843000262,2,104,46,76,76,44,196
355030843000263,1,355,157,315,315,164,794
355030843000264,1,568,265,506,506,299,1311
355030843000265,1,159,83,134,134,141,409
355030843000266,1,135,58,118,118,83,319
355030843000267,1,137,60,111,111,99,321
355030843000268,1,232,96,197,197,120,514
355030843000269,1,466,158,330,330,155,815
355030843000270,1,550,207,475,475,192,1142
355030843000271,1,66,30,66,66,37,169
355030843000272,1,305,161,273,273,172,718
355030843000273,1,291,174,326,326,150,802
355030843000274,1,404,154,318,318,94,730
355030843000275,1,201,82,189,189,74,452
355030843000276,1,149,65,162,162,133,457
355030843000277,1,218,78,179,179,73,431
355030843000278,1,158,76,171,171,94,436
355030843000279,1,123,58,140,140,86,366
355030843000280,1,145,71,142,142,76,360
355030843000281,1,111,36,101,101,66,268
355030843000282,1,137,68,111,111,58,280
355030843000283,1,186,101,176,176,88,440
355030843000284,1,586,208,516,516,191,1223
355030843000285,1,408,202,404,404,161,969
355030843000286,1,175,83,190,190,112,492
355030843000287,1,276,110,252,252,143,647
355030843000288,1,144,69,165,165,110,440
355030843000289,1,93,72,110,110,96,316
355030843000290,1,93,51,106,106,77,289
355030843000291,1,239,100,183,183,114,480
355030843000292,1,513,211,468,468,182,1118
355030843000293,1,247,123,230,230,106,566
355030843000294,1,125,56,138,138,100,376
355030843000295,1,154,91,126,126,78,330
355030843000296,1,118,54,141,141,68,350
355030843000297,1,149,60,143,143,66,352
355030843000298,1,251,92,237,237,123,597
355030843000299,1,157,95,176,176,98,450
355030843000300,1,311,137,296,296,161,753
355030843000301,1,222,107,192,192,115,499
355030843000302,1,232,98,232,232,124,588
355030843000303,1,277,125,278,278,137,693
355030843000304,3,211,102,225,225,140,590
355030843000305,1,338,149,289,289,145,723
355030843000306,4,246,113,230,230,100,560
355030843000307,1,75,37,56,56,27,139
355030843000308,1,184,81,166,166,90,422
355030843000309,1,169,71,177,177,75,429
355030843000310,1,68,35,83,83,37,203
355030843000311,1,198,84,179,179,82,440
355030843000312,1,312,107,260,260,83,603
355030843000313,8,20,5,17,17,9,43
355030843000314,8,296,104,257,257,97,611
355030843000315,8,85,30,70,70,35,175
355030843000317,8,47,21,52,52,39,143
355030843000318,8,0,0,0,0,0,0
355030843000319,8,35,17,42,42,30,114
355030843000320,8,42,13,38,38,14,90
355030843000321,1,87,38,83,83,74,240
355030843000322,8,0,0,0,0,0,0
355030843000323,8,29,8,26,26,14,66
355030843000324,1,526,189,418,418,149,985
355030843000325,8,50,34,60,60,34,154
355030843000326,8,0,0,0,0,0,0
355030843000327,8,132,34,121,121,44,286
355030843000328,8,116,45,103,103,31,237
355030843000329,4,213,97,221,221,97,539
355030843000330,8,36,15,34,34,17,85
355030843000332,8,26,11,19,19,13,51
355030843000334,8,89,46,92,92,72,256
355030843000335,4,20,6,14,14,13,41
355030843000336,8,35,20,39,39,38,116
355030843000337,8,17,15,20,20,16,56
355030843000338,1,52,13,33,33,11,77
355030843000340,1,19,5,15,15,9,39
355030843000343,1,59,23,64,64,17,145
355030843000344,1,30,14,36,36,10,82
355030843000345,1,55,27,76,76,27,179
355030843000346,1,13,6,20,20,4,44
355030843000348,1,90,29,74,74,55,203
355030843000349,1,26,6,25,25,6,56
355030843000350,1,51,26,47,47,47,141
355030843000351,1,18,4,7,7,9,23
355030843000352,1,38,29,43,43,15,101
355030843000353,1,242,118,217,217,114,548
355030843000354,1,89,58,103,103,78,284
355030843000355,1,41,14,41,41,8,90
355030843000356,1,26,10,20,20,13,53
355030843000357,1,65,23,64,64,25,153
355030843000358,1,202,99,184,184,90,458
355030843000359,1,395,144,316,316,140,772
355030843000360,1,232,109,247,247,118,612
355030843000361,1,38,29,48,48,22,118
355030843000362,1,214,102,201,201,116,518
355030843000363,1,129,41,104,104,61,269
355030843000364,1,21,10,32,32,11,75
355030843000365,1,26,11,25,25,20,70
355030843000366,1,25,13,31,31,18,80
355030843000367,1,110,45,105,105,50,260
355030843000368,1,271,100,212,212,125,549
355030843000369,1,531,201,436,436,156,1028
355030843000370,1,86,40,77,77,35,189
355030843000371,1,28,12,30,30,16,76
355030843000372,1,95,63,125,125,70,320
355030843000373,1,59,30,57,57,37,151
355030843000374,1,255,100,279,279,131,689
355030843000375,1,39,7,39,39,25,103
355030843000376,1,84,58,73,73,64,210
355030843000377,1,53,28,42,42,21,105
355030843000378,1,64,38,83,83,38,204
355030843000379,1,35,16,30,30,19,79
355030843000380,1,34,21,31,31,21,83
355030843000381,1,19,10,18,18,10,46
355030843000382,1,58,30,72,72,36,180
355030843000383,1,207,76,137,137,108,382
355030843000384,1,41,25,31,31,23,85
355030843000385,1,30,17,28,28,31,87
355030843000386,1,151,65,150,150,70,370
355030843000387,1,91,62,99,99,63,261
355030843000388,1,47,26,33,33,19,85
355030843000389,1,74,26,72,72,30,174
355030843000390,1,28,10,34,34,26,94
355030843000391,1,88,41,88,88,38,214
355030843000392,1,83,29,67,67,51,185
355030843000393,1,24,12,32,32,31,95
355030843000394,1,90,48,82,82,40,204
355030843000395,1,66,18,61,61,26,148
355030843000396,1,40,14,36,36,24,96
355030843000397,1,94,41,99,99,65,263
355030843000398,1,127,56,133,133,53,319
355030843000399,1,41,17,40,40,25,105
355030843000400,1,130,69,124,124,82,330
355030843000401,1,80,32,104,104,34,242
355030843000402,1,80,43,74,74,50,198
355030843000403,1,70,25,75,75,52,202
355030843000404,1,53,11,47,47,12,106
355030843000405,1,116,39,64,64,29,157
355030843000406,1,129,53,117,117,61,295
355030843000407,1,9,3,6,6,7,19
355030843000408,1,65,35,52,52,41,145
355030843000409,1,197,80,171,171,65,407
355030843000410,1,36,23,40,40,17,97
355030843000411,1,478,224,416,416,158,990
355030843000412,1,68,21,52,52,28,132
355030843000413,1,96,29,68,68,13,149
355030844000001,1,115,48,127,127,78,332
355030844000002,1,114,34,103,103,63,269
355030844000003,1,114,65,117,117,71,305
355030844000004,1,62,32,64,64,67,195
355030844000005,1,149,57,157,157,76,390
355030844000006,1,146,56,166,166,104,436
355030844000007,1,129,58,133,133,97,363
355030844000008,1,145,58,150,150,104,404
355030844000009,1,93,43,107,107,56,270
355030844000010,1,52,36,47,47,51,145
355030844000011,1,96,55,92,92,92,276
355030844000012,1,98,51,93,93,55,241
355030844000013,1,155,51,134,134,89,357
355030844000014,1,108,39,106,106,71,283
355030844000015,1,107,70,103,103,77,283
355030844000016,1,136,60,155,155,83,393
355030844000017,1,109,38,133,133,99,365
355030844000018,1,172,95,183,183,117,483
355030844000019,1,128,54,146,146,100,392
355030844000020,1,112,67,134,134,78,346
355030844000021,1,184,85,201,201,114,516
355030844000022,4,96,37,88,88,84,260
355030844000023,4,115,61,112,112,64,288
355030844000024,1,130,63,113,113,64,290
355030844000025,1,182,103,158,158,71,387
355030844000026,1,142,60,114,114,54,282
355030844000027,1,175,87,145,145,67,357
355030844000028,1,179,87,174,174,93,441
355030844000029,1,224,123,200,200,108,508
355030844000030,1,204,111,189,189,88,466
355030844000031,1,131,76,105,105,60,270
355030844000032,1,163,83,146,146,96,388
355030844000033,4,193,92,192,192,117,501
355030844000034,1,93,49,86,86,67,239
355030844000035,1,152,78,151,151,109,411
355030844000036,1,267,120,268,268,171,707
355030844000037,1,96,57,150,150,79,379
355030844000038,1,185,91,182,182,139,503
355030844000039,1,88,43,99,99,65,263
355030844000040,1,127,72,144,144,116,404
355030844000041,1,229,96,208,208,127,543
355030844000042,1,195,93,189,189,159,537
355030844000043,1,91,49,94,94,90,278
355030844000044,1,93,39,113,113,88,314
355030844000045,4,223,104,218,218,110,546
355030844000046,1,149,68,153,153,105,411
355030844000047,1,163,86,164,164,140,468
355030844000048,1,170,77,157,157,107,421
355030844000049,1,110,59,130,130,81,341
355030844000050,1,197,96,247,247,161,655
355030844000051,1,126,67,135,135,81,351
355030844000052,1,110,60,109,109,99,317
355030844000053,1,145,49,148,148,92,388
355030844000054,1,178,83,219,219,139,577
355030844000055,1,58,36,73,73,79,225
355030844000056,1,169,95,179,179,185,543
355030844000057,1,160,85,167,167,91,425
355030844000058,1,134,64,150,150,87,387
355030844000059,1,178,80,196,196,112,504
355030844000060,1,151,91,154,154,147,455
355030844000061,1,76,56,125,125,97,347
355030844000062,1,154,82,180,180,162,522
355030844000063,4,364,143,259,259,107,625
355030844000064,4,261,138,215,215,101,531
355030844000065,1,127,55,91,91,51,233
355030844000066,1,152,57,128,128,58,314
355030844000067,1,147,75,173,173,100,446
355030844000068,1,162,69,172,172,94,438
355030844000069,1,133,52,150,150,98,398
355030844000070,1,134,62,120,120,79,319
355030844000071,1,104,59,138,138,97,373
355030844000072,1,69,39,60,60,48,168
355030844000073,1,149,95,123,123,110,356
355030844000074,1,97,54,109,109,67,285
355030844000075,1,192,97,168,168,86,422
355030844000076,1,144,49,151,151,99,401
355030844000077,1,264,113,254,254,180,688
355030844000078,1,157,78,175,175,148,498
355030844000079,1,102,68,140,140,130,410
355030844000080,4,484,211,447,447,185,1079
355030844000081,1,377,151,359,359,158,876
355030844000082,1,158,50,87,87,48,222
355030844000083,1,228,74,155,155,53,363
355030844000084,1,82,34,65,65,28,158
355030844000085,1,280,98,190,190,78,458
355030844000086,1,188,113,202,202,143,547
355030844000087,1,171,79,179,179,116,474
355030844000088,1,150,87,194,194,134,522
355030844000089,1,122,38,116,116,63,295
355030844000090,1,193,89,221,221,149,591
355030844000091,1,221,104,269,269,172,710
355030844000092,1,116,64,160,160,89,409
355030844000093,1,148,61,124,124,97,345
355030844000094,1,90,60,117,117,118,352
355030844000095,1,203,103,229,229,158,616
355030844000096,1,120,61,128,128,116,372
355030844000097,1,72,40,95,95,80,270
355030844000098,1,138,55,170,170,133,473
355030844000099,1,108,81,126,126,124,376
355030844000100,1,218,65,210,210,123,543
355030844000101,1,86,35,66,66,39,171
355030844000102,1,229,125,259,259,147,665
355030844000103,1,80,44,83,83,74,240
355030844000104,1,121,68,133,133,82,348
355030844000105,1,137,69,143,143,98,384
355030844000106,1,133,55,133,133,90,356
355030844000107,1,187,72,222,222,167,611
355030844000108,1,133,56,138,138,120,396
355030844000109,1,152,86,167,167,179,513
355030844000110,1,167,76,165,165,117,447
355030844000111,1,104,61,140,140,127,407
355030844000112,1,130,61,153,153,107,413
355030844000113,1,72,27,88,88,74,250
355030844000115,1,224,96,227,227,88,542
355030844000116,1,161,70,156,156,91,403
355030844000117,1,40,24,51,51,30,132
355030844000118,1,236,116,239,239,133,611
355030844000119,1,138,69,157,157,133,447
355030844000120,1,150,99,184,184,159,527
355030844000121,4,10,12,19,19,21,59
355030844000122,8,50,23,40,40,21,101
355030844000123,4,85,38,92,92,57,241
355030844000124,1,347,179,338,338,122,798
355030844000125,1,82,55,110,110,97,317
355030844000126,4,344,146,296,296,146,738
355030844000127,4,217,105,197,197,130,524
355030844000128,1,72,31,50,50,29,129
355030844000129,1,179,74,158,158,83,399
355030844000130,1,248,103,274,274,147,695
355030844000131,1,182,100,180,180,130,490
355030844000132,1,187,70,169,169,90,428
355030844000133,4,74,43,63,63,45,171
355030844000134,1,113,53,93,93,61,247
355030844000135,1,163,79,152,152,99,403
355030844000136,1,205,76,202,202,114,518
355030844000138,4,280,162,545,545,144,1234
355030844000139,4,183,94,176,176,71,423
355030844000140,4,101,50,88,88,49,225
355030844000141,1,106,50,80,80,70,230
355030844000142,1,271,106,208,208,105,521
355030844000143,1,225,68,171,171,87,429
355030844000144,1,203,106,189,189,117,495
355030844000145,1,150,86,157,157,149,463
355030844000146,1,92,48,108,108,71,287
355030844000147,1,180,72,132,132,71,335
355030844000148,1,119,58,100,100,78,278
355030844000149,1,140,69,108,108,73,289
355030844000150,1,34,13,37,37,7,81
355030844000151,1,118,47,112,112,60,284
355030844000152,1,192,78,189,189,110,488
355030844000153,1,222,93,200,200,96,496
355030844000154,1,157,72,137,137,108,382
355030844000155,1,88,39,125,125,78,328
355030844000156,1,105,86,138,138,122,398
355030844000157,1,250,72,252,252,109,613
355030844000158,4,43,13,39,39,19,97
355030844000159,1,203,105,210,210,120,540
355030844000160,1,203,90,219,219,139,577
355030844000161,1,111,49,117,117,86,320
355030844000162,4,26,22,27,27,15,69
355030844000163,1,149,63,152,152,122,426
355030844000164,4,77,32,57,57,42,156
355030844000165,1,197,72,181,181,112,474
355030844000166,4,160,89,132,132,60,324
355030844000167,1,111,45,128,128,74,330
355030844000168,1,325,157,298,298,236,832
355030844000169,1,197,99,209,209,143,561
355030844000170,1,105,67,127,127,64,318
355030844000171,1,156,88,121,121,58,300
355030844000172,1,178,93,191,191,120,502
355030844000173,1,147,74,135,135,74,344
355030844000174,1,137,57,129,129,77,335
355030844000175,1,88,46,117,117,78,312
355030844000176,1,115,49,78,78,48,204
355030844000177,1,92,46,99,99,92,290
355030844000178,4,32,29,43,43,30,116
355030844000179,1,146,60,129,129,102,360
355030844000180,4,40,23,33,33,29,95
355030844000181,1,234,133,227,227,195,649
355030844000182,1,0,0,0,0,0,0
355030844000183,4,49,19,50,50,19,119
355030844000184,4,41,25,30,30,11,71
355030844000185,1,117,41,99,99,58,256
355030844000186,4,51,21,48,48,40,136
355030844000187,1,41,17,31,31,14,76
355030844000188,1,176,93,141,141,104,386
355030844000189,4,202,81,184,184,76,444
355030844000190,1,146,60,159,159,64,382
355030844000191,1,124,67,104,104,79,287
355030844000192,1,59,40,38,38,35,111
355030844000193,4,100,53,79,79,56,214
355030844000194,1,34,16,26,26,12,64
355030844000195,1,227,109,243,243,132,618
355030844000196,1,99,46,83,83,54,220
355030844000197,4,36,26,41,41,28,110
355030844000198,1,59,20,40,40,46,126
355030844000199,4,73,46,101,101,56,258
355030844000200,4,106,54,128,128,51,307
355030844000201,1,83,32,99,99,91,289
355030844000202,1,99,38,112,112,81,305
355030844000203,1,72,53,103,103,79,285
355030844000204,1,52,16,42,42,18,102
355030844000205,1,31,15,50,50,32,132
355030844000206,1,220,75,143,143,77,363
355030844000207,1,133,48,120,120,66,306
355030844000208,4,53,28,51,51,19,121
355030844000209,4,36,18,32,32,29,93
355030844000210,1,19,10,18,18,11,47
355030844000211,1,27,10,18,18,10,46
355030844000212,1,0,0,0,0,0,0
355030844000214,1,201,140,143,143,124,410
355030844000215,1,146,58,147,147,56,350
355030844000216,1,161,45,193,193,75,461
355030844000217,1,106,50,104,104,88,296
355030844000218,1,37,20,36,36,17,89
355030844000219,1,249,106,196,196,130,522
355030844000220,1,132,66,110,110,73,293
355030844000221,1,76,37,73,73,25,171
355030844000222,1,150,44,116,116,42,274
355030844000223,1,29,25,33,33,20,86
355030844000224,1,80,28,63,63,33,159
355030845000001,1,45,24,119,119,112,350
355030845000002,1,36,12,84,84,74,242
355030845000003,1,69,26,100,100,93,293
355030845000004,1,34,24,108,108,74,290
355030845000005,1,59,38,112,112,148,372
355030845000006,1,59,44,150,150,129,429
355030845000007,1,36,25,83,83,110,276
355030845000008,1,49,23,101,101,92,294
355030845000009,1,42,13,78,78,76,232
355030845000010,1,36,26,75,75,102,252
355030845000011,1,55,35,117,117,131,365
355030845000012,1,22,19,73,73,53,199
355030845000013,1,54,30,138,138,95,371
355030845000014,1,32,12,62,62,67,191
355030845000015,1,59,37,139,139,117,395
355030845000016,1,88,37,91,91,112,294
355030845000017,1,58,30,97,97,93,287
355030845000018,1,71,53,132,132,158,422
355030845000019,1,42,24,88,88,56,232
355030845000020,1,43,23,121,121,136,378
355030845000021,1,63,34,93,93,75,261
355030845000022,1,36,25,86,86,97,269
355030845000023,1,32,12,82,82,80,244
355030845000024,1,67,30,171,171,124,466
355030845000025,1,36,19,96,96,81,273
355030845000026,1,28,14,49,49,39,137
355030845000027,1,19,16,53,53,60,166
355030845000028,1,15,14,66,66,58,190
355030845000029,1,43,31,120,120,112,352
355030845000030,1,23,15,55,55,59,169
355030845000031,1,25,15,78,78,69,225
355030845000032,1,85,30,159,159,144,462
355030845000033,1,52,42,136,136,143,415
355030845000034,1,64,41,142,142,106,390
355030845000035,1,19,26,78,78,69,225
355030845000036,1,62,33,113,113,123,349
355030845000037,1,36,32,94,94,97,285
355030845000038,1,18,12,85,85,47,217
355030845000039,1,55,28,131,131,129,391
355030845000040,1,10,12,59,59,39,157
355030845000041,1,14,16,84,84,74,242
355030845000042,1,60,31,103,103,109,315
355030845000043,1,76,41,157,157,155,469
355030845000044,1,59,33,179,179,104,462
355030845000045,1,129,73,204,204,228,636
355030845000046,1,59,23,127,127,106,360
355030845000047,1,41,24,71,71,87,229
355030845000048,1,56,27,78,78,105,261
355030845000049,1,8,13,71,71,57,199
355030845000050,1,36,28,113,113,128,354
355030845000051,1,65,29,125,125,152,402
355030845000052,1,50,40,117,117,143,377
355030845000053,1,4,24,81,81,30,192
355030845000054,1,37,34,93,93,89,275
355030845000055,1,19,27,78,78,84,240
355030845000056,1,41,31,134,134,116,384
355030845000057,1,64,51,114,114,145,373
355030845000058,1,64,27,100,100,87,287
355030845000059,1,13,18,39,39,38,116
355030845000060,1,51,29,81,81,87,249
355030845000061,1,45,31,90,90,100,280
355030845000062,1,43,48,125,125,139,389
355030845000063,1,18,20,85,85,61,231
355030845000064,1,47,32,130,130,139,399
355030845000065,1,31,23,52,52,81,185
355030845000066,1,40,37,225,225,175,625
355030845000067,1,8,6,15,15,17,47
355030845000068,1,14,15,83,83,46,212
355030845000069,1,66,38,185,185,149,519
355030845000070,1,89,54,143,143,168,454
355030845000071,1,88,21,152,152,107,411
355030845000072,1,25,10,40,40,39,119
355030845000073,1,72,16,119,119,92,330
355030845000074,1,72,47,136,136,120,392
355030845000075,1,68,41,167,167,140,474
355030845000076,1,15,14,67,67,62,196
355030845000077,1,35,34,107,107,111,325
355030845000078,1,28,23,65,65,97,227
355030845000079,1,59,25,122,122,120,364
355030845000080,1,26,16,93,93,90,276
355030845000081,1,38,30,131,131,123,385
355030845000082,1,67,35,130,130,128,388
355030845000083,1,62,26,88,88,108,284
355030845000084,1,17,24,83,83,68,234
355030845000085,1,30,11,77,77,52,206
355030845000086,1,22,8,96,96,92,284
355030845000087,1,39,21,108,108,103,319
355030845000088,1,26,25,89,89,66,244
355030845000089,1,22,19,129,129,78,336
355030845000090,1,21,17,74,74,45,193
355030845000091,1,27,26,94,94,77,265
355030845000092,1,31,28,106,106,89,301
355030845000093,1,29,33,124,124,82,330
355030845000094,1,16,11,52,52,45,149
355030845000095,1,34,27,90,90,125,305
355030845000096,1,15,28,87,87,58,232
355030845000097,1,22,40,123,123,93,339
355030845000098,1,28,46,89,89,104,282
355030845000099,1,12,18,86,86,52,224
355030845000100,1,7,9,43,43,47,133
355030845000101,1,35,21,104,104,73,281
355030845000102,1,8,14,59,59,72,190
355030845000103,1,37,32,146,146,77,369
355030845000104,1,49,31,109,109,83,301
355030845000105,1,61,12,133,133,108,374
355030845000106,1,39,21,86,86,56,228
355030845000107,1,27,19,100,100,59,259
355030845000108,1,49,22,92,92,77,261
355030845000109,1,56,26,79,79,104,262
355030845000110,1,39,21,105,105,79,289
355030845000111,1,57,19,119,119,99,337
355030845000112,1,40,21,115,115,94,324
355030845000113,1,85,42,144,144,145,433
355030845000114,1,25,32,75,75,80,230
355030845000115,1,48,38,167,167,139,473
355030845000116,1,31,38,88,88,112,288
355030845000117,1,31,33,135,135,93,363
355030845000118,1,33,25,83,83,96,262
355030845000119,1,40,24,113,113,82,308
355030845000120,1,21,22,55,55,67,177
355030845000121,1,30,37,116,116,97,329
355030845000122,1,34,21,98,98,84,280
355030845000123,1,34,28,91,91,105,287
355030845000124,1,61,60,121,121,124,366
355030845000125,1,3,1,10,10,1,21
355030845000126,1,11,21,101,101,53,255
355030845000127,1,46,23,98,98,98,294
355030845000128,1,35,33,105,105,111,321
355030845000129,1,14,9,59,59,27,145
355030845000130,1,44,28,102,102,79,283
355030845000131,1,56,28,161,161,157,479
355030845000132,1,20,15,50,50,58,158
355030845000133,1,43,26,120,120,81,321
355030845000134,1,69,27,137,137,108,382
355030845000135,1,35,18,107,107,83,297
355030845000136,1,20,13,65,65,51,181
355030845000137,1,17,19,58,58,43,159
355030845000138,1,55,28,107,107,109,323
355030845000139,1,38,25,163,163,74,400
355030845000140,1,50,24,137,137,96,370
355030845000141,1,37,26,132,132,100,364
355030845000142,1,28,17,68,68,58,194
355030845000143,1,17,4,78,78,41,197
355030845000144,1,22,23,80,80,64,224
355030845000145,1,27,29,139,139,90,368
355030845000146,1,20,33,99,99,43,241
355030845000147,1,28,28,104,104,77,285
355030845000148,1,26,27,131,131,83,345
355030845000149,1,11,12,50,50,37,137
355030845000150,1,34,22,56,56,48,160
355030845000151,1,3,17,60,60,30,150
355030845000152,1,16,37,93,93,89,275
355030845000153,1,27,17,127,127,49,303
355030845000154,1,33,16,63,63,66,192
355030845000155,1,19,57,92,92,83,267
355030845000156,1,9,12,47,47,26,120
355030845000157,1,41,51,135,135,100,370
355030845000158,1,57,31,127,127,102,356
355030845000159,1,21,19,100,100,71,271
355030845000160,1,54,22,103,103,100,306
355030845000161,1,26,27,111,111,81,303
355030845000162,1,38,42,126,126,139,391
355030845000163,1,42,32,144,144,143,431
355030845000164,1,20,13,102,102,62,266
355030845000165,1,26,17,104,104,71,279
355030845000166,1,42,23,62,62,79,203
355030845000167,1,43,36,167,167,143,477
355030845000168,1,9,3,19,19,15,53
355030845000169,1,19,12,88,88,53,229
355030845000170,1,34,36,117,117,91,325
355030845000171,1,15,15,62,62,50,174
355030845000172,1,56,34,65,65,74,204
355030845000173,1,9,18,72,72,60,204
355030845000174,1,27,23,99,99,86,284
355030845000175,1,40,40,92,92,86,270
355030845000176,1,36,16,84,84,54,222
355030845000177,1,25,20,131,131,80,342
355030845000178,1,2,24,101,101,38,240
355030845000179,1,6,15,70,70,27,167
355030845000180,1,8,6,100,100,33,233
355030845000181,1,52,22,81,81,81,243
355030845000182,1,32,12,111,111,52,274
355030845000183,1,34,18,91,91,88,270
355030845000184,1,30,19,87,87,66,240
355030845000185,1,12,21,47,47,62,156
355030845000186,1,29,22,66,66,70,202
355030845000187,1,16,17,86,86,50,222
355030845000188,1,12,18,84,84,78,246
355030845000189,1,21,11,122,122,34,278
355030845000190,1,29,16,83,83,85,251
355030845000191,1,27,20,76,76,95,247
355030845000192,1,9,7,45,45,33,123
355030845000193,1,51,26,95,95,77,267
355030845000194,1,0,10,28,28,10,66
355030845000195,1,43,36,81,81,97,259
355030845000196,1,23,25,76,76,85,237
355030845000197,1,13,7,45,45,27,117
355030845000198,1,62,36,140,140,121,401
355030845000199,1,2,7,54,54,16,124
355030845000200,1,36,28,106,106,83,295
355030845000201,1,29,27,75,75,75,225
355030845000203,1,31,14,62,62,58,182
355030845000204,1,9,26,55,55,33,143
355030845000205,1,30,27,72,72,118,262
355030845000206,1,34,34,131,131,69,331
355030845000207,1,11,20,70,70,46,186
355030845000208,1,15,6,69,69,55,193
355030845000209,1,1,9,49,49,41,139
355030845000210,1,24,19,175,175,65,415
355030845000211,1,25,28,64,64,79,207
355030845000212,1,37,19,120,120,72,312
355030845000213,1,28,41,169,169,57,395
355030845000214,1,14,27,104,104,63,271
355030845000215,1,35,34,112,112,87,311
355030846000001,1,172,96,267,267,162,696
355030846000002,1,141,75,137,137,111,385
355030846000003,1,419,184,407,407,201,1015
355030846000004,1,115,48,116,116,78,310
355030846000005,1,144,78,195,195,127,517
355030846000006,1,156,77,175,175,98,448
355030846000007,1,113,54,163,163,98,424
355030846000008,1,124,47,179,179,77,435
355030846000009,1,180,101,260,260,198,718
355030846000010,1,91,51,148,148,169,465
355030846000011,1,89,49,159,159,131,449
355030846000012,1,171,86,245,245,190,680
355030846000013,1,88,45,133,133,98,364
355030846000014,1,118,60,187,187,140,514
355030846000015,1,98,59,151,151,104,406
355030846000016,1,118,43,100,100,65,265
355030846000017,1,121,52,95,95,80,270
355030846000018,1,141,41,120,120,67,307
355030846000019,1,139,60,163,163,71,397
355030846000020,1,118,53,120,120,93,333
355030846000021,1,211,104,235,235,153,623
355030846000022,1,162,78,179,179,101,459
355030846000023,1,150,55,160,160,76,396
355030846000024,1,113,41,139,139,87,365
355030846000025,1,150,59,163,163,112,438
355030846000026,1,82,37,97,97,67,261
355030846000027,1,42,38,81,81,38,200
355030846000028,1,57,36,55,55,45,155
355030846000029,1,156,91,244,244,108,596
355030846000030,1,116,58,118,118,99,335
355030846000031,1,140,62,164,164,94,422
355030846000032,1,150,72,156,156,103,415
355030846000033,1,342,117,315,315,153,783
355030846000034,1,165,89,191,191,133,515
355030846000035,1,97,57,135,135,84,354
355030846000036,1,75,46,97,97,61,255
355030846000037,1,184,68,159,159,71,389
355030846000038,1,126,66,122,122,81,325
355030846000039,1,384,178,424,424,305,1153
355030846000040,1,267,135,304,304,217,825
355030846000041,1,198,101,227,227,154,608
355030846000042,1,70,40,100,100,60,260
355030846000043,1,343,155,261,261,117,639
355030846000044,1,57,20,75,75,56,206
355030846000045,1,163,72,236,236,139,611
355030846000046,1,120,64,115,115,57,287
355030846000047,1,199,116,269,269,143,681
355030846000048,1,97,46,115,115,118,348
355030846000049,1,100,47,171,171,111,453
355030846000050,1,96,74,139,139,125,403
355030846000051,1,198,70,300,300,115,715
355030846000052,1,79,56,135,135,99,369
355030846000053,1,189,109,251,251,153,655
355030846000054,1,52,23,69,69,31,169
355030846000055,1,118,78,138,138,79,355
355030846000056,1,194,111,242,242,141,625
355030846000057,1,240,107,259,259,107,625
355030846000058,1,124,73,167,167,76,410
355030846000059,1,96,61,132,132,83,347
355030846000060,1,82,49,89,89,38,216
355030846000061,1,110,49,107,107,133,347
355030846000062,1,192,66,221,221,109,551
355030846000063,1,276,117,232,232,79,543
355030846000064,1,201,82,191,191,92,474
355030846000065,1,78,39,81,81,34,196
355030846000066,1,221,82,173,173,82,428
355030846000067,1,173,83,144,144,71,359
355030846000068,1,133,73,192,192,107,491
355030846000069,1,96,37,143,143,74,360
355030846000070,1,23,11,40,40,19,99
355030846000071,1,67,31,111,111,71,293
355030846000072,1,154,65,158,158,107,423
355030846000073,1,67,44,87,87,57,231
355030846000074,1,81,34,128,128,70,326
355030846000075,1,123,73,130,130,107,367
355030846000076,1,122,54,159,159,93,411
355030846000077,1,138,46,144,144,107,395
355030846000079,1,147,75,165,165,105,435
355030846000080,1,115,62,167,167,114,448
355030846000081,1,106,51,122,122,52,296
355030846000082,1,157,68,161,161,87,409
355030846000083,1,326,141,333,333,178,844
355030846000084,1,150,76,143,143,70,356
355030846000085,1,161,72,197,197,78,472
355030846000086,1,113,38,102,102,61,265
355030846000087,1,108,69,139,139,88,366
355030846000088,1,193,102,249,249,125,623
355030846000089,1,75,40,108,108,58,274
355030846000090,1,211,120,260,260,168,688
355030846000091,1,165,107,200,200,113,513
355030846000092,1,200,124,232,232,161,625
355030846000093,1,158,67,182,182,96,460
355030846000094,1,109,76,142,142,133,417
355030846000095,1,107,76,128,128,142,398
355030846000096,1,102,60,141,141,119,401
355030846000097,1,174,102,190,190,157,537
355030846000098,1,34,11,60,60,22,142
355030846000099,1,438,182,428,428,193,1049
355030846000100,1,229,100,285,285,197,767
355030846000101,1,124,62,175,175,175,525
355030846000102,1,82,40,105,105,101,311
355030846000103,1,67,32,112,112,85,309
355030846000104,1,117,67,169,169,140,478
355030846000105,1,148,71,200,200,118,518
355030846000106,1,76,38,97,97,84,278
355030846000107,1,85,58,123,123,87,333
355030846000108,1,254,120,318,318,173,809
355030846000109,1,91,65,136,136,95,367
355030846000110,1,100,57,132,132,81,345
355030846000111,1,236,110,188,188,140,516
355030846000112,1,63,37,70,70,63,203
355030846000113,1,192,61,232,232,116,580
355030846000114,1,162,76,140,140,91,371
355030846000115,1,141,50,112,112,64,288
355030846000116,1,454,204,470,470,258,1198
355030846000117,1,166,97,219,219,136,574
355030846000118,1,74,46,95,95,48,238
355030846000119,1,76,23,67,67,48,182
355030846000120,1,86,33,97,97,64,258
355030846000121,1,41,19,45,45,29,119
355030846000122,1,76,37,92,92,70,254
355030846000123,1,234,112,199,199,107,505
355030846000124,1,97,54,103,103,69,275
355030846000125,1,134,78,148,148,129,425
355030846000126,1,131,58,166,166,108,440
355030846000127,1,200,109,216,216,112,544
355030846000128,1,61,33,73,73,31,177
355030846000129,1,107,45,111,111,60,282
355030846000130,1,119,50,165,165,88,418
355030846000131,1,133,65,152,152,100,404
355030846000132,1,171,97,215,215,111,541
355030846000133,1,218,102,248,248,131,627
355030846000134,1,184,83,249,249,141,639
355030846000135,1,188,79,204,204,134,542
355030846000136,1,153,66,139,139,86,364
355030846000137,1,177,74,155,155,106,416
355030846000138,1,198,98,187,187,107,481
355030846000139,1,131,54,170,170,109,449
355030846000141,1,152,81,143,143,71,357
355030846000142,1,575,232,507,507,187,1201
355030846000143,1,166,73,142,142,91,375
355030846000144,1,469,233,398,398,190,986
355030846000145,1,330,149,285,285,117,687
355030846000146,1,79,39,73,73,42,188
355030846000147,1,240,143,205,205,192,602
355030846000148,1,199,85,253,253,167,673
355030846000149,1,82,48,118,118,101,337
355030846000150,1,54,31,89,89,74,252
355030846000151,1,174,86,270,270,138,678
355030846000152,1,154,66,197,197,73,467
355030846000153,1,122,70,192,192,133,517
355030846000154,1,201,128,234,234,167,635
355030846000155,1,85,39,110,110,107,327
355030846000156,1,229,82,263,263,165,691
355030846000157,1,233,100,249,249,153,651
355030846000158,1,137,63,181,181,82,444
355030846000159,1,134,47,180,180,112,472
355030846000160,1,219,130,250,250,183,683
355030846000161,1,223,90,276,276,174,726
355030846000162,1,196,80,184,184,106,474
355030846000163,1,92,37,120,120,36,276
355030846000164,1,155,58,263,263,121,647
355030846000165,1,203,79,295,295,121,711
355030846000166,1,153,71,262,262,135,659
355030846000167,1,75,42,122,122,81,325
355030846000168,1,97,56,90,90,67,247
355030846000169,1,100,33,123,123,84,330
355030846000170,1,171,68,215,215,113,543
355030846000171,1,120,60,149,149,84,382
355030846000172,1,110,55,116,116,77,309
355030846000173,1,176,57,170,170,79,419
355030846000174,1,160,76,152,152,89,393
355030846000175,1,149,75,151,151,82,384
355030846000176,1,83,36,100,100,73,273
355030846000177,1,170,90,184,184,103,471
355030846000178,1,151,62,179,179,115,473
355030846000179,1,142,67,163,163,107,433
355030846000180,1,204,92,227,227,178,632
355030846000181,1,24,48,77,77,198,352
355030846000182,1,302,163,392,392,186,970
355030846000183,1,121,59,147,147,94,388
355030846000184,1,110,69,179,179,127,485
355030846000185,1,171,73,228,228,105,561
355030846000186,1,241,113,216,216,105,537
355030846000187,1,321,187,358,358,198,914
355030846000188,1,103,38,131,131,63,325
355030846000189,1,149,88,213,213,149,575
355030846000190,1,246,163,264,264,200,728
355030846000191,1,396,181,412,412,247,1071
355030846000192,1,140,55,230,230,107,567
355030846000193,1,131,50,189,189,105,483
355030846000194,1,100,50,150,150,115,415
355030846000195,1,215,140,272,272,157,701
355030846000196,1,105,45,154,154,93,401
355030846000197,1,201,83,248,248,170,666
355030846000198,1,170,98,213,213,125,551
355030846000199,1,279,129,317,317,169,803
355030846000200,1,260,132,285,285,151,721
355030846000201,1,131,50,148,148,93,389
355030846000202,1,63,51,113,113,101,327
355030846000203,1,66,30,59,59,43,161
355030846000204,1,166,99,183,183,142,508
355030846000205,1,157,79,178,178,97,453
355030846000206,1,333,123,356,356,198,910
355030846000207,1,190,101,279,279,179,737
355030846000208,1,100,45,124,124,71,319
355030846000209,1,112,66,147,147,99,393
355030846000210,1,171,76,222,222,134,578
355030846000211,1,132,58,152,152,103,407
355030846000212,1,143,73,203,203,133,539
355030846000213,1,165,83,163,163,92,418
355030846000214,1,160,101,206,206,157,569
355030846000215,1,279,123,333,333,182,848
355030846000216,1,151,79,166,166,115,447
355030846000217,1,256,119,228,228,159,615
355030846000218,1,111,49,107,107,55,269
355030846000219,1,231,104,202,202,115,519
355030846000220,1,177,64,152,152,114,418
355030846000221,1,220,108,224,224,131,579
355030846000222,1,68,36,83,83,53,219
355030846000223,1,120,57,118,118,89,325
355030846000224,1,141,45,125,125,64,314
355030846000225,1,138,48,153,153,81,387
355030846000226,1,220,135,244,244,146,634
355030846000227,1,144,65,200,200,161,561
355030846000228,1,130,57,146,146,122,414
355030846000229,1,106,55,143,143,147,433
355030846000230,1,90,60,139,139,98,376
355030846000231,1,104,64,141,141,110,392
355030846000232,1,83,53,128,128,97,353
355030846000233,1,154,83,214,214,178,606
355030846000234,1,115,67,177,177,110,464
355030846000235,1,87,49,131,131,87,349
355030846000236,1,79,34,82,82,48,212
355030846000237,1,161,94,178,178,116,472
355030846000238,1,43,48,105,105,83,293
355030846000239,1,288,152,286,286,148,720
355030846000240,1,231,104,235,235,82,552
355030846000241,1,59,22,83,83,80,246
355030846000242,1,125,57,147,147,134,428
355030846000243,1,263,108,294,294,199,787
355030846000244,1,251,130,292,292,151,735
355030846000245,1,114,55,188,188,147,523
355030846000246,1,200,86,235,235,106,576
355030846000247,1,93,33,65,65,37,167
355030846000248,1,366,182,408,408,216,1032
355030846000249,1,57,59,140,140,153,433
355030846000250,1,13,16,51,51,91,193
355030846000251,1,188,93,195,195,88,478
355030846000252,1,67,26,103,103,67,273
355030846000253,1,232,111,300,300,189,789
355030846000254,1,115,66,121,121,129,371
355030846000255,1,153,45,204,204,86,494
355030846000256,1,124,21,204,204,59,467
355030846000257,1,121,73,161,161,126,448
355030846000258,1,136,58,130,130,114,374
355030846000259,1,142,84,149,149,116,414
355030846000260,1,131,81,165,165,141,471
355030846000261,1,52,26,65,65,74,204
355030846000262,1,193,92,274,274,159,707
355030846000263,1,120,47,179,179,110,468
355030846000264,1,134,77,182,182,159,523
355030846000265,1,161,86,214,214,180,608
355030846000266,1,111,68,165,165,117,447
355030846000267,1,186,110,243,243,196,682
355030846000268,1,161,67,163,163,135,461
355030846000269,1,201,86,219,219,127,565
355030846000270,1,75,41,100,100,72,272
355030846000271,1,133,55,143,143,100,386
355030846000272,1,177,94,197,197,185,579
355030846000273,1,126,71,173,173,99,445
355030846000274,1,484,210,529,529,242,1300
355030846000275,1,236,119,216,216,115,547
355030846000276,1,90,39,82,82,42,206
355030846000277,1,420,196,328,328,126,782
355030846000278,1,117,81,175,175,183,533
355030846000279,1,388,175,348,348,201,897
355030846000280,1,87,71,149,149,155,453
355030846000281,1,125,75,218,218,192,628
355030846000282,1,128,67,169,169,134,472
355030846000283,1,198,89,353,353,143,849
355030846000284,1,100,30,109,109,56,274
355030846000285,1,159,101,257,257,189,703
355030846000286,1,163,87,300,300,198,798
355030846000287,1,123,57,180,180,153,513
355030846000288,1,69,45,114,114,74,302
355030846000289,1,120,61,166,166,120,452
355030846000290,1,147,75,247,247,98,592
355030846000291,1,156,81,175,175,86,436
355030846000292,1,115,51,144,144,160,448
355030846000293,1,112,58,173,173,150,496
355030846000294,1,111,70,195,195,146,536
355030846000295,1,139,72,211,211,193,615
355030846000296,1,82,50,141,141,145,427
355030846000297,1,132,54,172,172,77,421
355030846000298,1,87,50,79,79,62,220
355030846000299,1,82,44,128,128,90,346
355030846000300,1,116,56,131,131,65,327
355030846000301,1,109,34,121,121,53,295
355030846000302,1,105,56,146,146,66,358
355030846000303,1,83,59,116,116,76,308
355030846000304,1,194,96,213,213,125,551
355030846000305,1,234,128,260,260,157,677
355030846000306,1,219,86,205,205,107,517
355030846000307,1,289,113,263,263,126,652
355030846000308,1,63,33,78,78,16,172
355030846000309,1,470,165,384,384,166,934
355030846000310,1,80,48,106,106,55,267
355030846000311,1,86,43,115,115,89,319
355030846000312,1,114,56,173,173,131,477
355030846000313,1,184,59,149,149,48,346
355030846000314,1,158,63,158,158,69,385
355030846000315,1,170,86,167,167,88,422
355030846000316,1,168,86,159,159,83,401
355030846000317,1,211,87,224,224,113,561
355030846000318,1,132,66,109,109,53,271
355030846000319,1,178,88,175,175,115,465
355030846000320,1,182,121,215,215,111,541
355030846000321,1,268,105,211,211,132,554
355030846000322,1,121,53,133,133,67,333
355030846000323,1,182,101,169,169,143,481
355030846000324,1,159,81,194,194,94,482
355030846000325,1,122,43,138,138,83,359
355030846000326,1,97,53,130,130,86,346
355030846000327,1,88,51,89,89,54,232
355030846000328,1,214,96,210,210,143,563
355030846000329,1,143,58,141,141,68,350
355030846000330,1,87,48,158,158,111,427
355030846000331,1,172,99,228,228,157,613
355030846000332,1,128,38,125,125,37,287
355030846000333,1,127,48,139,139,45,323
355030846000334,1,91,37,94,94,42,230
355030846000335,1,170,71,180,180,90,450
355030846000336,1,304,112,323,323,123,769
355030846000337,1,259,117,216,216,103,535
355030846000338,1,58,32,100,100,89,289
355030846000340,1,77,42,111,111,88,310
355030846000341,1,166,68,145,145,80,370
355030846000342,1,145,54,229,229,81,539
355030846000343,1,107,47,158,158,42,358
355030846000344,1,51,21,112,112,26,250
355030846000345,1,140,49,215,215,81,511
355030846000346,1,108,16,187,187,39,413
355030846000347,1,88,38,109,109,67,285
355030846000348,1,113,75,170,170,195,535
355030846000349,1,261,67,272,272,66,610
355030846000350,1,275,109,247,247,134,628
355030846000351,1,224,118,220,220,99,539
355030846000353,1,63,27,34,34,27,95
355030846000354,1,61,27,55,55,32,142
355030846000355,1,66,28,76,76,58,210
355030846000356,1,33,13,33,33,9,75
355030846000357,1,46,23,60,60,43,163
355030846000358,1,61,26,72,72,37,181
355030846000359,1,95,44,153,153,85,391
355030846000360,1,240,128,299,299,152,750
355030846000362,1,33,17,50,50,26,126
355030846000363,1,23,16,28,28,22,78
355030846000364,1,71,56,105,105,69,279
355030846000365,1,0,0,0,0,0,0
355030846000366,1,58,19,65,65,39,169
355030846000367,1,125,75,143,143,114,400
355030846000368,1,111,47,111,111,63,285
355030846000369,1,21,6,22,22,10,54
355030846000370,1,28,16,32,32,19,83
355030846000371,1,60,25,61,61,33,155
355030846000372,1,57,43,78,78,48,204
355030846000374,1,119,46,153,153,36,342
355030846000375,1,149,67,148,148,45,341
355030846000376,1,29,11,27,27,24,78
355030846000377,1,27,18,45,45,13,103
355030846000378,1,118,48,100,100,59,259
355030846000379,1,0,0,0,0,0,0
355030846000380,1,25,6,31,31,20,82
355030846000381,1,74,40,80,80,34,194
355030846000382,1,44,28,40,40,29,109
355030846000383,1,58,34,55,55,36,146
355030846000384,1,116,44,129,129,46,304
355030846000385,1,15,12,17,17,18,52
355030846000386,1,29,14,35,35,25,95
355030847000001,1,73,47,117,117,91,325
355030847000002,1,80,33,107,107,106,320
355030847000003,1,101,48,148,148,171,467
355030847000004,1,121,52,189,189,133,511
355030847000005,1,159,54,226,226,124,576
355030847000006,1,163,57,202,202,152,556
355030847000007,1,287,96,412,412,221,1045
355030847000008,1,154,91,154,154,107,415
355030847000009,1,206,89,215,215,145,575
355030847000010,1,96,44,118,118,85,321
355030847000011,1,131,83,195,195,105,495
355030847000012,1,86,45,67,67,50,184
355030847000013,1,126,44,114,114,75,303
355030847000014,1,101,49,129,129,118,376
355030847000015,1,99,46,120,120,107,347
355030847000016,1,110,59,159,159,158,476
355030847000017,1,92,43,155,155,115,425
355030847000018,1,152,59,165,165,182,512
355030847000019,1,111,47,156,156,121,433
355030847000020,1,79,30,114,114,128,356
355030847000021,1,87,41,115,115,111,341
355030847000022,1,120,45,159,159,132,450
355030847000023,1,151,71,185,185,143,513
355030847000024,1,133,44,147,147,96,390
355030847000025,1,77,40,108,108,72,288
355030847000026,1,94,52,112,112,83,307
355030847000027,1,142,72,164,164,106,434
355030847000028,1,218,112,230,230,178,638
355030847000029,1,181,91,152,152,130,434
355030847000030,1,115,73,139,139,176,454
355030847000031,1,132,59,164,164,195,523
355030847000032,1,130,53,167,167,143,477
355030847000033,1,100,40,112,112,89,313
355030847000034,1,98,60,130,130,91,351
355030847000035,1,95,50,144,144,129,417
355030847000036,1,158,80,203,203,188,594
355030847000037,1,161,53,196,196,192,584
355030847000038,1,143,84,166,166,229,561
355030847000039,1,107,54,153,153,128,434
355030847000040,1,95,53,146,146,88,380
355030847000041,1,110,53,145,145,166,456
355030847000042,1,140,65,200,200,148,548
355030847000043,1,72,24,104,104,91,299
355030847000044,1,88,35,138,138,110,386
355030847000045,1,120,53,168,168,116,452
355030847000047,1,215,92,251,251,151,653
355030847000048,1,142,70,149,149,110,408
355030847000049,1,191,87,168,168,114,450
355030847000050,1,86,50,83,83,85,251
355030847000051,1,93,31,94,94,63,251
355030847000052,1,199,78,188,188,90,466
355030847000053,1,191,83,170,170,135,475
355030847000054,1,272,155,219,219,228,666
355030847000055,1,66,34,70,70,71,211
355030847000056,1,84,35,109,109,64,282
355030847000057,1,121,63,166,166,86,418
355030847000058,1,74,24,89,89,68,246
355030847000059,1,105,37,131,131,93,355
355030847000060,1,87,40,104,104,105,313
355030847000061,1,100,54,166,166,130,462
355030847000062,1,67,30,129,129,94,352
355030847000063,1,0,0,0,0,0,0
355030847000064,1,98,45,155,155,103,413
355030847000065,1,145,79,216,216,169,601
355030847000066,1,126,71,177,177,161,515
355030847000067,1,99,46,127,127,106,360
355030847000068,1,95,40,108,108,61,277
355030847000069,1,117,48,162,162,143,467
355030847000070,1,131,48,150,150,142,442
355030847000071,1,98,50,165,165,137,467
355030847000072,1,179,91,244,244,155,643
355030847000073,1,317,120,396,396,206,998
355030847000074,1,95,40,156,156,76,388
355030847000075,1,124,58,144,144,74,362
355030847000076,1,137,67,210,210,193,613
355030847000077,1,63,32,98,98,96,292
355030847000078,1,165,67,225,225,152,602
355030847000079,1,116,42,163,163,114,440
355030847000080,1,77,30,120,120,95,335
355030847000081,1,87,30,129,129,100,358
355030847000082,1,158,57,223,223,135,581
355030847000083,1,71,34,152,152,72,376
355030847000084,1,75,37,116,116,81,313
355030847000085,1,230,127,286,286,238,810
355030847000086,1,121,74,131,131,135,397
355030847000087,1,95,61,131,131,116,378
355030847000088,1,186,89,219,219,145,583
355030847000089,1,157,86,188,188,130,506
355030847000090,1,112,40,116,116,89,321
355030847000091,1,109,46,144,144,133,421
355030847000092,1,103,40,134,134,152,420
355030847000093,1,90,36,135,135,92,362
355030847000094,1,124,49,157,157,144,458
355030847000095,1,138,64,167,167,135,469
355030847000096,1,107,65,182,182,98,462
355030847000097,1,81,43,113,113,97,323
355030847000098,1,179,76,230,230,128,588
355030847000099,1,134,65,152,152,113,417
355030847000100,1,79,38,116,116,104,336
355030847000101,1,86,56,134,134,129,397
355030847000102,1,94,49,128,128,100,356
355030847000103,1,83,50,129,129,118,376
355030847000104,1,267,149,266,266,196,728
355030847000105,1,25,16,44,44,31,119
355030847000106,1,137,51,164,164,141,469
355030847000107,1,110,50,169,169,123,461
355030847000108,1,163,77,190,190,147,527
355030847000109,1,80,54,109,109,90,308
355030847000110,1,88,57,140,140,114,394
355030847000111,1,136,61,167,167,96,430
355030847000112,1,11,6,10,10,9,29
355030847000113,1,61,27,75,75,60,210
355030847000114,1,98,48,138,138,110,386
355030847000115,1,83,41,121,121,114,356
355030847000116,1,75,26,101,101,96,298
355030847000117,1,143,73,170,170,96,436
355030847000118,1,68,26,113,113,72,298
355030847000119,1,116,38,130,130,88,348
355030847000120,1,161,85,158,158,75,391
355030847000121,1,63,34,62,62,30,154
355030847000122,1,101,56,108,108,67,283
355030847000123,1,130,64,122,122,101,345
355030847000124,1,206,102,188,188,138,514
355030847000125,1,113,66,111,111,71,293
355030847000126,1,34,12,28,28,24,80
355030847000127,1,89,37,80,80,75,235
355030847000129,1,22,8,28,28,19,75
355030847000130,1,295,137,303,303,202,808
355030847000131,1,177,69,178,178,152,508
355030847000132,1,101,42,92,92,71,255
355030847000133,1,125,53,118,118,55,291
355030847000134,1,112,58,123,123,80,326
355030847000135,1,97,51,107,107,96,310
355030847000136,1,147,78,166,166,92,424
355030847000137,1,144,58,177,177,83,437
355030847000138,1,140,61,139,139,68,346
355030847000139,1,126,81,159,159,105,423
355030847000140,8,77,37,58,58,38,154
355030847000141,1,175,77,181,181,109,471
355030847000142,1,230,98,262,262,98,622
355030847000143,1,135,67,138,138,60,336
355030847000144,1,180,94,174,174,102,450
355030847000145,1,159,78,151,151,107,409
355030847000146,1,213,119,232,232,142,606
355030847000147,1,155,52,169,169,57,395
355030847000148,4,46,17,40,40,34,114
355030847000150,3,139,51,133,133,98,364
355030847000151,8,49,24,45,45,33,123
355030847000152,1,89,30,69,69,27,165
355030847000153,1,207,83,179,179,81,439
355030847000154,1,144,88,136,136,96,368
355030847000155,1,316,116,234,234,121,589
355030847000156,1,170,74,163,163,116,442
355030847000157,1,117,53,105,105,97,307
355030847000158,1,49,24,77,77,68,222
355030847000159,1,83,53,110,110,105,325
355030847000160,1,92,50,103,103,87,293
355030847000161,1,101,56,100,100,73,273
355030847000162,1,95,33,151,151,65,367
355030847000163,1,108,29,148,148,60,356
355030847000164,1,97,32,165,165,51,381
355030847000165,1,126,40,195,195,70,460
355030847000166,1,96,18,131,131,51,313
355030847000167,1,100,35,165,165,60,390
355030847000168,1,61,25,73,73,77,223
355030847000169,1,95,32,159,159,63,381
355030847000170,1,94,59,117,117,82,316
355030847000171,1,82,23,131,131,38,300
355030847000172,1,63,26,91,91,53,235
355030847000173,1,142,53,125,125,80,330
355030847000174,1,31,8,45,45,30,120
355030847000175,1,60,25,74,74,48,196
355030847000176,1,71,32,51,51,28,130
355030847000177,1,103,47,108,108,62,278
355030847000179,3,219,79,193,193,131,517
355030847000180,1,199,88,157,157,102,416
355030847000181,1,219,93,132,132,58,322
355030847000182,1,126,42,133,133,57,323
355030847000183,1,35,23,44,44,20,108
355030847000184,1,63,22,75,75,31,181
355030847000185,4,0,0,0,0,0,0
355030847000186,1,90,33,61,61,27,149
355030847000187,1,92,51,110,110,60,280
355030847000188,4,9,2,6,6,5,17
355030847000190,1,265,90,210,210,87,507
355030847000191,1,336,131,262,262,98,622
355030847000192,2,278,121,230,230,70,530
355030847000193,4,206,76,215,215,99,529
355030847000194,1,107,21,105,105,42,252
355030847000195,1,85,33,94,94,54,242
355030847000196,1,85,41,105,105,65,275
355030847000197,1,118,51,139,139,76,354
355030847000198,1,218,107,247,247,123,617
355030847000199,1,74,53,92,92,84,268
355030847000200,2,75,25,28,28,29,85
355030847000201,2,5,6,4,4,8,16
355030847000202,4,197,102,232,232,82,546
355030847000203,4,171,51,143,143,43,329
355030847000204,4,169,44,157,157,40,354
355030847000205,4,152,57,124,124,61,309
355030847000206,4,258,82,224,224,74,522
355030847000207,4,206,54,157,157,64,378
355030847000208,4,133,36,82,82,35,199
355030847000209,8,84,34,93,93,29,215
355030847000212,1,23,10,29,29,16,74
355030847000213,1,231,107,198,198,78,474
355030847000214,1,103,27,68,68,27,163
355030848000001,1,36,36,74,74,69,217
355030848000002,1,48,30,150,150,86,386
355030848000003,1,35,25,91,91,86,268
355030848000004,1,46,22,64,64,78,206
355030848000005,1,69,57,107,107,100,314
355030848000006,1,135,80,232,232,185,649
355030848000007,1,54,29,85,85,109,279
355030848000008,1,68,36,60,60,200,320
355030848000009,1,35,35,81,81,95,257
355030848000010,1,28,29,77,77,65,219
355030848000011,1,47,28,95,95,97,287
355030848000012,1,26,19,71,71,59,201
355030848000013,1,61,41,129,129,108,366
355030848000014,1,52,25,79,79,74,232
355030848000015,1,91,42,121,121,130,372
355030848000016,1,116,45,193,193,156,542
355030848000017,1,97,34,182,182,97,461
355030848000018,1,91,46,176,176,133,485
355030848000019,1,51,9,140,140,65,345
355030848000020,1,125,51,258,258,160,676
355030848000021,1,120,97,180,180,159,519
355030848000022,1,91,63,199,199,155,553
355030848000023,1,105,51,187,187,157,531
355030848000024,1,102,58,173,173,150,496
355030848000025,1,46,33,92,92,102,286
355030848000026,1,23,20,51,51,84,186
355030848000027,1,54,38,87,87,124,298
355030848000028,1,23,15,69,69,63,201
355030848000029,1,65,84,140,140,127,407
355030848000030,1,38,32,91,91,72,254
355030848000031,1,46,44,98,98,124,320
355030848000032,1,54,37,107,107,70,284
355030848000033,1,86,48,183,183,169,535
355030848000034,1,76,49,152,152,178,482
355030848000035,1,69,46,150,150,160,460
355030848000036,1,39,32,89,89,106,284
355030848000037,1,22,18,49,49,63,161
355030848000038,1,127,39,235,235,164,634
355030848000039,1,38,13,91,91,59,241
355030848000040,1,75,39,143,143,142,428
355030848000041,1,37,24,91,91,105,287
355030848000042,1,46,24,98,98,100,296
355030848000043,1,102,49,144,144,154,442
355030848000044,1,53,32,93,93,101,287
355030848000045,1,36,20,77,77,76,230
355030848000046,1,51,35,122,122,118,362
355030848000047,1,46,26,65,65,60,190
355030848000048,1,36,27,65,65,83,213
355030848000049,1,40,28,81,81,94,256
355030848000050,1,56,35,105,105,134,344
355030848000051,1,44,21,80,80,101,261
355030848000052,1,67,34,112,112,91,315
355030848000053,1,91,26,131,131,129,391
355030848000054,1,66,33,128,128,169,425
355030848000055,1,51,30,100,100,113,313
355030848000056,1,49,26,83,83,79,245
355030848000057,1,47,28,86,86,98,270
355030848000058,1,31,11,64,64,49,177
355030848000059,1,36,22,55,55,82,192
355030848000060,1,62,25,85,85,99,269
355030848000061,1,40,17,68,68,25,161
355030848000062,1,50,24,81,81,95,257
355030848000063,1,85,53,149,149,129,427
355030848000064,1,71,40,134,134,91,359
355030848000065,1,38,31,83,83,102,268
355030848000066,1,48,38,87,87,103,277
355030848000067,1,35,21,84,84,74,242
355030848000068,1,60,33,154,154,126,434
355030848000069,1,27,19,125,125,107,357
355030848000070,1,54,32,117,117,81,315
355030848000071,1,36,20,59,59,63,181
355030848000072,1,50,37,94,94,102,290
355030848000073,1,45,25,96,96,105,297
355030848000074,1,66,33,138,138,114,390
355030848000075,1,23,13,82,82,80,244
355030848000076,1,48,26,91,91,100,282
355030848000077,1,62,42,132,132,156,420
355030848000078,1,68,36,131,131,149,411
355030848000079,1,55,18,84,84,59,227
355030848000080,1,77,41,201,201,108,510
355030848000081,1,42,55,141,141,139,421
355030848000082,1,52,37,133,133,120,386
355030848000083,1,82,44,215,215,98,528
355030848000084,1,59,35,138,138,116,392
355030848000085,1,49,39,84,84,106,274
355030848000086,1,69,56,137,137,170,444
355030848000087,1,20,5,122,122,17,261
355030848000088,1,44,34,72,72,63,207
355030848000089,1,55,26,82,82,92,256
355030848000090,1,43,28,76,76,88,240
355030848000091,1,54,41,79,79,95,253
355030848000092,1,79,37,132,132,139,403
355030848000093,1,42,31,76,76,84,236
355030848000094,1,51,38,120,120,115,355
355030848000095,1,30,9,103,103,29,235
355030848000096,1,37,30,58,58,60,176
355030848000097,1,43,34,100,100,97,297
355030848000098,1,46,23,89,89,99,277
355030848000099,1,58,30,96,96,90,282
355030848000100,1,62,42,79,79,166,324
355030848000101,1,66,30,161,161,123,445
355030848000102,1,99,33,191,191,120,502
355030848000103,1,50,37,97,97,105,299
355030848000104,1,33,15,69,69,59,197
355030848000105,1,3,1,8,8,8,24
355030848000106,1,59,28,115,115,93,323
355030848000107,1,47,61,121,121,95,337
355030848000108,1,150,35,190,190,105,485
355030848000109,1,71,46,150,150,104,404
355030848000110,1,12,7,26,26,42,94
355030848000111,1,15,19,71,71,66,208
355030848000112,1,19,6,26,26,26,78
355030848000113,1,114,45,275,275,141,691
355030848000114,1,28,9,54,54,53,161
355030848000115,1,30,24,88,88,61,237
355030848000116,1,45,25,184,184,90,458
355030848000117,1,42,27,87,87,96,270
355030848000118,1,31,21,70,70,86,226
355030848000119,1,28,8,95,95,33,223
355030848000120,1,31,25,62,62,89,213
355030848000121,1,99,25,116,116,102,334
355030848000122,1,44,21,140,140,99,379
355030848000123,1,50,25,108,108,104,320
355030848000124,1,41,22,80,80,121,281
355030848000125,1,55,27,59,59,25,143
355030848000126,1,56,27,151,151,71,373
355030848000127,1,108,51,166,166,166,498
355030848000128,1,38,17,113,113,62,288
355030848000129,1,21,10,54,54,42,150
355030848000130,1,50,37,98,98,90,286
355030848000131,1,27,14,100,100,55,255
355030848000132,1,59,28,123,123,104,350
355030848000133,1,115,31,201,201,96,498
355030848000134,1,21,21,46,46,70,162
355030848000135,1,14,11,38,38,40,116
355030848000136,1,20,7,131,131,34,296
355030848000137,1,8,3,57,57,18,132
355030848000138,1,17,7,56,56,43,155
355030848000139,1,37,18,71,71,42,184
355030848000140,1,57,32,53,53,41,147
355030849000001,1,37,22,97,97,85,279
355030849000002,1,67,47,219,219,133,571
355030849000003,1,90,49,161,161,81,403
355030849000004,1,41,27,86,86,68,240
355030849000005,1,108,72,177,177,137,491
355030849000006,1,166,73,235,235,132,602
355030849000007,1,67,48,207,207,189,603
355030849000008,1,71,39,141,141,126,408
355030849000009,1,148,77,185,185,107,477
355030849000010,1,169,109,351,351,254,956
355030849000011,1,13,8,73,73,41,187
355030849000012,1,8,11,42,42,27,111
355030849000013,1,97,76,220,220,177,617
355030849000014,1,94,50,222,222,175,619
355030849000015,1,51,38,115,115,103,333
355030849000016,1,77,47,185,185,169,539
355030849000017,1,45,29,172,172,115,459
355030849000018,1,72,50,150,150,89,389
355030849000019,1,122,63,206,206,89,501
355030849000020,1,60,23,102,102,109,313
355030849000021,1,75,37,119,119,95,333
355030849000022,1,148,58,302,302,162,766
355030849000023,1,31,33,135,135,106,376
355030849000024,1,39,32,115,115,125,355
355030849000025,1,60,34,143,143,123,409
355030849000026,1,60,57,158,158,179,495
355030849000027,1,5,1,26,26,12,64
355030849000028,1,87,56,196,196,116,508
355030849000029,1,23,31,87,87,70,244
355030849000030,1,78,44,100,100,74,274
355030849000031,1,101,154,211,211,142,564
355030849000032,1,41,87,101,101,85,287
355030849000033,1,37,43,88,88,77,253
355030849000034,1,41,47,101,101,84,286
355030849000035,1,95,77,183,183,117,483
355030849000036,1,85,47,189,189,99,477
355030849000037,1,41,30,104,104,66,274
355030849000038,1,87,46,134,134,107,375
355030849000039,1,147,72,234,234,124,592
355030849000040,1,116,41,299,299,94,692
355030849000041,1,76,30,164,164,57,385
355030849000042,1,66,29,102,102,80,284
355030849000043,1,89,48,188,188,135,511
355030849000044,1,55,31,134,134,125,393
355030849000045,1,103,58,150,150,140,440
355030849000046,1,41,37,95,95,113,303
355030849000047,1,86,44,214,214,152,580
355030849000048,1,105,55,209,209,173,591
355030849000049,1,55,35,99,99,121,319
355030849000050,1,79,47,214,214,191,619
355030849000051,1,29,45,76,76,117,269
355030849000052,1,70,63,162,162,164,488
355030849000053,1,64,51,226,226,106,558
355030849000054,1,50,60,170,170,116,456
355030849000055,1,40,38,124,124,68,316
355030849000056,1,27,46,95,95,66,256
355030849000057,1,59,25,106,106,48,260
355030849000058,1,55,71,118,118,107,343
355030849000059,1,49,44,92,92,47,231
355030849000060,1,88,68,170,170,128,468
355030849000061,1,12,26,38,38,23,99
355030849000062,1,16,32,74,74,41,189
355030849000063,1,44,70,113,113,78,304
355030849000064,1,35,49,102,102,140,344
355030849000065,1,89,64,195,195,145,535
355030849000066,1,16,44,112,112,58,282
355030849000067,1,72,74,234,234,144,612
355030849000068,1,53,35,84,84,42,210
355030849000069,1,157,79,212,212,112,536
355030849000070,1,124,68,166,166,151,483
355030849000071,1,165,86,195,195,99,489
355030849000072,1,80,32,146,146,145,437
355030849000073,1,48,44,125,125,127,377
355030849000074,1,99,52,257,257,170,684
355030849000075,1,117,72,211,211,219,641
355030849000076,1,57,27,140,140,98,378
355030849000077,1,96,50,159,159,175,493
355030849000078,1,88,44,156,156,184,496
355030849000079,1,87,88,156,156,200,512
355030849000080,1,52,42,102,102,101,305
355030849000081,1,118,81,224,224,263,711
355030849000082,1,126,67,229,229,179,637
355030849000083,1,144,85,298,298,243,839
355030849000084,1,91,71,180,180,161,521
355030849000085,1,59,53,213,213,125,551
355030849000086,1,81,98,278,278,151,707
355030849000087,1,35,46,79,79,55,213
355030849000088,1,33,39,102,102,60,264
355030849000089,1,17,23,51,51,62,164
355030849000090,1,14,64,80,80,84,244
355030849000091,1,67,65,137,137,130,404
355030849000092,1,13,9,35,35,23,93
355030849000093,1,89,64,188,188,143,519
355030849000094,1,38,34,92,92,65,249
355030849000095,1,68,46,137,137,113,387
355030849000096,1,29,24,67,67,33,167
355030849000097,1,157,100,194,194,155,543
355030849000098,1,127,58,194,194,128,516
355030849000099,1,34,20,113,113,54,280
355030849000100,1,91,53,119,119,72,310
355030849000101,1,38,24,80,80,77,237
355030849000102,1,54,62,127,127,102,356
355030849000103,1,10,19,55,55,42,152
355030849000104,1,35,42,113,113,101,327
355030849000105,1,22,28,97,97,64,258
355030849000106,1,64,48,111,111,75,297
355030849000107,1,25,45,121,121,72,314
355030849000108,1,17,38,68,68,65,201
355030849000109,1,28,19,79,79,83,241
355030849000110,1,62,13,101,101,56,258
355030849000111,1,102,36,210,210,126,546
355030849000112,1,70,42,100,100,86,286
355030849000113,1,54,34,107,107,89,303
355030849000114,1,77,29,122,122,67,311
355030849000115,1,56,11,187,187,121,495
355030849000116,1,23,25,91,91,65,247
355030850000001,1,74,36,106,106,84,296
355030850000002,1,124,61,190,190,117,497
355030850000003,1,50,31,92,92,76,260
355030850000004,1,123,81,176,176,182,534
355030850000005,1,116,37,140,140,77,357
355030850000006,1,175,85,223,223,166,612
355030850000007,1,95,57,155,155,133,443
355030850000008,1,64,46,128,128,162,418
355030850000009,1,116,65,174,174,149,497
355030850000010,1,74,39,91,91,77,259
355030850000011,1,133,74,145,145,154,444
355030850000012,1,141,66,195,195,169,559
355030850000013,1,140,82,207,207,163,577
355030850000014,1,95,59,157,157,154,468
355030850000015,1,51,41,86,86,104,276
355030850000016,1,162,74,221,221,189,631
355030850000017,1,217,101,228,228,194,650
355030850000018,1,62,60,60,60,49,169
355030850000019,1,171,98,181,181,148,510
355030850000020,1,92,43,123,123,82,328
355030850000021,1,131,118,163,163,92,418
355030850000022,1,110,52,118,118,95,331
355030850000023,1,58,38,88,88,85,261
355030850000024,1,178,73,359,359,210,928
355030850000025,1,153,89,223,223,258,704
355030850000026,1,147,53,228,228,172,628
355030850000027,1,131,83,210,210,180,600
355030850000028,1,78,48,131,131,137,399
355030850000029,1,88,43,123,123,82,328
355030850000030,1,79,50,119,119,73,311
355030850000031,1,163,107,203,203,187,593
355030850000032,1,151,79,181,181,174,536
355030850000033,1,48,25,66,66,59,191
355030850000034,1,113,78,205,205,172,582
355030850000035,1,82,62,125,125,148,398
355030850000036,1,84,70,185,185,165,535
355030850000037,1,59,35,89,89,121,299
355030850000038,1,85,38,148,148,96,392
355030850000039,1,62,26,62,62,47,171
355030850000040,1,171,105,179,179,172,530
355030850000041,1,63,30,76,76,49,201
355030850000042,1,207,98,210,210,147,567
355030850000043,1,76,31,90,90,47,227
355030850000044,1,99,53,147,147,180,474
355030850000045,1,530,273,400,400,227,1027
355030850000046,1,29,14,20,20,20,60
355030850000047,1,107,45,131,131,105,367
355030850000048,1,136,77,167,167,165,499
355030850000049,1,125,67,152,152,153,457
355030850000050,1,81,42,120,120,116,356
355030850000051,1,108,56,161,161,190,512
355030850000052,1,79,56,129,129,164,422
355030850000053,1,51,43,120,120,129,369
355030850000054,1,96,58,141,141,121,403
355030850000055,1,72,55,67,67,91,225
355030850000056,1,97,44,122,122,118,362
355030850000057,1,71,58,101,101,87,289
355030850000058,1,103,38,136,136,79,351
355030850000059,1,92,47,133,133,118,384
355030850000060,1,102,56,147,147,123,417
355030850000061,1,109,61,135,135,122,392
355030850000062,1,150,79,180,180,138,498
355030850000063,1,71,46,131,131,129,391
355030850000064,1,49,25,83,83,107,273
355030850000065,1,116,59,169,169,144,482
355030850000066,1,63,28,130,130,111,371
355030850000067,1,87,68,149,149,135,433
355030850000068,1,85,24,107,107,103,317
355030850000069,1,93,68,142,142,153,437
355030850000070,1,108,67,126,126,105,357
355030850000071,1,136,80,176,176,164,516
355030850000072,1,84,49,98,98,145,341
355030850000073,1,125,53,158,158,149,465
355030850000074,1,122,88,160,160,182,502
355030850000075,1,61,44,83,83,71,237
355030850000076,1,98,47,97,97,63,257
355030850000077,1,148,67,175,175,117,467
355030850000078,1,154,75,187,187,143,517
355030850000079,1,204,125,167,167,116,450
355030850000080,1,76,36,80,80,57,217
355030850000081,1,155,70,175,175,121,471
355030850000082,1,98,44,103,103,104,310
355030850000083,1,87,36,133,133,93,359
355030850000084,1,4,2,3,3,6,12
355030850000085,1,151,94,188,188,138,514
355030850000086,1,196,67,199,199,158,556
355030850000087,1,92,56,120,120,145,385
355030850000088,1,125,47,154,154,96,404
355030850000089,1,44,25,59,59,76,194
355030850000090,1,70,50,108,108,113,329
355030850000091,1,87,42,115,115,106,336
355030850000092,1,377,203,375,375,153,903
355030850000094,1,224,123,249,249,102,600
355030850000096,1,109,56,149,149,125,423
355030850000097,1,53,20,85,85,67,237
355030850000098,1,77,33,260,260,103,623
355030850000099,1,161,53,281,281,93,655
355030850000100,1,130,66,187,187,147,521
355030850000101,1,113,54,111,111,81,303
355030850000102,1,122,63,164,164,122,450
355030850000103,1,234,101,196,196,110,502
355030850000104,1,55,40,76,76,72,224
355030850000105,1,57,26,94,94,76,264
355030850000106,1,143,62,346,346,102,794
355030850000107,1,137,74,150,150,135,435
355030850000109,1,118,44,106,106,64,276
355030850000110,1,197,120,160,160,142,462
355030850000111,1,91,31,222,222,59,503
355030850000112,1,32,10,104,104,26,234
355030850000113,1,144,40,129,129,27,285
355030850000115,1,8,1,26,26,13,65
355030850000116,1,61,52,105,105,105,315
355030850000117,1,38,24,86,86,81,253
355030850000118,1,55,27,128,128,73,329
355030850000119,1,71,49,100,100,134,334
355030850000120,1,75,53,129,129,107,365
355030850000121,1,68,48,108,108,98,314
355030850000122,1,80,44,86,86,73,245
355030850000123,1,45,31,67,67,102,236
355030850000124,1,139,85,183,183,135,501
355030850000125,1,107,35,113,113,113,339
355030850000126,1,96,35,159,159,87,405
355030850000127,1,94,41,139,139,79,357
355030850000128,1,76,23,67,67,77,211
355030850000129,1,62,18,49,49,26,124
355030851000001,1,98,57,152,152,143,447
355030851000002,1,104,66,186,186,182,554
355030851000003,1,75,51,125,125,118,368
355030851000004,1,75,41,140,140,99,379
355030851000005,1,16,7,20,20,15,55
355030851000006,1,78,50,145,145,122,412
355030851000007,1,138,69,229,229,182,640
355030851000008,1,83,48,139,139,100,378
355030851000009,1,122,78,196,196,167,559
355030851000010,1,102,55,141,141,156,438
355030851000011,1,61,41,118,118,94,330
355030851000012,1,123,54,173,173,132,478
355030851000013,1,133,59,207,207,161,575
355030851000014,1,162,78,242,242,178,662
355030851000015,1,68,31,125,125,72,322
355030851000016,1,113,85,151,151,154,456
355030851000017,1,64,45,124,124,98,346
355030851000018,1,115,64,183,183,161,527
355030851000019,1,128,80,200,200,214,614
355030851000020,1,81,46,133,133,189,455
355030851000021,1,113,63,193,193,183,569
355030851000022,1,98,51,163,163,147,473
355030851000023,1,109,59,201,201,180,582
355030851000024,1,85,40,174,174,67,415
355030851000025,1,157,101,248,248,246,742
355030851000026,1,47,36,106,106,110,322
355030851000027,1,118,63,176,176,214,566
355030851000028,1,38,22,66,66,56,188
355030851000029,1,126,79,148,148,125,421
355030851000030,1,87,70,179,179,150,508
355030851000031,1,166,61,268,268,165,701
355030851000032,1,87,39,134,134,126,394
355030851000033,1,90,40,177,177,137,491
355030851000034,1,45,40,101,101,109,311
355030851000035,1,136,47,221,221,125,567
355030851000036,1,81,46,118,118,94,330
355030851000037,1,46,24,74,74,77,225
355030851000038,1,118,46,145,145,107,397
355030851000039,1,133,72,213,213,191,617
355030851000040,1,59,42,88,88,114,290
355030851000041,1,139,56,251,251,166,668
355030851000042,1,48,23,86,86,70,242
355030851000043,1,10,10,12,12,18,42
355030851000044,1,69,41,108,108,120,336
355030851000045,1,113,75,185,185,163,533
355030851000046,1,138,53,134,134,86,354
355030851000047,1,137,55,140,140,129,409
355030851000048,1,113,60,165,165,105,435
355030851000049,1,101,51,131,131,110,372
355030851000050,1,182,83,325,325,216,866
355030851000051,1,168,75,171,171,149,491
355030851000052,1,93,34,154,154,130,438
355030851000053,1,111,77,153,153,153,459
355030851000054,1,75,47,98,98,111,307
355030851000055,1,83,72,164,164,205,533
355030851000056,1,90,84,199,199,193,591
355030851000057,1,134,56,195,195,172,562
355030851000058,1,70,57,123,123,115,361
355030851000059,1,108,74,159,159,114,432
355030851000060,1,90,53,118,118,124,360
355030851000061,1,105,45,183,183,125,491
355030851000062,1,125,94,206,206,203,615
355030851000063,1,139,88,218,218,227,663
355030851000064,1,151,78,189,189,160,538
355030851000065,1,83,64,150,150,162,462
355030851000066,1,91,30,140,140,82,362
355030851000067,1,124,56,226,226,137,589
355030851000068,1,90,39,109,109,67,285
355030851000069,1,134,69,153,153,171,477
355030851000070,1,86,44,126,126,105,357
355030851000071,1,43,23,46,46,43,135
355030851000072,1,89,48,141,141,104,386
355030851000073,1,121,67,141,141,133,415
355030851000074,1,60,26,100,100,64,264
355030851000075,1,53,45,143,143,167,453
355030851000076,1,134,85,155,155,108,418
355030851000077,1,191,96,223,223,160,606
355030851000078,1,99,40,138,138,130,406
355030851000079,1,95,56,138,138,129,405
355030851000080,1,140,71,169,169,127,465
355030851000081,1,135,66,151,151,129,431
355030851000082,1,83,52,142,142,110,394
355030851000083,1,132,82,161,161,160,482
355030851000084,1,167,81,208,208,176,592
355030851000085,1,131,63,179,179,143,501
355030851000086,1,160,95,197,197,136,530
355030851000087,1,191,56,254,254,117,625
355030851000088,1,150,86,214,214,129,557
355030851000089,1,93,57,123,123,86,332
355030851000090,1,76,45,105,105,77,287
355030851000091,1,154,62,187,187,118,492
355030851000092,1,164,92,188,188,176,552
355030851000093,1,79,40,107,107,83,297
355030851000094,1,23,12,89,89,32,210
355030851000095,1,115,67,130,130,99,359
355030851000096,1,57,25,105,105,59,269
355030851000097,1,144,79,211,211,167,589
355030851000098,1,116,58,153,153,137,443
355030851000099,1,104,49,133,133,117,383
355030851000100,1,51,26,76,76,64,216
355030851000101,1,53,19,60,60,64,184
355030851000102,1,91,51,121,121,126,368
355030851000103,1,58,70,204,204,128,536
355030851000104,1,39,33,118,118,86,322
355030851000105,1,154,94,197,197,190,584
355030851000106,1,58,52,100,100,102,302
355030851000107,1,90,39,116,116,94,326
355030851000108,1,60,20,121,121,78,320
355030851000109,1,93,46,165,165,140,470
355030851000110,1,112,56,162,162,164,488
355030851000111,1,183,104,245,245,176,666
355030851000112,1,159,104,158,158,97,413
355030851000113,1,93,45,131,131,91,353
355030851000114,1,73,33,129,129,106,364
355030851000115,1,144,75,183,183,120,486
355030851000116,1,124,60,143,143,107,393
355030851000117,1,156,87,220,220,128,568
355030851000118,8,195,122,256,256,224,736
355030851000119,8,34,23,46,46,41,133
355030851000120,1,211,92,209,209,172,590
355030851000121,1,109,62,143,143,186,472
355030851000122,1,101,75,146,146,170,462
355030851000123,1,120,71,185,185,181,551
355030851000124,1,33,14,62,62,43,167
355030851000125,1,50,16,153,153,73,379
355030851000126,1,100,43,162,162,101,425
355030851000127,1,19,13,38,38,18,94
355030851000129,1,82,43,117,117,77,311
355030851000130,1,118,47,144,144,121,409
355030851000131,1,83,29,175,175,64,414
355030851000132,1,66,36,168,168,98,434
355030851000133,1,199,99,318,318,201,837
355030851000134,1,110,67,135,135,144,414
355030851000135,1,77,53,173,173,167,513
355030851000136,1,96,65,135,135,138,408
355030851000137,1,58,40,123,123,121,367
355030851000138,1,58,31,63,63,80,206
355030851000139,1,96,54,127,127,117,371
355030851000140,1,84,27,133,133,91,357
355030851000141,1,91,18,192,192,67,451
355030851000142,1,108,39,164,164,110,438
355030851000145,1,22,14,91,91,62,244
355030851000146,1,86,58,121,121,49,291
355030851000147,1,90,26,213,213,63,489
355030851000148,1,113,31,224,224,85,533
355030851000149,1,141,44,227,227,93,547
355030851000150,1,19,4,27,27,11,65
355030851000151,1,62,30,120,120,70,310
355030851000152,1,77,20,123,123,51,297
355030851000153,1,82,61,181,181,136,498
355030851000154,1,43,14,127,127,32,286
355030851000155,1,87,28,140,140,52,332
355030851000156,1,27,12,31,31,27,89
355030851000157,1,92,44,160,160,114,434
355030851000158,1,35,20,101,101,43,245
355030851000159,1,59,32,104,104,95,303
355030851000160,1,79,47,117,117,108,342
355030851000161,1,78,38,114,114,111,339
355030851000162,1,51,20,114,114,48,276
355030851000163,4,43,21,56,56,41,153
355030851000164,4,14,7,17,17,20,54
355030851000165,4,72,62,100,100,88,288
355030851000166,1,119,51,176,176,86,438
355030851000170,1,68,32,126,126,148,400
355030851000171,1,42,41,88,88,72,248
355030851000172,1,76,31,124,124,94,342
355030851000173,1,64,34,107,107,97,311
355030851000174,1,72,48,120,120,101,341
355030851000175,1,77,26,116,116,100,332
355030851000176,1,72,34,104,104,97,305
355030851000177,1,61,19,87,87,42,216
355030851000178,1,42,39,59,59,86,204
355030851000179,1,102,70,151,151,110,412
355030851000180,1,48,27,68,68,59,195
355030851000181,1,171,68,170,170,76,416
355030851000182,1,131,82,168,168,115,451
355030851000183,1,113,57,138,138,79,355
355030851000184,1,110,43,79,79,66,224
355030852000001,3,0,0,0,0,0,0
355030852000002,3,101,55,87,87,59,233
355030852000003,1,128,44,90,90,77,257
355030852000004,1,45,9,24,24,35,83
355030852000005,7,90,37,54,54,49,157
355030852000006,8,161,78,136,136,121,393
355030852000007,8,353,124,255,255,157,667
355030852000008,3,40,19,45,45,25,115
355030852000009,3,22,6,25,25,13,63
355030852000010,8,10,6,11,11,19,41
355030852000011,8,54,15,36,36,28,100
355030852000012,8,161,67,137,137,98,372
355030852000013,8,0,0,0,0,0,0
355030852000014,8,0,0,0,0,0,0
355030852000015,8,0,0,0,0,0,0
355030852000016,8,0,2,3,3,11,17
355030852000018,8,52,30,61,61,35,157
355030852000019,8,10,5,6,6,14,26
355030852000021,4,22,10,23,23,13,59
355030852000022,8,32,19,31,31,38,100
355030852000025,8,76,28,64,64,70,198
355030852000026,7,9,4,9,9,5,23
355030852000027,8,0,0,0,0,0,0
355030852000029,8,50,20,37,37,25,99
355030852000030,8,32,6,30,30,38,98
355030852000031,8,3,2,8,8,11,27
355030852000032,8,102,61,100,100,63,263
355030852000033,3,9,4,3,3,8,14
355030852000040,8,15,10,9,9,25,43
355030852000041,8,16,3,11,11,15,37
355030852000043,8,44,13,20,20,18,58
355030852000044,8,5,3,3,3,4,10
355030852000045,8,0,0,0,0,0,0
355030852000046,8,37,18,28,28,28,84
355030852000048,8,76,25,47,47,60,154
355030852000051,8,0,0,0,0,0,0
355030852000053,8,25,7,14,14,14,42
355030852000056,8,177,79,157,157,119,433
355030852000057,8,0,0,0,0,0,0
355030852000059,8,9,5,4,4,5,13
355030852000061,8,68,36,50,50,39,139
355030852000063,8,12,3,7,7,6,20
355030852000064,8,8,3,8,8,4,20
355030852000065,8,0,1,6,6,5,17
355030852000071,3,15,3,6,6,8,20
355030853000001,1,65,43,110,110,93,313
355030853000002,1,88,42,156,156,93,405
355030853000003,1,35,22,73,73,57,203
355030853000004,1,99,56,154,154,117,425
355030853000005,1,88,53,162,162,135,459
355030853000006,1,80,65,141,141,151,433
355030853000007,1,59,47,129,129,145,403
355030853000008,1,62,23,118,118,68,304
355030853000009,1,128,89,284,284,190,758
355030853000010,1,156,62,274,274,188,736
355030853000011,1,51,29,114,114,77,305
355030853000012,1,31,32,72,72,92,236
355030853000013,1,69,40,120,120,110,350
355030853000014,1,66,40,119,119,97,335
355030853000015,1,29,16,78,78,85,241
355030853000016,1,74,42,116,116,137,369
355030853000017,1,60,46,147,147,133,427
355030853000018,1,100,64,209,209,173,591
355030853000019,1,47,54,110,110,146,366
355030853000020,1,82,49,141,141,156,438
355030853000021,1,89,35,170,170,114,454
355030853000022,1,56,32,69,69,84,222
355030853000023,1,29,12,42,42,34,118
355030853000024,1,106,49,173,173,186,532
355030853000025,1,26,12,34,34,25,93
355030853000026,1,49,34,127,127,118,372
355030853000027,1,37,30,78,78,71,227
355030853000028,1,61,42,90,90,81,261
355030853000029,1,80,45,195,195,147,537
355030853000030,1,74,43,108,108,135,351
355030853000031,1,39,32,92,92,92,276
355030853000032,1,28,15,55,55,72,182
355030853000033,1,113,57,201,201,164,566
355030853000034,1,61,50,117,117,156,390
355030853000035,1,62,41,123,123,170,416
355030853000036,1,54,32,102,102,84,288
355030853000037,1,82,63,153,153,131,437
355030853000038,1,98,53,161,161,145,467
355030853000039,1,93,51,163,163,166,492
355030853000040,1,51,28,80,80,72,232
355030853000041,1,91,48,149,149,116,414
355030853000042,1,69,23,155,155,98,408
355030853000043,1,54,43,140,140,135,415
355030853000044,1,70,35,141,141,85,367
355030853000045,1,103,63,216,216,209,641
355030853000046,1,46,40,88,88,144,320
355030853000047,1,40,32,59,59,69,187
355030853000048,1,97,68,193,193,172,558
355030853000049,1,45,32,88,88,98,274
355030853000050,1,72,53,136,136,187,459
355030853000051,1,55,24,93,93,105,291
355030853000052,1,139,41,293,293,97,683
355030853000053,1,119,94,198,198,126,522
355030853000054,1,72,50,120,120,127,367
355030853000055,1,72,45,123,123,119,365
355030853000056,1,140,88,213,213,202,628
355030853000057,1,54,40,86,86,67,239
355030853000058,1,73,57,145,145,155,445
355030853000059,1,94,60,153,153,152,458
355030853000060,1,63,62,101,101,136,338
355030853000061,1,59,45,117,117,176,410
355030853000062,1,66,29,98,98,143,339
355030853000063,1,48,39,80,80,108,268
355030853000064,1,56,48,135,135,150,420
355030853000065,1,85,64,167,167,143,477
355030853000066,1,63,43,108,108,137,353
355030853000067,1,90,52,153,153,185,491
355030853000068,1,86,56,141,141,173,455
355030853000069,1,84,61,175,175,159,509
355030853000070,1,69,32,145,145,68,358
355030853000071,1,166,295,667,667,511,1845
355030853000072,1,67,76,177,177,145,499
355030853000073,1,78,71,142,142,109,393
355030853000074,1,114,97,348,348,159,855
355030853000075,1,53,46,98,98,79,275
355030853000076,1,36,33,93,93,82,268
355030853000077,1,75,49,136,136,178,450
355030853000078,1,61,60,110,110,122,342
355030853000079,1,108,63,170,170,184,524
355030853000080,1,46,35,104,104,151,359
355030853000081,1,50,36,88,88,102,278
355030853000082,1,10,5,22,22,14,58
355030853000083,1,62,34,161,161,130,452
355030853000084,1,12,21,38,38,44,120
355030853000085,1,88,49,100,100,43,243
355030853000086,1,99,26,210,210,105,525
355030853000087,1,80,54,109,109,119,337
355030853000088,1,57,23,71,71,63,205
355030853000089,1,74,45,167,167,155,489
355030853000090,1,71,30,84,84,61,229
355030853000091,1,68,43,118,118,127,363
355030853000092,1,43,31,94,94,77,265
355030853000093,1,111,46,171,171,144,486
355030853000094,1,76,55,139,139,158,436
355030853000095,1,158,53,281,281,171,733
355030853000096,1,88,36,196,196,158,550
355030853000097,1,73,52,120,120,128,368
355030853000098,1,62,44,108,108,81,297
355030853000099,1,76,68,127,127,109,363
355030853000100,1,199,85,253,253,121,627
355030853000101,1,107,37,193,193,125,511
355030853000102,1,28,9,56,56,38,150
355030853000103,1,74,43,200,200,98,498
355030853000104,1,119,27,244,244,75,563
355030853000105,1,49,15,120,120,55,295
355030853000107,1,16,4,87,87,19,193
355030853000108,1,42,7,123,123,35,281
355030853000109,1,16,10,92,92,32,216
355030853000110,1,38,21,54,54,62,170
355030853000111,1,97,40,154,154,77,385
355030853000112,1,96,16,158,158,56,372
355030853000113,1,39,27,69,69,72,210
355030853000114,1,31,27,63,63,57,183
355030853000115,1,85,22,152,152,99,403
355030853000116,1,297,89,412,412,161,985
355030853000117,1,47,36,99,99,120,318
355030853000118,1,101,60,149,149,127,425
355030853000119,1,69,57,124,124,87,335
355030853000120,1,58,43,101,101,142,344
355030853000121,1,51,15,168,168,46,382
355030853000122,1,55,22,124,124,77,325
355030853000123,1,30,16,60,60,62,182
355030853000124,1,60,27,153,153,67,373
355030853000125,1,63,38,145,145,77,367
355030853000126,1,52,41,126,126,106,358
355030853000127,1,20,13,44,44,10,98
355030853000128,1,94,44,133,133,76,342
355030853000129,1,24,14,49,49,41,139
355030853000130,1,41,15,134,134,54,322
355030853000131,1,52,32,123,123,102,348
355030853000132,1,73,55,116,116,145,377
355030853000133,1,60,23,39,39,10,88
355030854000001,1,46,16,53,53,52,158
355030854000002,1,59,33,96,96,90,282
355030854000003,1,21,11,34,34,42,110
355030854000004,1,38,12,61,61,50,172
355030854000005,1,31,15,67,67,72,206
355030854000006,1,89,40,144,144,142,430
355030854000007,1,42,21,62,62,85,209
355030854000008,1,41,27,92,92,84,268
355030854000009,1,23,17,37,37,53,127
355030854000010,1,30,17,57,57,59,173
355030854000011,1,175,86,128,128,67,323
355030854000012,1,77,38,152,152,101,405
355030854000013,1,55,25,77,77,55,209
355030854000014,1,107,45,144,144,114,402
355030854000015,1,86,41,124,124,109,357
355030854000016,1,56,40,119,119,103,341
355030854000017,1,76,36,87,87,76,250
355030854000018,1,122,63,129,129,133,391
355030854000019,1,30,35,148,148,96,392
355030854000020,1,46,25,102,102,71,275
355030854000021,1,59,16,115,115,41,271
355030854000022,1,54,37,105,105,98,308
355030854000023,1,18,7,32,32,40,104
355030854000024,1,34,8,129,129,53,311
355030854000025,1,28,13,55,55,40,150
355030854000026,1,69,34,121,121,132,374
355030854000027,1,24,20,40,40,68,148
355030854000028,1,61,26,65,65,62,192
355030854000029,1,39,24,93,93,80,266
355030854000030,1,39,9,72,72,49,193
355030854000032,1,87,48,110,110,93,313
355030854000033,1,301,105,185,185,81,451
355030854000034,1,151,92,190,190,92,472
355030854000035,1,142,83,114,114,76,304
355030854000036,1,58,25,83,83,76,242
355030854000037,1,62,20,104,104,74,282
355030854000038,1,127,44,196,196,129,521
355030854000039,1,57,34,74,74,60,208
355030854000040,1,13,8,22,22,23,67
355030854000041,1,265,117,205,205,84,494
355030854000042,1,40,24,69,69,102,240
355030854000043,1,37,23,91,91,83,265
355030854000044,1,74,50,111,111,155,377
355030854000045,1,18,18,92,92,47,231
355030854000046,1,31,20,86,86,103,275
355030854000047,1,27,18,64,64,59,187
355030854000048,1,77,58,120,120,172,412
355030854000049,1,26,14,62,62,23,147
355030854000050,1,42,27,66,66,88,220
355030854000051,1,68,25,163,163,87,413
355030854000052,1,74,36,115,115,67,297
355030854000053,1,30,12,46,46,39,131
355030854000054,1,270,108,268,268,76,612
355030854000055,1,180,46,207,207,157,571
355030854000056,1,89,27,116,116,112,344
355030854000057,1,27,13,37,37,39,113
355030854000058,1,262,105,194,194,90,478
355030854000059,1,112,51,102,102,54,258
355030854000060,1,284,124,203,203,109,515
355030854000061,1,60,36,145,145,111,401
355030854000062,1,50,20,79,79,50,208
355030854000063,1,80,3,105,105,33,243
355030854000064,1,15,13,31,31,25,87
355030854000065,1,41,30,67,67,95,229
355030854000066,1,68,32,100,100,97,297
355030854000067,1,48,24,91,91,78,260
355030854000068,1,48,19,71,71,85,227
355030854000069,1,40,25,106,106,56,268
355030854000070,1,72,31,133,133,33,299
355030854000071,1,55,22,187,187,58,432
355030854000072,1,62,22,131,131,52,314
355030854000073,1,51,11,118,118,24,260
355030854000074,1,16,8,71,71,22,164
355030854000075,1,120,51,126,126,41,293
355030854000076,1,38,19,52,52,54,158
355030854000077,1,23,16,37,37,49,123
355030854000078,1,15,7,37,37,20,94
355030854000079,1,19,3,51,51,24,126
355030854000080,1,29,26,67,67,48,182
355030854000081,1,65,23,119,119,80,318
355030854000082,1,29,12,61,61,41,163
355030854000083,1,95,42,112,112,121,345
355030854000084,1,26,17,38,38,28,104
355030854000085,1,70,32,114,114,81,309
355030854000086,1,43,19,103,103,91,297
355030854000087,1,11,11,42,42,53,137
355030854000088,1,35,24,53,53,58,164
355030854000089,1,61,12,67,67,52,186
355030854000090,1,78,19,168,168,83,419
355030854000091,1,129,56,94,94,35,223
355030854000093,1,29,34,59,59,66,184
355030854000094,1,59,33,99,99,90,288
355030854000095,1,69,27,129,129,93,351
355030854000096,1,97,36,181,181,120,482
355030854000097,1,30,8,53,53,31,137
355030854000098,1,0,0,0,0,0,0
355030854000099,1,23,17,43,43,21,107
355030854000100,1,16,15,63,63,39,165
355030854000101,1,14,15,22,22,29,73
355030854000102,1,0,0,0,0,0,0
355030854000103,1,20,6,16,16,14,46
355030854000104,1,56,32,196,196,62,454
355030854000105,1,21,9,65,65,47,177
355030854000106,1,93,28,127,127,85,339
355030854000107,1,9,4,13,13,13,39
355030854000108,1,21,14,62,62,44,168
355030854000109,1,38,16,106,106,59,271
355030854000110,1,45,33,97,97,125,319
355030854000111,1,30,12,90,90,58,238
355030854000112,1,32,18,45,45,51,141
355030854000113,1,13,10,27,27,32,86
355030854000116,1,69,27,96,96,83,275
355030854000117,1,53,42,87,87,105,279
355030854000118,1,40,23,75,75,70,220
355030854000119,1,22,13,55,55,53,163
355030854000120,1,18,21,73,73,60,206
355030854000121,1,38,22,66,66,55,187
355030854000123,1,30,37,63,63,72,198
355030854000124,1,21,20,27,27,55,109
355030854000125,1,25,20,49,49,52,150
355030854000126,1,25,21,51,51,63,165
355030854000127,1,69,41,116,116,123,355
355030854000128,1,44,18,76,76,74,226
355030854000129,1,17,13,42,42,65,149
355030854000130,1,19,12,34,34,45,113
355030854000131,1,34,20,47,47,66,160
355030854000132,1,60,12,88,88,57,233
355030854000133,1,9,6,16,16,24,56
355030855000001,1,100,41,107,107,59,273
355030855000002,1,216,103,246,246,149,641
355030855000003,1,21,16,21,21,13,55
355030855000004,1,197,110,219,219,161,599
355030855000005,1,243,91,238,238,154,630
355030855000006,3,10,5,10,10,5,25
355030855000007,3,43,14,33,33,38,104
355030855000008,3,147,68,129,129,89,347
355030855000009,3,37,11,39,39,39,117
355030855000010,1,173,81,201,201,170,572
355030855000011,1,171,86,180,180,117,477
355030855000012,1,194,114,278,278,163,719
355030855000013,1,200,83,280,280,94,654
355030855000014,1,403,199,487,487,288,1262
355030855000015,1,142,80,176,176,138,490
355030855000016,1,56,15,37,37,28,102
355030855000017,1,161,83,196,196,121,513
355030855000018,1,159,87,164,164,102,430
355030855000019,1,225,96,181,181,127,489
355030855000020,1,210,119,250,250,145,645
355030855000021,1,256,88,200,200,130,530
355030855000022,1,98,47,124,124,82,330
355030855000023,1,88,44,97,97,93,287
355030855000024,1,65,29,61,61,49,171
355030855000025,1,123,55,142,142,105,389
355030855000026,1,119,70,133,133,65,331
355030855000027,1,156,74,134,134,103,371
355030855000028,1,88,43,83,83,51,217
355030855000029,1,88,45,52,52,52,156
355030855000030,1,97,63,113,113,69,295
355030855000031,1,141,74,137,137,86,360
355030855000032,1,279,119,209,209,160,578
355030855000033,1,266,96,169,169,84,422
355030855000034,1,121,74,134,134,126,394
355030855000035,1,187,70,144,144,71,359
355030855000036,1,180,94,230,230,161,621
355030855000037,1,137,70,154,154,91,399
355030855000038,1,272,137,276,276,159,711
355030855000039,1,162,79,185,185,121,491
355030855000040,1,186,89,140,140,104,384
355030855000041,1,309,125,270,270,142,682
355030855000042,1,186,91,153,153,111,417
355030855000043,1,150,90,170,170,172,512
355030855000044,1,286,133,296,296,186,778
355030855000045,1,42,14,64,64,43,171
355030855000046,1,289,121,306,306,190,802
355030855000047,1,110,51,106,106,76,288
355030855000048,1,324,122,351,351,202,904
355030855000049,1,70,32,53,53,18,124
355030855000050,1,149,67,124,124,66,314
355030855000051,1,166,76,171,171,74,416
355030855000052,1,309,140,273,273,159,705
355030855000053,1,215,88,170,170,102,442
355030855000054,3,288,108,282,282,150,714
355030855000055,3,187,100,134,134,105,373
355030855000056,1,581,242,510,510,265,1285
355030855000057,3,49,24,33,33,41,107
355030855000059,1,240,107,192,192,153,537
355030855000060,1,5,4,13,13,2,28
355030855000061,1,0,0,0,0,0,0
355030855000062,1,214,99,286,286,110,682
355030855000063,1,360,175,401,401,188,990
355030855000064,1,328,137,288,288,100,676
355030855000065,1,105,36,97,97,41,235
355030855000066,1,130,38,118,118,41,277
355030855000067,1,126,57,164,164,123,451
355030855000068,1,127,41,107,107,88,302
355030855000069,1,128,29,79,79,28,186
355030855000070,1,179,87,177,177,105,459
355030855000071,1,352,143,242,242,117,601
355030855000072,1,19,2,16,16,2,34
355030855000073,1,254,111,245,245,164,654
355030855000074,1,162,64,163,163,95,421
355030855000075,1,63,27,49,49,42,140
355030855000076,1,196,115,218,218,144,580
355030855000077,1,138,64,149,149,74,372
355030855000078,3,346,138,280,280,205,765
355030855000079,3,443,193,336,336,255,927
355030855000080,3,180,78,145,145,92,382
355030855000081,3,297,155,268,268,180,716
355030855000082,3,93,32,82,82,58,222
355030855000083,3,242,121,227,227,114,568
355030855000084,3,171,85,161,161,106,428
355030855000085,3,268,106,232,232,140,604
355030855000086,3,384,202,339,339,180,858
355030855000087,3,261,137,247,247,122,616
355030855000088,3,451,210,394,394,251,1039
355030855000089,3,144,71,133,133,78,344
355030855000090,3,81,29,72,72,34,178
355030855000091,3,32,16,26,26,25,77
355030855000092,1,571,281,634,634,242,1510
355030855000093,3,1,1,2,2,5,9
355030855000094,1,162,57,158,158,61,377
355030855000095,1,343,118,348,348,112,808
355030855000096,1,483,213,481,481,234,1196
355030855000097,1,292,115,283,283,166,732
355030855000098,3,629,289,558,558,262,1378
355030855000099,3,273,128,246,246,129,621
355030855000100,3,273,115,254,254,156,664
355030855000101,1,38,16,24,24,28,76
355030855000102,1,297,146,266,266,139,671
355030855000103,1,178,98,195,195,101,491
355030855000104,8,53,27,47,47,24,118
355030855000105,3,198,63,116,116,94,326
355030855000106,3,23,13,39,39,26,104
355030855000107,8,274,90,68,68,13,149
355030855000108,3,63,13,34,34,18,86
355030855000109,8,124,26,21,21,19,61
355030855000110,3,82,26,57,57,52,166
355030855000111,3,132,59,86,86,54,226
355030855000113,3,308,109,209,209,148,566
355030855000114,3,105,56,84,84,68,236
355030855000115,3,146,67,101,101,69,271
355030855000116,3,587,239,475,475,196,1146
355030855000118,3,43,36,42,42,27,111
355030855000119,3,217,114,190,190,142,522
355030855000120,3,17,11,19,19,16,54
355030855000121,3,202,96,181,181,115,477
355030855000122,3,37,15,31,31,11,73
355030855000123,3,25,7,33,33,28,94
355030855000124,1,11,12,14,14,15,43
355030855000125,1,218,105,199,199,129,527
355030855000126,1,359,119,304,304,113,721
355030855000127,1,131,68,102,102,39,243
355030855000128,1,95,43,77,77,37,191
355030855000129,1,235,119,321,321,197,839
355030855000130,1,120,65,128,128,119,375
355030855000131,1,197,92,191,191,107,489
355030855000132,1,217,90,176,176,79,431
355030855000133,1,88,46,116,116,65,297
355030855000134,1,116,59,125,125,97,347
355030855000135,1,180,82,172,172,120,464
355030855000136,1,105,49,83,83,50,216
355030855000138,1,428,143,315,315,144,774
355030855000139,2,152,79,157,157,101,415
355030855000140,3,157,44,211,211,145,567
355030855000141,3,72,99,181,181,55,417
355030855000142,1,21,15,46,46,35,127
355030855000143,8,77,54,102,102,61,265
355030855000144,1,0,0,0,0,0,0
355030855000145,8,29,18,22,22,23,67
355030855000146,8,59,15,53,53,30,136
355030855000148,8,27,3,33,33,17,83
355030855000149,8,14,8,14,14,11,39
355030855000150,8,26,12,16,16,17,49
355030855000151,1,128,54,156,156,84,396
355030855000152,8,94,49,110,110,55,275
355030855000153,8,101,39,65,65,39,169
355030855000155,8,4,3,6,6,9,21
355030855000156,8,31,11,19,19,11,49
355030855000157,8,91,45,83,83,50,216
355030855000158,8,26,13,24,24,35,83
355030855000160,8,0,0,0,0,0,0
355030855000162,1,8,3,9,9,9,27
355030855000163,1,68,40,82,82,81,245
355030855000165,1,40,11,42,42,31,115
355030855000166,8,35,23,36,36,27,99
355030855000170,8,15,11,22,22,25,69
355030855000171,8,24,24,21,21,12,54
355030855000180,8,33,12,25,25,8,58
355030855000182,8,40,14,52,52,18,122
355030855000183,8,16,5,9,9,10,28
355030855000185,8,0,0,0,0,0,0
355030855000186,1,87,29,78,78,57,213
355030855000187,8,25,4,25,25,12,62
355030855000188,3,90,35,107,107,54,268
355030855000193,1,22,10,30,30,19,79
355030855000196,1,34,5,24,24,6,54
355030855000200,8,16,6,18,18,11,47
355030855000201,8,13,7,15,15,9,39
355030855000204,8,14,3,5,5,13,23
355030855000205,8,3,7,11,11,1,23
355030855000206,8,31,19,31,31,21,83
355030855000208,8,61,27,42,42,21,105
355030855000212,8,46,27,34,34,16,84
355030855000213,8,8,5,13,13,6,32
355030855000214,8,363,175,311,311,202,824
355030855000215,8,32,21,36,36,22,94
355030855000216,8,48,19,49,49,26,124
355030855000217,8,45,16,33,33,17,83
355030855000218,8,7,6,9,9,9,27
355030855000219,1,14,12,28,28,15,71
355030855000220,1,110,48,113,113,69,295
355030855000221,8,0,0,0,0,0,0
355030855000222,8,5,0,6,6,0,12
355030855000223,8,0,0,0,0,0,0
355030855000224,8,7,1,6,6,2,14
355030855000225,8,29,9,26,26,15,67
355030855000226,8,39,15,29,29,23,81
355030855000227,8,0,0,0,0,0,0
355030855000228,8,13,13,16,16,24,56
355030855000229,8,28,14,24,24,19,67
355030855000230,3,100,48,106,106,82,294
355030855000231,3,54,17,56,56,33,145
355030855000232,8,12,3,7,7,5,19
355030855000233,8,12,6,7,7,11,25
355030855000234,8,18,3,10,10,7,27
355030855000235,8,19,10,16,16,11,43
355030855000236,8,27,10,23,23,29,75
355030855000237,1,73,37,61,61,55,177
355030855000239,8,0,0,0,0,0,0
355030855000240,3,0,0,0,0,0,0
355030855000241,8,10,4,13,13,11,37
355030855000245,8,5,3,10,10,2,22
355030855000246,8,3,4,5,5,1,11
355030855000247,8,49,19,30,30,25,85
355030855000248,8,139,61,126,126,112,364
355030855000249,8,59,29,84,84,35,203
355030855000250,1,22,13,27,27,12,66
355030855000251,1,11,8,22,22,16,60
355030855000253,8,75,36,44,44,45,133
355030855000255,1,195,63,176,176,64,416
355030855000256,8,7,3,5,5,2,12
355030855000257,8,0,0,0,0,0,0
355030855000258,8,11,2,7,7,8,22
355030855000264,1,85,34,72,72,59,203
355030855000266,8,52,37,67,67,25,159
355030855000268,1,31,9,20,20,15,55
355030855000270,8,90,47,86,86,72,244
355030855000271,8,38,18,46,46,53,145
355030855000272,4,200,76,122,122,86,330
355030855000273,3,137,61,111,111,83,305
355030855000274,8,0,0,0,0,0,0
355030855000275,8,277,104,173,173,119,465
355030855000276,8,0,0,0,0,0,0
355030855000277,8,1,0,3,3,3,9
355030855000278,8,2,2,3,3,4,10
355030855000279,8,10,4,19,19,10,48
355030855000283,8,25,13,29,29,19,77
355030855000285,8,4,0,4,4,4,12
355030855000287,3,108,55,110,110,53,273
355030855000289,8,154,43,98,98,51,247
355030855000291,3,48,27,52,52,27,131
355030855000293,3,57,30,47,47,34,128
355030855000294,8,0,0,0,0,0,0
355030855000295,3,133,57,107,107,59,273
355030855000297,8,22,9,37,37,10,84
355030855000298,8,0,0,0,0,0,0
355030855000300,8,12,9,17,17,8,42
355030855000301,8,11,6,11,11,4,26
355030855000302,8,162,38,134,134,80,348
355030855000304,8,0,0,0,0,0,0
355030855000307,8,49,17,34,34,18,86
355030855000311,8,0,0,0,0,0,0
355030855000312,4,114,65,92,92,65,249
355030855000316,8,27,8,16,16,16,48
355030855000319,1,422,208,519,519,190,1228
355030855000320,1,71,29,51,51,37,139
355030855000321,1,98,42,90,90,55,235
355030855000322,1,113,43,78,78,28,184
355030855000323,1,70,27,60,60,35,155
355030855000324,1,156,55,113,113,55,281
355030855000325,1,238,86,234,234,84,552
355030855000326,1,52,25,54,54,29,137
355030855000327,1,22,14,27,27,26,80
355030855000328,1,111,68,114,114,66,294
355030855000329,1,160,79,175,175,75,425
355030855000330,1,122,43,124,124,58,306
355030855000331,1,96,47,70,70,49,189
355030855000332,1,139,84,139,139,83,361
355030855000333,1,41,22,48,48,27,123
355030855000334,1,161,64,108,108,58,274
355030855000335,1,81,46,74,74,66,214
355030855000336,1,53,22,58,58,35,151
355030856000001,1,108,58,141,141,121,403
355030856000002,1,169,117,218,218,181,617
355030856000003,1,80,46,138,138,102,378
355030856000004,1,80,46,109,109,96,314
355030856000005,1,127,73,165,165,101,431
355030856000006,1,62,38,91,91,127,309
355030856000007,1,81,33,97,97,81,275
355030856000008,1,78,49,106,106,136,348
355030856000009,1,101,54,132,132,105,369
355030856000010,1,107,75,150,150,115,415
355030856000011,1,74,60,105,105,102,312
355030856000012,1,71,39,115,115,75,305
355030856000013,1,85,55,112,112,94,318
355030856000014,1,60,38,80,80,51,211
355030856000015,1,87,54,140,140,106,386
355030856000016,1,65,30,92,92,54,238
355030856000017,1,67,72,117,117,64,298
355030856000018,1,198,109,237,237,147,621
355030856000019,1,82,54,139,139,113,391
355030856000020,1,303,184,341,341,196,878
355030856000021,1,139,70,175,175,121,471
355030856000022,1,68,19,126,126,55,307
355030856000023,1,147,57,100,100,55,255
355030856000024,1,44,18,49,49,34,132
355030856000025,1,137,79,134,134,80,348
355030856000026,1,97,43,120,120,67,307
355030856000027,1,55,34,80,80,67,227
355030856000028,1,124,51,105,105,50,260
355030857000001,1,198,119,238,238,197,673
355030857000002,1,89,45,90,90,75,255
355030857000003,1,283,126,228,228,138,594
355030857000004,1,181,79,176,176,147,499
355030857000005,1,216,104,274,274,190,738
355030857000006,1,136,82,220,220,177,617
355030857000007,1,176,89,241,241,141,623
355030857000008,1,73,43,110,110,85,305
355030857000009,1,38,26,57,57,41,155
355030857000010,1,231,111,236,236,156,628
355030857000011,1,127,73,161,161,125,447
355030857000012,1,129,55,170,170,126,466
355030857000013,1,154,79,199,199,121,519
355030857000014,1,0,0,0,0,0,0
355030857000015,1,305,119,441,441,158,1040
355030857000016,1,91,34,99,99,63,261
355030857000017,1,75,23,127,127,58,312
355030857000018,1,104,51,131,131,75,337
355030857000019,1,217,121,312,312,198,822
355030857000020,1,233,106,226,226,168,620
355030857000021,1,136,64,141,141,107,389
355030857000022,1,171,96,185,185,86,456
355030857000023,1,156,80,166,166,88,420
355030857000024,1,204,92,216,216,191,623
355030857000025,1,275,157,339,339,299,977
355030857000026,1,264,121,320,320,219,859
355030857000027,1,121,64,200,200,121,521
355030857000028,1,215,108,243,243,137,623
355030857000029,1,196,114,259,259,200,718
355030857000030,1,152,78,171,171,114,456
355030857000031,1,62,67,114,114,41,269
355030857000032,1,150,82,201,201,167,569
355030857000033,1,111,48,173,173,79,425
355030857000034,1,138,67,170,170,110,450
355030857000035,1,396,182,401,401,197,999
355030857000036,1,210,132,288,288,201,777
355030857000037,1,157,87,182,182,132,496
355030857000038,1,584,190,481,481,152,1114
355030857000039,1,64,25,100,100,62,262
355030857000040,1,88,48,96,96,50,242
355030857000041,1,224,113,258,258,136,652
355030857000042,1,62,36,82,82,61,225
355030857000043,1,58,29,101,101,47,249
355030857000044,1,79,51,67,67,58,192
355030857000045,1,141,61,180,180,114,474
355030857000046,1,70,56,122,122,106,350
355030857000047,1,210,101,267,267,210,744
355030857000048,1,249,130,340,340,205,885
355030857000049,1,61,23,90,90,67,247
355030857000050,1,183,59,233,233,141,607
355030857000051,1,237,66,272,272,129,673
355030857000052,1,142,116,261,261,209,731
355030857000053,1,158,59,152,152,95,399
355030857000054,1,145,71,172,172,111,455
355030857000055,1,176,89,207,207,176,590
355030857000056,1,375,162,225,225,132,582
355030857000057,1,134,75,110,110,79,299
355030857000058,1,143,59,168,168,122,458
355030857000059,1,111,68,122,122,121,365
355030857000060,1,121,41,136,136,91,363
355030857000061,1,97,34,89,89,69,247
355030857000062,1,146,80,180,180,132,492
355030857000063,1,146,52,164,164,127,455
355030857000064,1,166,69,191,191,163,545
355030857000065,1,170,94,230,230,204,664
355030857000066,1,112,55,160,160,110,430
355030857000067,1,147,78,147,147,141,435
355030857000068,1,137,83,171,171,108,450
355030857000069,1,180,49,161,161,92,414
355030857000070,1,385,162,341,341,207,889
355030857000071,1,101,47,123,123,66,312
355030857000072,1,176,82,187,187,128,502
355030857000073,1,110,58,148,148,97,393
355030857000074,1,68,21,107,107,53,267
355030857000075,1,88,39,118,118,66,302
355030857000076,1,83,52,132,132,103,367
355030857000077,1,115,40,82,82,41,205
355030857000079,1,140,85,135,135,111,381
355030857000080,1,153,89,140,140,128,408
355030857000081,1,180,94,168,168,144,480
355030857000082,1,373,154,307,307,220,834
355030857000083,1,207,93,170,170,133,473
355030857000084,1,104,44,85,85,43,213
355030857000085,1,57,22,49,49,53,151
355030857000086,1,134,53,72,72,47,191
355030857000088,4,0,0,0,0,0,0
355030857000089,1,136,50,79,79,23,181
355030857000091,1,58,26,56,56,31,143
355030857000092,1,45,16,37,37,16,90
355030857000093,1,54,20,47,47,19,113
355030857000094,1,18,10,22,22,15,59
355030857000095,1,115,40,99,99,57,255
355030857000096,1,57,22,57,57,18,132
355030858000001,1,170,68,199,199,125,523
355030858000002,1,81,34,92,92,103,287
355030858000003,1,165,78,228,228,192,648
355030858000004,1,146,70,175,175,98,448
355030858000005,1,5,5,25,25,17,67
355030858000006,1,40,24,41,41,35,117
355030858000007,1,212,85,192,192,111,495
355030858000008,1,227,134,211,211,167,589
355030858000009,1,118,66,132,132,74,338
355030858000010,1,93,37,65,65,58,188
355030858000011,1,145,78,154,154,140,448
355030858000012,1,8,6,11,11,9,31
355030858000013,1,96,45,103,103,57,263
355030858000014,1,169,93,147,147,86,380
355030858000015,1,133,74,184,184,134,502
355030858000016,1,160,89,226,226,164,616
355030858000017,1,166,86,225,225,174,624
355030858000018,1,109,55,142,142,125,409
355030858000019,1,98,62,107,107,98,312
355030858000020,1,164,65,168,168,89,425
355030858000021,1,93,57,100,100,60,260
355030858000022,1,108,67,180,180,182,542
355030858000023,1,122,76,151,151,103,405
355030858000024,1,329,159,291,291,140,722
355030858000025,1,195,85,206,206,106,518
355030858000026,1,297,95,456,456,220,1132
355030858000027,1,254,120,281,281,185,747
355030858000028,1,108,42,143,143,67,353
355030858000029,1,82,54,119,119,95,333
355030858000030,1,79,34,81,81,78,240
355030858000031,1,188,82,180,180,80,440
355030858000032,1,70,32,64,64,37,165
355030858000033,1,63,40,68,68,13,149
355030858000034,1,39,25,23,23,18,64
355030858000035,1,358,169,317,317,134,768
355030858000036,1,199,77,173,173,56,402
355030858000037,1,160,60,119,119,77,315
355030858000038,1,162,72,145,145,69,359
355030858000039,1,162,78,162,162,57,381
355030858000040,1,150,65,109,109,54,272
355030858000041,1,64,25,58,58,31,147
355030858000042,1,98,42,103,103,46,252
355030858000043,1,112,60,109,109,58,276
355030858000044,1,180,75,143,143,84,370
355030858000045,1,47,37,47,47,29,123
355030858000046,1,117,51,89,89,53,231
355030858000047,1,78,36,69,69,39,177
355030858000048,1,75,32,88,88,43,219
355030858000049,1,241,121,226,226,120,572
355030858000050,1,244,99,271,271,111,653
355030858000051,1,107,49,154,154,69,377
355030858000052,1,63,55,83,83,66,232
355030858000053,1,125,75,150,150,131,431
355030858000054,1,216,100,201,201,151,553
355030858000055,1,230,126,213,213,105,531
355030858000056,1,138,59,152,152,94,398
355030858000057,1,187,77,150,150,118,418
355030858000058,1,103,55,138,138,75,351
355030858000059,1,83,38,85,85,62,232
355030858000060,1,388,150,353,353,232,938
355030858000061,1,136,52,124,124,95,343
355030858000062,1,189,77,206,206,147,559
355030858000063,1,59,41,85,85,74,244
355030858000064,1,69,40,120,120,85,325
355030858000065,1,135,51,134,134,77,345
355030858000066,1,106,69,130,130,84,344
355030858000067,1,157,85,183,183,108,474
355030858000068,1,128,48,123,123,103,349
355030858000069,1,67,37,72,72,38,182
355030858000070,1,291,131,270,270,142,682
355030858000071,1,30,12,31,31,22,84
355030858000072,1,64,30,76,76,45,197
355030858000073,1,64,39,97,97,83,277
355030858000074,1,135,86,199,199,107,505
355030858000075,1,374,178,303,303,154,760
355030858000076,1,201,109,154,154,105,413
355030858000077,1,54,29,62,62,28,152
355030858000078,1,31,18,40,40,22,102
355030858000079,1,271,137,248,248,191,687
355030858000080,1,112,74,143,143,131,417
355030858000081,1,128,53,149,149,88,386
355030858000082,1,143,59,146,146,104,396
355030858000083,1,117,92,152,152,165,469
355030858000084,1,113,43,119,119,77,315
355030858000085,1,102,42,129,129,132,390
355030858000086,1,261,136,266,266,196,728
355030858000087,1,229,122,231,231,103,565
355030858000088,1,55,37,68,68,46,182
355030858000089,1,249,82,239,239,79,557
355030858000090,1,22,10,34,34,11,79
355030858000091,1,181,116,232,232,187,651
355030858000092,1,158,87,189,189,112,490
355030858000093,1,86,49,102,102,98,302
355030858000094,1,316,163,377,377,224,978
355030858000095,1,158,47,165,165,85,415
355030858000096,1,127,56,135,135,103,373
355030858000097,1,330,145,349,349,158,856
355030858000098,1,96,40,127,127,117,371
355030858000099,1,125,45,144,144,91,379
355030858000100,1,53,26,91,91,71,253
355030858000101,1,62,36,75,75,34,184
355030858000102,1,132,61,135,135,138,408
355030858000103,1,223,98,271,271,157,699
355030858000104,1,254,178,298,298,192,788
355030858000105,1,36,14,23,23,29,75
355030858000106,1,122,61,145,145,100,390
355030858000107,1,261,137,275,275,231,781
355030858000108,1,2,3,2,2,4,8
355030858000109,1,81,44,114,114,107,335
355030858000110,1,90,35,101,101,102,304
355030858000111,1,146,65,204,204,149,557
355030858000112,1,74,29,72,72,64,208
355030858000113,1,140,70,142,142,90,374
355030858000114,1,192,78,265,265,164,694
355030858000115,1,170,76,155,155,101,411
355030858000116,1,281,110,221,221,109,551
355030858000117,1,265,136,321,321,172,814
355030858000118,1,154,58,165,165,68,398
355030858000119,1,129,58,111,111,40,262
355030858000120,1,164,68,161,161,70,392
355030858000121,1,113,43,102,102,33,237
355030858000122,1,308,149,374,374,182,930
355030858000123,1,336,114,345,345,217,907
355030858000124,1,71,33,71,71,53,195
355030858000125,1,169,100,224,224,195,643
355030858000126,1,149,78,209,209,148,566
355030858000127,1,142,61,165,165,145,475
355030858000128,1,215,105,305,305,221,831
355030858000129,1,50,32,74,74,37,185
355030858000130,1,61,12,47,47,13,107
355030858000131,1,77,44,150,150,97,397
355030858000132,1,131,50,186,186,107,479
355030858000133,1,209,77,212,212,56,480
355030858000134,1,211,67,205,205,54,464
355030858000135,1,221,70,204,204,61,469
355030858000136,1,83,42,106,106,37,249
355030858000137,1,90,48,92,92,87,271
355030858000138,1,135,52,136,136,107,379
355030858000139,1,69,42,115,115,88,318
355030858000140,1,99,56,151,151,124,426
355030858000141,1,41,24,65,65,66,196
355030858000142,1,109,59,140,140,131,411
355030858000143,1,114,54,107,107,50,264
355030858000144,1,110,42,136,136,57,329
355030858000145,1,155,74,148,148,81,377
355030858000146,1,89,48,130,130,95,355
355030858000147,1,144,48,148,148,55,351
355030858000148,1,240,89,193,193,112,498
355030858000149,1,39,17,34,34,16,84
355030858000150,1,200,66,176,176,75,427
355030858000151,1,119,57,145,145,136,426
355030858000152,1,97,40,74,74,29,177
355030858000153,1,69,49,78,78,45,201
355030858000154,1,105,46,100,100,63,263
355030858000155,1,106,37,86,86,29,201
355030858000156,1,72,40,87,87,45,219
355030858000157,1,127,67,171,171,117,459
355030858000158,1,109,70,115,115,96,326
355030858000159,1,116,54,146,146,115,407
355030858000160,4,184,75,228,228,129,585
355030858000161,1,80,41,82,82,60,224
355030858000162,1,184,98,176,176,83,435
355030858000163,4,110,56,115,115,80,310
355030858000164,1,153,81,164,164,88,416
355030858000165,1,164,98,184,184,121,489
355030858000166,1,82,45,115,115,73,303
355030858000167,1,68,26,60,60,27,147
355030858000168,1,83,33,100,100,51,251
355030858000169,1,122,47,151,151,57,359
355030858000170,1,109,50,111,111,80,302
355030858000171,1,32,23,69,69,43,181
355030858000172,1,87,52,98,98,43,239
355030858000173,4,134,55,138,138,64,340
355030858000174,1,89,41,93,93,56,242
355030858000175,1,68,50,89,89,83,261
355030858000176,1,120,54,126,126,95,347
355030858000177,1,88,41,76,76,40,192
355030858000178,1,177,94,196,196,113,505
355030858000179,1,229,128,258,258,161,677
355030858000180,1,191,105,232,232,114,578
355030858000181,1,114,65,137,137,55,329
355030858000182,1,102,51,105,105,59,269
355030858000183,1,46,21,38,38,24,100
355030858000184,1,99,47,142,142,106,390
355030858000185,1,269,106,258,258,112,628
355030858000186,1,110,74,136,136,90,362
355030858000187,1,86,26,70,70,19,159
355030858000188,1,228,133,267,267,186,720
355030858000189,1,76,45,120,120,75,315
355030858000190,1,77,41,109,109,58,276
355030858000191,1,185,88,192,192,76,460
355030858000192,1,86,64,127,127,167,421
355030858000193,1,121,60,146,146,97,389
355030858000194,1,123,77,187,187,103,477
355030858000195,1,69,36,70,70,52,192
355030858000196,1,125,47,140,140,43,323
355030858000197,4,64,28,65,65,24,154
355030858000198,1,94,38,114,114,72,300
355030858000199,1,201,91,208,208,112,528
355030858000200,1,304,87,247,247,180,674
355030858000201,1,85,43,82,82,24,188
355030858000202,1,568,226,408,408,155,971
355030858000203,1,94,61,107,107,43,257
355030858000204,1,280,106,245,245,75,565
355030858000205,1,218,85,199,199,87,485
355030858000206,1,264,128,254,254,122,630
355030858000207,1,201,68,172,172,59,403
355030858000208,1,161,73,125,125,62,312
355030858000209,1,164,63,159,159,88,406
355030858000210,1,96,67,127,127,70,324
355030858000211,1,33,12,31,31,20,82
355030858000212,1,53,30,47,47,45,139
355030858000213,1,80,36,100,100,110,310
355030858000214,1,89,58,135,135,116,386
355030858000215,1,49,11,55,55,21,131
355030858000216,1,364,144,386,386,184,956
355030858000217,1,125,75,128,128,107,363
355030858000218,8,0,0,0,0,0,0
355030858000219,4,13,10,22,22,17,61
355030858000220,8,31,15,30,30,11,71
355030858000221,4,9,6,12,12,18,42
355030858000222,4,4,3,4,4,9,17
355030858000223,1,24,9,21,21,12,54
355030858000224,4,80,32,88,88,34,210
355030858000225,1,30,4,22,22,7,51
355030858000226,1,108,31,96,96,29,221
355030858000228,4,12,12,10,10,13,33
355030858000230,1,95,38,113,113,54,280
355030858000231,4,0,0,0,0,0,0
355030858000232,4,87,42,75,75,45,195
355030858000234,1,0,0,0,0,0,0
355030858000235,8,38,20,41,41,10,92
355030858000236,4,7,6,9,9,7,25
355030858000237,4,38,25,52,52,44,148
355030858000238,1,14,3,12,12,10,34
355030858000239,1,64,33,73,73,56,202
355030858000240,4,0,0,0,0,0,0
355030858000243,1,40,16,43,43,28,114
355030858000244,1,76,30,80,80,43,203
355030858000245,1,11,11,15,15,15,45
355030858000246,1,11,1,18,18,8,44
355030858000247,1,119,65,146,146,61,353
355030858000248,1,38,25,43,43,28,114
355030858000249,1,64,28,62,62,38,162
355030858000250,1,96,25,57,57,44,158
355030858000251,1,79,32,65,65,41,171
355030858000252,1,80,25,57,57,26,140
355030858000253,1,17,8,28,28,12,68
355030858000254,1,92,46,94,94,32,220
355030858000255,1,68,12,56,56,35,147
355030858000256,1,38,15,36,36,23,95
355030858000257,1,21,12,27,27,11,65
355030858000258,1,52,32,62,62,25,149
355030858000259,1,95,40,121,121,42,284
355030858000260,1,74,50,115,115,77,307
355030858000261,1,49,16,39,39,17,95
355030858000262,1,54,27,49,49,50,148
355030859000001,1,114,49,172,172,122,466
355030859000002,1,110,50,196,196,129,521
355030859000003,1,77,55,141,141,149,431
355030859000004,1,74,41,105,105,124,334
355030859000005,1,104,59,150,150,130,430
355030859000006,1,91,40,114,114,128,356
355030859000007,1,67,38,124,124,120,368
355030859000008,1,105,66,161,161,162,484
355030859000009,1,90,63,170,170,135,475
355030859000010,1,100,67,175,175,179,529
355030859000011,1,148,85,217,217,180,614
355030859000012,1,60,27,97,97,120,314
355030859000013,1,79,53,132,132,141,405
355030859000014,1,86,39,143,143,129,415
355030859000015,1,174,85,218,218,155,591
355030859000016,1,159,87,218,218,172,608
355030859000017,1,83,62,125,125,186,436
355030859000018,1,69,40,109,109,90,308
355030859000019,1,86,32,134,134,95,363
355030859000020,1,108,61,168,168,122,458
355030859000021,1,64,44,91,91,87,269
355030859000022,1,46,19,82,82,79,243
355030859000023,1,73,34,136,136,117,389
355030859000024,1,119,47,210,210,201,621
355030859000025,1,50,34,81,81,83,245
355030859000026,1,133,50,179,179,136,494
355030859000027,1,114,72,190,190,180,560
355030859000028,1,77,45,135,135,145,415
355030859000029,1,108,57,251,251,112,614
355030859000030,1,90,70,168,168,124,460
355030859000031,1,165,81,251,251,164,666
355030859000032,1,76,60,174,174,90,438
355030859000033,1,61,41,97,97,121,315
355030859000034,1,103,53,165,165,117,447
355030859000035,1,76,69,112,112,138,362
355030859000036,1,105,56,172,172,146,490
355030859000037,1,70,22,121,121,100,342
355030859000038,1,106,52,192,192,168,552
355030859000039,1,89,52,160,160,154,474
355030859000040,1,99,48,145,145,142,432
355030859000041,1,117,52,173,173,150,496
355030859000042,1,131,68,175,175,203,553
355030859000043,1,113,77,157,157,152,466
355030859000044,1,27,17,66,66,50,182
355030859000045,1,213,105,219,219,199,637
355030859000046,1,75,39,112,112,81,305
355030859000047,1,80,51,134,134,135,403
355030859000048,1,109,69,240,240,179,659
355030859000049,1,79,40,120,120,60,300
355030859000050,1,129,68,203,203,183,589
355030859000051,1,27,11,34,34,43,111
355030859000052,1,103,68,183,183,175,541
355030859000053,1,84,40,148,148,142,438
355030859000054,1,101,55,168,168,141,477
355030859000055,1,124,74,184,184,130,498
355030859000056,1,84,53,163,163,129,455
355030859000057,1,60,34,90,90,92,272
355030859000058,1,94,67,142,142,208,492
355030859000059,1,73,45,125,125,128,378
355030859000060,1,86,52,124,124,106,354
355030859000061,1,104,54,161,161,133,455
355030859000062,1,98,65,165,165,155,485
355030859000063,1,105,51,206,206,148,560
355030859000064,1,128,43,189,189,143,521
355030859000065,1,68,46,99,99,111,309
355030859000066,1,83,44,145,145,122,412
355030859000067,1,80,41,120,120,121,361
355030859000068,1,98,52,176,176,118,470
355030859000069,1,61,41,116,116,98,330
355030859000070,1,80,45,134,134,124,392
355030859000071,1,120,68,172,172,197,541
355030859000072,1,103,55,134,134,131,399
355030859000073,1,105,36,125,125,102,352
355030859000074,1,100,49,161,161,163,485
355030859000075,1,90,70,159,159,202,520
355030859000076,1,113,55,132,132,152,416
355030859000077,1,61,47,104,104,117,325
355030859000078,1,116,50,152,152,131,435
355030859000079,1,79,29,120,120,89,329
355030859000080,1,68,53,114,114,138,366
355030859000081,1,113,44,177,177,133,487
355030859000082,1,154,82,275,275,147,697
355030859000083,1,148,80,222,222,137,581
355030859000084,1,79,52,117,117,102,336
355030859000085,1,127,70,181,181,143,505
355030859000086,1,63,31,100,100,86,286
355030859000087,1,64,62,136,136,161,433
355030859000088,1,129,66,194,194,142,530
355030859000089,1,93,66,192,192,137,521
355030859000090,1,74,45,118,118,97,333
355030859000091,1,144,62,161,161,151,473
355030859000092,1,110,79,160,160,176,496
355030859000093,1,70,45,110,110,98,318
355030859000094,1,79,37,111,111,86,308
355030859000095,1,123,55,132,132,159,423
355030859000096,1,61,36,101,101,120,322
355030859000097,1,61,39,110,110,101,321
355030859000098,1,96,42,134,134,101,369
355030859000099,1,102,74,164,164,108,436
355030859000100,1,172,82,251,251,145,647
355030859000101,1,100,68,142,142,130,414
355030859000102,1,98,49,125,125,112,362
355030859000103,1,79,49,135,135,145,415
355030859000104,1,90,45,128,128,140,396
355030859000105,1,102,52,138,138,130,406
355030859000106,1,84,55,121,121,124,366
355030859000107,1,54,30,67,67,72,206
355030859000108,1,60,54,105,105,118,328
355030859000109,1,161,110,206,206,152,564
355030859000110,1,129,66,203,203,148,554
355030859000111,1,129,79,197,197,188,582
355030859000112,1,82,59,125,125,119,369
355030859000113,1,73,58,138,138,136,412
355030859000114,1,117,53,133,133,133,399
355030859000115,1,127,66,174,174,146,494
355030859000116,1,82,80,142,142,135,419
355030859000117,1,32,20,71,71,87,229
355030859000118,1,63,55,111,111,121,343
355030859000119,1,51,40,87,87,88,262
355030859000120,1,53,55,86,86,88,260
355030859000121,1,63,46,96,96,90,282
355030859000122,1,61,38,93,93,148,334
355030859000123,1,61,35,83,83,107,273
355030859000124,1,54,43,112,112,102,326
355030859000125,1,90,47,129,129,122,380
355030859000126,1,47,42,84,84,115,283
355030859000127,1,95,52,118,118,122,358
355030859000128,1,133,52,180,180,125,485
355030859000129,1,87,45,129,129,130,388
355030859000130,1,127,65,181,181,145,507
355030859000131,1,129,79,210,210,200,620
355030859000132,1,147,116,237,237,209,683
355030859000133,1,92,54,141,141,104,386
355030859000134,1,74,46,125,125,95,345
355030859000135,1,47,34,101,101,84,286
355030859000136,1,69,46,80,80,112,272
355030859000137,1,82,47,119,119,113,351
355030859000138,1,58,33,103,103,95,301
355030859000139,1,194,101,196,196,143,535
355030859000140,1,81,32,98,98,104,300
355030859000141,1,211,105,273,273,190,736
355030859000142,1,140,64,112,112,45,269
355030859000143,1,106,62,112,112,70,294
355030859000144,1,147,79,215,215,157,587
355030859000145,1,140,47,155,155,63,373
355030859000146,1,59,33,71,71,72,214
355030859000147,1,149,80,189,189,155,533
355030859000148,1,150,86,178,178,164,520
355030859000149,1,153,64,208,208,176,592
355030859000150,1,151,96,199,199,143,541
355030859000151,1,96,45,121,121,126,368
355030859000152,1,92,68,179,179,113,471
355030859000153,1,138,62,190,190,133,513
355030859000154,1,98,60,152,152,129,433
355030859000155,1,92,42,153,153,132,438
355030859000156,1,238,98,195,195,168,558
355030859000157,1,274,101,261,261,138,660
355030859000158,1,208,106,199,199,86,484
355030859000159,1,176,80,185,185,151,521
355030859000161,1,117,47,109,109,56,274
355030859000162,1,121,57,146,146,114,406
355030859000163,1,110,81,185,185,145,515
355030859000164,1,173,58,296,296,112,704
355030859000165,1,119,55,170,170,124,464
355030859000166,1,84,42,105,105,84,294
355030859000167,1,42,18,68,68,55,191
355030859000168,1,105,57,169,169,121,459
355030859000169,1,95,46,195,195,112,502
355030859000170,1,66,30,131,131,76,338
355030859000171,1,45,28,81,81,75,237
355030859000172,1,130,82,239,239,218,696
355030859000173,1,68,35,91,91,114,296
355030859000174,1,80,53,155,155,95,405
355030859000175,1,32,17,37,37,28,102
355030859000176,1,103,59,127,127,112,366
355030859000177,1,106,51,103,103,100,306
355030859000178,1,92,59,139,139,119,397
355030859000179,1,61,27,120,120,100,340
355030859000180,1,113,48,149,149,76,374
355030859000181,1,84,42,135,135,112,382
355030859000182,1,108,66,127,127,142,396
355030859000183,1,78,41,129,129,119,377
355030859000184,1,99,37,137,137,99,373
355030859000185,1,49,36,93,93,91,277
355030859000186,1,64,34,79,79,90,248
355030859000187,1,67,48,114,114,112,340
355030859000188,1,136,80,171,171,138,480
355030859000189,1,71,45,93,93,69,255
355030859000190,1,26,16,29,29,18,76
355030859000191,1,66,41,110,110,83,303
355030859000192,1,71,43,113,113,87,313
355030859000193,1,22,11,60,60,41,161
355030859000194,1,49,13,135,135,42,312
355030859000195,1,18,6,47,47,7,101
355030859000196,1,25,11,71,71,49,191
355030859000197,1,52,27,95,95,48,238
355030859000198,1,26,5,80,80,20,180
355030859000200,1,21,6,58,58,17,133
355030859000201,1,41,17,76,76,50,202
355030859000202,1,36,17,55,55,62,172
355030859000203,1,17,5,38,38,28,104
355030859000204,1,78,47,64,64,77,205
355030859000205,1,155,61,105,105,50,260
355030859000206,1,119,60,95,95,60,250
355030860000001,1,50,35,92,92,133,317
355030860000002,1,88,59,216,216,210,642
355030860000003,1,131,75,206,206,209,621
355030860000004,1,94,43,193,193,144,530
355030860000005,1,61,57,98,98,162,358
355030860000006,1,46,30,136,136,93,365
355030860000007,1,51,25,106,106,124,336
355030860000008,1,29,37,99,99,70,268
355030860000009,1,59,23,185,185,121,491
355030860000010,1,49,15,114,114,97,325
355030860000011,1,100,46,199,199,198,596
355030860000012,1,106,47,171,171,169,511
355030860000013,1,31,15,84,84,81,249
355030860000014,1,51,33,130,130,125,385
355030860000015,1,65,36,102,102,150,354
355030860000016,1,41,24,80,80,110,270
355030860000017,1,48,18,152,152,96,400
355030860000018,1,30,32,72,72,92,236
355030860000019,1,41,27,168,168,103,439
355030860000020,1,53,44,140,140,142,422
355030860000021,1,31,26,93,93,105,291
355030860000022,1,56,37,106,106,113,325
355030860000023,1,47,30,159,159,121,439
355030860000024,1,48,33,185,185,129,499
355030860000025,1,47,24,90,90,117,297
355030860000026,1,89,48,158,158,144,460
355030860000027,1,102,56,178,178,177,533
355030860000028,1,69,36,158,158,140,456
355030860000029,1,63,27,90,90,100,280
355030860000030,1,66,80,156,156,151,463
355030860000031,1,41,30,94,94,71,259
355030860000032,1,36,22,93,93,72,258
355030860000033,1,49,23,102,102,91,295
355030860000034,1,48,30,131,131,96,358
355030860000035,1,49,34,147,147,126,420
355030860000036,1,95,68,189,189,221,599
355030860000037,1,47,39,109,109,99,317
355030860000038,1,22,21,110,110,75,295
355030860000039,1,86,56,258,258,196,712
355030860000040,1,65,40,143,143,140,426
355030860000041,1,101,47,198,198,176,572
355030860000042,1,145,84,232,232,256,720
355030860000043,1,86,32,184,184,157,525
355030860000044,1,62,48,178,178,142,498
355030860000045,1,82,42,123,123,146,392
355030860000046,1,61,32,110,110,123,343
355030860000047,1,21,44,81,81,79,241
355030860000048,1,41,52,135,135,125,395
355030860000049,1,69,55,139,139,154,432
355030860000050,1,39,29,63,63,97,223
355030860000051,1,87,33,114,114,168,396
355030860000052,1,53,36,132,132,112,376
355030860000053,1,48,44,132,132,153,417
355030860000054,1,108,41,163,163,115,441
355030860000055,1,74,28,184,184,182,550
355030860000056,1,79,49,132,132,155,419
355030860000057,1,65,38,120,120,123,363
355030860000058,1,60,36,141,141,138,420
355030860000059,1,37,21,114,114,91,319
355030860000060,1,53,44,143,143,163,449
355030860000061,1,47,37,128,128,115,371
355030860000062,1,54,43,136,136,144,416
355030860000063,1,59,37,133,133,101,367
355030860000064,1,160,68,238,238,221,697
355030860000065,1,47,30,147,147,109,403
355030860000066,1,89,46,205,205,153,563
355030860000067,1,129,71,217,217,231,665
355030860000068,1,74,32,205,205,139,549
355030860000069,1,123,42,282,282,155,719
355030860000070,1,56,36,94,94,72,260
355030860000071,1,32,28,86,86,83,255
355030860000072,1,49,32,75,75,90,240
355030860000073,1,100,74,141,141,171,453
355030860000074,1,24,39,62,62,43,167
355030860000075,1,47,45,75,75,114,264
355030860000076,1,58,71,100,100,107,307
355030860000077,1,83,61,120,120,144,384
355030860000078,1,36,47,66,66,115,247
355030860000079,1,30,18,41,41,57,139
355030860000080,1,37,25,111,111,116,338
355030860000081,1,73,46,159,159,136,454
355030860000082,1,96,40,152,152,152,456
355030860000083,1,68,54,162,162,144,468
355030860000084,1,34,23,98,98,75,271
355030860000085,1,67,34,162,162,138,462
355030860000086,1,23,25,113,113,75,301
355030860000087,1,81,36,220,220,167,607
355030860000088,1,49,32,102,102,94,298
355030860000089,1,61,25,194,194,103,491
355030860000090,1,25,11,76,76,68,220
355030860000091,1,62,30,127,127,126,380
355030860000092,1,49,43,148,148,151,447
355030860000093,1,88,44,143,143,141,427
355030860000094,1,111,46,157,157,184,498
355030860000095,1,46,34,111,111,83,305
355030860000096,1,32,28,67,67,65,199
355030860000097,1,88,51,206,206,140,552
355030860000098,1,74,35,143,143,133,419
355030860000099,1,75,63,122,122,171,415
355030860000100,1,37,55,99,99,93,291
355030860000101,1,79,46,116,116,137,369
355030860000102,1,49,52,103,103,108,314
355030860000103,1,34,42,85,85,95,265
355030860000104,1,43,56,116,116,136,368
355030860000105,1,115,45,139,139,132,410
355030860000106,1,49,42,136,136,161,433
355030860000107,1,40,36,115,115,59,289
355030860000108,1,87,61,185,185,161,531
355030860000109,1,19,24,129,129,78,336
355030860000110,1,76,47,104,104,118,326
355030860000111,1,178,96,167,167,175,509
355030860000112,1,222,127,244,244,211,699
355030860000113,1,112,54,198,198,174,570
355030860000114,1,76,40,222,222,121,565
355030860000115,1,67,36,197,197,126,520
355030860000116,1,117,54,285,285,196,766
355030860000117,1,54,17,128,128,76,332
355030860000118,1,49,25,136,136,119,391
355030860000119,1,90,38,173,173,119,465
355030860000120,1,32,18,67,67,70,204
355030860000121,1,64,52,106,106,124,336
355030860000122,1,55,32,112,112,135,359
355030860000123,1,31,27,42,42,90,174
355030860000124,1,50,35,97,97,133,327
355030860000125,1,55,42,79,79,126,284
355030860000126,1,37,52,102,102,81,285
355030860000127,1,54,36,108,108,141,357
355030860000128,1,26,32,61,61,68,190
355030860000129,1,69,51,117,117,128,362
355030860000130,1,147,85,191,191,172,554
355030860000131,1,102,61,183,183,141,507
355030860000132,1,26,20,55,55,66,176
355030860000133,1,83,54,194,194,111,499
355030860000134,1,47,44,141,141,125,407
355030860000135,1,48,49,136,136,134,406
355030860000136,1,27,12,47,47,28,122
355030860000137,1,46,16,92,92,48,232
355030860000138,1,57,31,77,77,87,241
355030860000139,1,28,31,58,58,99,215
355030860000140,1,69,30,156,156,113,425
355030860000141,1,5,10,56,56,27,139
355030860000142,1,43,30,67,67,81,215
355030860000143,1,38,15,122,122,87,331
355030860000144,1,20,8,61,61,54,176
355030860000145,1,23,22,72,72,71,215
355030860000146,1,37,26,93,93,94,280
355030860000147,1,12,4,66,66,36,168
355030860000148,1,16,8,49,49,34,132
355030860000149,1,54,30,83,83,108,274
355030860000150,1,62,38,143,143,116,402
355030860000151,1,23,20,85,85,49,219
355030860000152,1,27,25,59,59,72,190
355030860000153,1,33,9,55,55,54,164
355030860000154,1,37,29,89,89,87,265
355030860000155,1,31,12,64,64,40,168
355030860000156,1,31,30,55,55,87,197
355030860000157,1,1,5,58,58,30,146
355030860000158,1,146,56,214,214,211,639
355030860000159,1,26,23,59,59,55,173
355030860000160,1,29,16,50,50,78,178
355030860000161,1,143,70,217,217,209,643
355030860000162,1,56,26,136,136,93,365
355030860000163,1,26,22,50,50,70,170
355030860000164,1,43,38,71,71,98,240
355030860000165,1,16,17,56,56,61,173
355030860000166,1,10,11,44,44,50,138
355030860000167,1,10,9,69,69,29,167
355030860000168,1,32,14,90,90,61,241
355030860000169,1,27,4,93,93,37,223
355030860000170,1,117,55,213,213,195,621
355030860000171,1,29,25,57,57,58,172
355030860000172,1,47,31,96,96,122,314
355030860000173,1,28,19,56,56,43,155
355030860000174,1,27,21,54,54,51,159
355030860000175,1,32,27,98,98,92,288
355030860000176,1,56,27,93,93,94,280
355030860000177,1,2,4,49,49,26,124
355030860000178,1,16,5,112,112,25,249
355030860000179,1,25,25,87,87,74,248
355030860000180,1,42,34,54,54,94,202
355030860000181,1,10,62,48,48,21,117
355030860000182,1,31,24,44,44,70,158
355030860000183,1,87,56,132,132,92,356
355030860000184,1,54,17,129,129,63,321
355030860000185,1,16,19,55,55,52,162
355030860000186,1,40,31,122,122,101,345
355030860000187,1,37,19,72,72,70,214
355030860000188,1,70,24,80,80,91,251
355030860000189,1,22,14,45,45,65,155
355030860000190,1,8,9,28,28,35,91
355030860000191,1,43,35,65,65,101,231
355030860000192,1,13,7,44,44,25,113
355030860000193,1,37,19,106,106,54,266
355030860000194,1,42,13,132,132,63,327
355030860000195,1,93,35,178,178,101,457
355030860000196,1,0,2,27,27,17,71
355030860000197,1,41,33,75,75,93,243
355030860000198,1,27,26,106,106,68,280
355030860000199,1,41,17,104,104,57,265
355030860000200,1,66,36,161,161,115,437
355030860000201,1,116,47,205,205,123,533
355030860000202,1,23,21,73,73,71,217
355030860000203,1,28,23,69,69,76,214
355030860000204,1,73,29,167,167,98,432
355030860000205,1,72,43,149,149,137,435
355030860000206,1,15,39,61,61,76,198
355030860000207,1,59,28,157,157,99,413
355030860000208,1,79,52,190,190,159,539
355030860000209,1,92,50,210,210,184,604
355030860000210,1,23,18,60,60,67,187
355030860000211,1,35,29,67,67,69,203
355030860000212,1,36,28,60,60,60,180
355030860000213,1,46,15,115,115,58,288
355030860000214,1,67,35,195,195,86,476
355030860000215,1,21,10,32,32,17,81
355030860000216,1,33,13,27,27,41,95
355030860000217,1,17,10,32,32,27,91
355030860000218,1,32,32,89,89,69,247
355030861000001,1,141,69,187,187,166,540
355030861000002,1,192,95,201,201,192,594
355030861000003,1,54,24,65,65,44,174
355030861000004,1,72,36,111,111,86,308
355030861000005,1,125,70,184,184,128,496
355030861000006,1,164,85,190,190,160,540
355030861000007,1,238,110,262,262,172,696
355030861000008,1,201,89,242,242,159,643
355030861000009,1,143,76,197,197,159,553
355030861000010,1,93,38,112,112,98,322
355030861000011,1,117,48,124,124,95,343
355030861000012,1,136,65,173,173,140,486
355030861000013,1,183,103,210,210,222,642
355030861000014,1,94,41,136,136,85,357
355030861000015,1,188,57,201,201,127,529
355030861000016,1,205,101,201,201,167,569
355030861000017,1,162,77,180,180,106,466
355030861000018,1,135,91,185,185,203,573
355030861000019,1,143,74,231,231,169,631
355030861000020,1,120,51,142,142,85,369
355030861000021,1,46,27,60,60,42,162
355030861000022,1,142,82,171,171,120,462
355030861000023,1,134,77,155,155,130,440
355030861000024,1,138,82,183,183,149,515
355030861000025,1,131,70,142,142,107,391
355030861000026,1,175,98,199,199,129,527
355030861000027,1,256,122,297,297,177,771
355030861000028,1,108,52,125,125,130,380
355030861000029,1,115,50,135,135,88,358
355030861000030,1,113,61,100,100,69,269
355030861000031,1,115,76,168,168,151,487
355030861000032,1,253,133,225,225,133,583
355030861000033,1,225,114,169,169,98,436
355030861000034,1,187,98,240,240,194,674
355030861000035,1,100,31,82,82,48,212
355030861000036,1,62,36,67,67,49,183
355030861000037,1,79,50,117,117,81,315
355030861000038,1,152,79,160,160,125,445
355030861000039,1,103,62,120,120,78,318
355030861000040,1,145,69,128,128,76,332
355030861000041,1,156,72,160,160,131,451
355030861000042,1,159,92,160,160,129,449
355030861000043,1,74,62,89,89,58,236
355030861000044,1,269,139,255,255,160,670
355030861000045,1,108,54,124,124,80,328
355030861000046,1,102,59,117,117,75,309
355030861000047,1,117,66,102,102,65,269
355030861000048,1,82,53,128,128,74,330
355030861000049,1,153,27,131,131,100,362
355030861000050,1,54,31,76,76,50,202
355030861000051,1,204,123,219,219,210,648
355030861000052,1,262,114,338,338,137,813
355030861000053,1,164,83,213,213,98,524
355030861000054,1,242,97,265,265,191,721
355030861000055,1,257,104,281,281,167,729
355030861000056,1,272,141,270,270,119,659
355030861000057,1,57,32,73,73,49,195
355030861000058,1,335,136,288,288,137,713
355030861000059,1,144,76,155,155,68,378
355030861000060,1,85,46,68,68,44,180
355030861000061,1,401,194,361,361,137,859
355030861000062,1,175,139,204,204,106,514
355030861000063,1,345,135,310,310,99,719
355030861000064,1,209,105,252,252,111,615
355030861000065,1,105,44,113,113,37,263
355030861000066,1,207,108,188,188,115,491
355030861000067,1,272,110,251,251,122,624
355030861000068,1,172,86,187,187,89,463
355030861000069,1,308,129,295,295,107,697
355030861000070,1,226,81,208,208,76,492
355030861000071,1,451,186,457,457,146,1060
355030861000072,1,402,196,372,372,98,842
355030861000073,1,346,134,343,343,117,803
355030861000074,1,215,59,130,130,36,296
355030861000076,8,12,3,14,14,11,39
355030861000078,2,2,1,3,3,5,11
355030861000081,1,238,128,215,215,85,515
355030861000082,1,307,98,271,271,102,644
355030861000083,2,0,0,0,0,0,0
355030861000084,1,184,95,184,184,138,506
355030861000085,1,152,85,177,177,138,492
355030861000086,1,116,60,112,112,92,316
355030861000087,1,112,67,134,134,130,398
355030861000088,1,322,138,340,340,179,859
355030861000089,1,65,33,97,97,86,280
355030861000090,1,46,23,56,56,42,154
355030861000091,1,212,111,205,205,141,551
355030861000092,1,106,81,130,130,116,376
355030861000093,1,232,93,227,227,164,618
355030861000094,1,155,72,144,144,87,375
355030861000095,1,155,78,149,149,105,403
355030861000096,1,81,42,91,91,59,241
355030861000097,1,214,83,182,182,51,415
355030861000098,1,76,37,72,72,38,182
355030861000099,4,20,11,24,24,15,63
355030861000100,4,51,99,68,68,35,171
355030861000101,4,163,79,186,186,93,465
355030861000102,4,121,47,98,98,38,234
355030861000103,1,211,67,250,250,73,573
355030861000104,1,181,80,166,166,107,439
355030861000105,1,208,103,212,212,97,521
355030861000106,1,324,122,327,327,136,790
355030861000108,2,1,1,4,4,4,12
355030861000109,8,0,0,0,0,0,0
355030861000121,2,122,54,89,89,47,225
355030861000124,2,13,10,10,10,5,25
355030861000125,2,41,35,46,46,34,126
355030861000126,3,184,78,146,146,92,384
355030861000127,8,11,5,10,10,5,25
355030861000131,1,69,42,48,48,35,131
355030861000132,1,41,20,28,28,23,79
355030861000133,1,52,13,43,43,18,104
355030861000134,1,146,66,112,112,67,291
355030861000135,1,56,17,40,40,28,108
355030861000136,1,139,71,141,141,72,354
355030861000137,1,33,11,34,34,26,94
355030861000138,1,73,33,50,50,13,113
355030861000139,1,175,41,109,109,26,244
355030861000140,1,119,19,62,62,14,138
355030861000141,1,22,11,24,24,5,53
355030861000142,1,109,44,103,103,46,252
355030861000143,1,77,25,72,72,25,169
355030861000144,1,25,10,26,26,13,65
355030861000145,1,54,21,55,55,20,130
355030862000001,1,14,22,96,96,78,270
355030862000002,1,59,17,132,132,78,342
355030862000003,1,16,9,35,35,40,110
355030862000004,1,30,25,98,98,71,267
355030862000005,1,27,17,76,76,90,242
355030862000006,1,48,28,126,126,73,325
355030862000007,1,38,25,77,77,101,255
355030862000008,1,31,10,86,86,68,240
355030862000009,1,21,17,61,61,43,165
355030862000010,1,21,13,37,37,43,117
355030862000011,1,41,19,116,116,73,305
355030862000012,1,53,13,110,110,56,276
355030862000013,1,38,30,125,125,114,364
355030862000014,1,38,23,87,87,94,268
355030862000015,1,35,27,97,97,65,259
355030862000016,1,31,31,122,122,99,343
355030862000017,1,25,19,75,75,65,215
355030862000018,1,18,15,65,65,63,193
355030862000019,1,17,23,67,67,50,184
355030862000020,1,43,26,77,77,59,213
355030862000021,1,46,26,121,121,84,326
355030862000022,1,63,26,118,118,138,374
355030862000023,1,24,15,63,63,70,196
355030862000024,1,22,17,74,74,65,213
355030862000025,1,34,15,102,102,76,280
355030862000026,1,21,9,40,40,51,131
355030862000027,1,24,18,54,54,48,156
355030862000028,1,56,20,95,95,95,285
355030862000029,1,46,28,85,85,113,283
355030862000030,1,54,40,145,145,109,399
355030862000031,1,0,0,2,2,3,7
355030862000032,1,50,35,99,99,102,300
355030862000033,1,77,55,180,180,169,529
355030862000034,1,51,39,105,105,97,307
355030862000035,1,50,43,145,145,117,407
355030862000036,1,17,22,101,101,86,288
355030862000037,1,28,21,86,86,76,248
355030862000038,1,10,9,36,36,25,97
355030862000039,1,21,16,81,81,68,230
355030862000040,1,31,18,94,94,93,281
355030862000041,1,52,29,154,154,96,404
355030862000042,1,41,21,106,106,49,261
355030862000043,1,33,16,85,85,42,212
355030862000044,1,37,29,95,95,80,270
355030862000045,1,46,20,92,92,64,248
355030862000046,1,36,20,67,67,78,212
355030862000047,1,20,14,77,77,60,214
355030862000048,1,53,35,119,119,119,357
355030862000049,1,92,37,210,210,138,558
355030862000050,1,21,8,49,49,50,148
355030862000051,1,109,48,210,210,163,583
355030862000052,1,10,5,34,34,30,98
355030862000053,1,66,42,133,133,119,385
355030862000054,1,20,14,76,76,54,206
355030862000055,1,37,27,106,106,126,338
355030862000056,1,18,13,85,85,44,214
355030862000057,1,27,17,55,55,27,137
355030862000058,1,23,10,87,87,69,243
355030862000059,1,16,13,104,104,55,263
355030862000060,1,19,13,62,62,59,183
355030862000061,1,46,34,105,105,84,294
355030862000062,1,40,23,117,117,83,317
355030862000063,1,48,30,113,113,103,329
355030862000064,1,32,36,78,78,63,219
355030862000065,1,41,20,93,93,69,255
355030862000066,1,99,51,166,166,131,463
355030862000067,1,22,19,45,45,72,162
355030862000068,1,37,11,83,83,50,216
355030862000069,1,60,48,202,202,103,507
355030862000070,1,43,49,113,113,109,335
355030862000071,1,55,44,105,105,98,308
355030862000072,1,27,15,42,42,47,131
355030862000073,1,52,43,145,145,107,397
355030862000074,1,29,18,58,58,53,169
355030862000075,1,32,24,124,124,80,328
355030862000076,1,37,26,87,87,75,249
355030862000077,1,18,8,71,71,63,205
355030862000078,1,26,24,72,72,70,214
355030862000079,1,58,32,125,125,105,355
355030862000080,1,54,23,112,112,83,307
355030862000081,1,47,44,112,112,153,377
355030862000082,1,33,13,82,82,43,207
355030862000083,1,41,29,145,145,120,410
355030862000084,1,26,17,95,95,70,260
355030862000085,1,28,14,79,79,71,229
355030862000086,1,58,24,77,77,97,251
355030862000087,1,27,24,67,67,63,197
355030862000088,1,37,39,121,121,88,330
355030862000089,1,48,24,129,129,109,367
355030862000090,1,105,43,191,191,109,491
355030862000091,1,46,26,134,134,74,342
355030862000092,1,39,24,121,121,91,333
355030862000093,1,34,19,125,125,51,301
355030862000094,1,18,19,78,78,56,212
355030862000095,1,43,29,60,60,92,212
355030862000096,1,34,18,52,52,76,180
355030862000097,1,45,34,68,68,82,218
355030862000098,1,64,28,98,98,122,318
355030862000099,1,58,39,104,104,119,327
355030862000100,1,66,28,98,98,97,293
355030862000101,1,78,25,122,122,113,357
355030862000102,1,32,32,82,82,76,240
355030862000103,1,40,31,107,107,107,321
355030862000104,1,23,23,59,59,61,179
355030862000105,1,28,16,52,52,61,165
355030862000106,1,44,15,139,139,116,394
355030862000107,1,64,28,148,148,85,381
355030862000108,1,33,20,108,108,92,308
355030862000109,1,30,19,73,73,74,220
355030862000110,1,30,15,90,90,100,280
355030862000111,1,35,19,74,74,100,248
355030862000112,1,40,20,74,74,81,229
355030862000113,1,45,15,85,85,99,269
355030862000114,1,27,14,41,41,75,157
355030862000115,1,71,41,128,128,115,371
355030862000116,1,67,25,131,131,102,364
355030862000117,1,38,17,84,84,63,231
355030862000118,1,51,26,53,53,54,160
355030862000119,1,96,38,154,154,143,451
355030862000120,1,64,33,83,83,86,252
355030862000121,1,73,39,109,109,108,326
355030862000122,1,69,42,117,117,125,359
355030862000123,1,23,11,52,52,56,160
355030862000124,1,28,15,116,116,72,304
355030862000125,1,12,9,81,81,31,193
355030862000126,1,17,13,92,92,94,278
355030862000127,1,35,21,66,66,63,195
355030862000128,1,19,14,41,41,58,140
355030862000129,1,25,13,97,97,67,261
355030862000130,1,37,18,78,78,70,226
355030862000131,1,22,20,67,67,70,204
355030862000132,1,79,37,168,168,140,476
355030862000133,1,30,29,111,111,99,321
355030862000134,1,45,14,120,120,69,309
355030862000135,1,17,7,71,71,52,194
355030862000136,1,22,10,49,49,46,144
355030862000137,1,22,24,63,63,66,192
355030862000138,1,12,18,58,58,53,169
355030862000139,1,18,29,90,90,48,228
355030862000140,1,9,14,40,40,17,97
355030862000141,1,47,17,106,106,76,288
355030862000142,1,27,18,73,73,50,196
355030862000143,1,57,44,74,74,52,200
355030862000144,1,48,37,148,148,116,412
355030862000145,1,31,16,84,84,69,237
355030862000146,1,10,17,62,62,34,158
355030862000147,1,49,17,77,77,61,215
355030862000148,1,20,13,85,85,80,250
355030862000149,1,35,27,79,79,79,237
355030862000150,1,6,10,48,48,28,124
355030862000151,1,18,21,45,45,45,135
355030862000152,1,28,15,130,130,51,311
355030862000153,1,17,15,80,80,71,231
355030862000154,1,77,26,139,139,82,360
355030862000155,1,17,7,89,89,63,241
355030862000156,1,26,24,141,141,84,366
355030862000157,1,22,26,54,54,91,199
355030862000158,1,15,14,59,59,64,182
355030862000159,1,32,15,76,76,89,241
355030862000160,1,20,11,36,36,58,130
355030862000161,1,31,14,59,59,71,189
355030862000162,1,17,14,37,37,39,113
355030862000163,1,39,10,77,77,67,221
355030862000164,1,19,11,78,78,41,197
355030862000165,1,11,13,43,43,31,117
355030862000166,1,7,8,48,48,27,123
355030862000167,1,37,32,65,65,69,199
355030862000168,1,46,23,69,69,87,225
355030862000169,1,38,13,51,51,66,168
355030862000170,1,20,27,70,70,54,194
355030862000171,1,35,15,71,71,76,218
355030862000172,1,41,25,95,95,107,297
355030862000173,1,10,10,31,31,27,89
355030863000001,1,461,209,644,644,458,1746
355030863000002,1,184,104,321,321,231,873
355030863000003,1,89,40,122,122,132,376
355030863000004,1,86,56,112,112,134,358
355030863000005,1,84,47,144,144,139,427
355030863000006,1,88,44,115,115,124,354
355030863000007,1,99,63,135,135,108,378
355030863000008,1,49,38,85,85,94,264
355030863000009,1,95,57,138,138,100,376
355030863000010,1,134,91,202,202,231,635
355030863000011,1,72,43,113,113,81,307
355030863000012,1,150,92,242,242,217,701
355030863000013,1,35,19,42,42,39,123
355030863000014,1,65,35,85,85,65,235
355030863000015,1,78,43,126,126,151,403
355030863000016,1,120,72,167,167,151,485
355030863000017,1,75,36,101,101,95,297
355030863000018,1,54,54,119,119,133,371
355030863000019,1,54,38,83,83,82,248
355030863000020,1,20,23,26,26,28,80
355030863000021,1,96,50,118,118,117,353
355030863000022,1,110,51,145,145,113,403
355030863000023,1,115,49,168,168,153,489
355030863000024,1,102,60,115,115,135,365
355030863000025,1,102,65,146,146,131,423
355030863000026,1,111,53,154,154,152,460
355030863000027,1,68,37,110,110,91,311
355030863000028,1,124,62,163,163,172,498
355030863000029,1,110,66,178,178,190,546
355030863000030,1,291,168,523,523,306,1352
355030863000031,1,51,47,115,115,115,345
355030863000032,1,131,72,190,190,171,551
355030863000033,1,107,55,164,164,169,497
355030863000034,1,101,47,127,127,145,399
355030863000035,1,90,43,151,151,82,384
355030863000037,1,149,111,254,254,281,789
355030863000038,1,149,82,224,224,159,607
355030863000039,1,152,80,185,185,129,499
355030863000040,1,139,74,177,177,212,566
355030863000041,1,99,72,151,151,133,435
355030863000042,1,130,78,221,221,188,630
355030863000043,1,84,46,130,130,138,398
355030863000044,1,192,103,235,235,180,650
355030863000045,1,46,29,92,92,74,258
355030863000046,1,99,58,164,164,172,500
355030863000047,1,122,55,135,135,76,346
355030863000048,1,133,69,187,187,137,511
355030863000049,1,80,43,111,111,105,327
355030863000050,1,129,66,203,203,138,544
355030863000051,1,118,59,115,115,97,327
355030863000052,1,133,95,193,193,216,602
355030863000053,1,149,109,207,207,231,645
355030863000054,1,130,73,180,180,179,539
355030863000055,1,71,53,95,95,152,342
355030863000056,1,120,65,193,193,164,550
355030863000057,1,70,40,105,105,94,304
355030863000058,1,77,40,105,105,72,282
355030863000059,1,75,33,124,124,144,392
355030863000060,1,150,40,334,334,96,764
355030863000061,1,229,108,211,211,100,522
355030863000062,1,143,81,314,314,288,916
355030863000063,1,70,65,149,149,170,468
355030863000064,1,90,57,149,149,146,444
355030863000065,1,47,25,61,61,49,171
355030863000066,1,85,36,146,146,71,363
355030863000067,1,118,69,201,201,152,554
355030863000068,1,184,94,291,291,173,755
355030863000069,1,121,70,186,186,145,517
355030863000070,1,122,68,175,175,177,527
355030863000071,1,113,81,172,172,177,521
355030863000072,1,120,64,172,172,147,491
355030863000073,1,217,108,234,234,210,678
355030863000074,1,61,35,76,76,65,217
355030863000075,1,175,73,194,194,149,537
355030863000076,1,90,45,121,121,95,337
355030863000077,1,128,95,175,175,160,510
355030863000078,1,118,62,157,157,146,460
355030863000079,1,121,54,168,168,174,510
355030863000080,1,162,102,184,184,223,591
355030863000081,1,110,59,182,182,149,513
355030863000082,1,122,67,174,174,147,495
355030863000083,1,151,74,191,191,178,560
355030863000084,1,89,72,159,159,159,477
355030863000085,1,176,69,134,134,73,341
355030863000086,1,79,40,127,127,81,335
355030863000087,1,83,49,128,128,120,376
355030863000088,1,155,73,184,184,163,531
355030863000089,1,191,100,222,222,178,622
355030863000090,1,116,73,178,178,191,547
355030863000091,1,87,35,115,115,104,334
355030863000092,1,92,54,140,140,116,396
355030863000093,1,115,71,158,158,128,444
355030863000094,1,96,36,94,94,83,271
355030863000095,1,398,187,347,347,248,942
355030863000096,1,179,60,159,159,131,449
355030863000097,1,145,89,202,202,191,595
355030863000098,1,87,47,85,85,69,239
355030863000099,1,177,90,201,201,177,579
355030863000100,1,123,64,153,153,114,420
355030863000101,1,146,87,186,186,168,540
355030863000102,1,58,27,88,88,95,271
355030863000103,1,95,56,149,149,129,427
355030863000104,1,143,81,241,241,202,684
355030863000105,1,93,52,131,131,126,388
355030863000106,1,107,57,175,175,118,468
355030863000107,1,43,18,45,45,26,116
355030863000108,1,60,50,152,152,186,490
355030863000109,1,98,71,168,168,206,542
355030863000110,1,67,48,174,174,186,534
355030863000111,1,85,76,168,168,209,545
355030863000112,1,125,48,237,237,140,614
355030863000113,1,121,48,220,220,141,581
355030863000114,1,142,51,266,266,105,637
355030863000115,1,198,97,237,237,193,667
355030863000116,1,133,84,176,176,140,492
355030863000117,1,132,71,204,204,152,560
355030863000118,1,178,80,213,213,170,596
355030863000119,1,119,50,126,126,103,355
355030863000120,1,165,79,210,210,160,580
355030863000121,1,142,67,140,140,125,405
355030863000122,1,256,129,275,275,145,695
355030863000123,1,146,72,137,137,87,361
355030863000124,1,225,123,239,239,156,634
355030863000125,1,153,57,145,145,113,403
355030863000126,1,80,45,109,109,105,323
355030863000127,1,221,114,274,274,177,725
355030863000128,1,164,80,199,199,204,602
355030863000129,1,86,62,179,179,153,511
355030863000130,1,98,70,178,178,133,489
355030863000131,1,79,36,117,117,115,349
355030863000132,1,94,55,153,153,167,473
355030863000133,1,80,39,112,112,101,325
355030863000134,1,110,70,194,194,196,584
355030863000135,1,169,85,202,202,162,566
355030863000136,1,150,63,144,144,124,412
355030863000137,1,116,66,150,150,80,380
355030863000138,1,113,61,140,140,129,409
355030863000139,1,83,43,107,107,85,299
355030863000140,1,161,81,231,231,228,690
355030863000141,1,175,88,281,281,208,770
355030863000142,1,183,102,254,254,169,677
355030863000143,1,141,62,139,139,103,381
355030863000144,1,81,27,138,138,119,395
355030863000145,1,146,65,164,164,138,466
355030863000146,1,238,120,223,223,174,620
355030863000147,1,19,7,21,21,15,57
355030863000148,1,123,62,125,125,113,363
355030863000149,1,170,71,261,261,147,669
355030863000150,1,65,27,82,82,80,244
355030863000151,1,130,82,160,160,141,461
355030863000152,1,141,54,131,131,73,335
355030863000153,1,272,127,419,419,286,1124
355030863000154,1,103,51,146,146,174,466
355030863000155,1,236,125,386,386,272,1044
355030863000156,1,122,78,159,159,180,498
355030863000157,1,78,52,99,99,123,321
355030863000158,1,213,98,217,217,162,596
355030863000159,1,113,45,118,118,71,307
355030863000161,1,281,140,330,330,161,821
355030863000162,1,27,16,44,44,29,117
355030863000163,1,211,100,233,233,122,588
355030863000164,1,38,18,40,40,25,105
355030863000165,1,398,152,350,350,156,856
355030863000166,1,168,62,186,186,117,489
355030863000167,1,160,79,185,185,121,491
355030863000168,1,128,68,145,145,64,354
355030863000169,1,174,70,210,210,110,530
355030863000170,1,163,62,187,187,97,471
355030863000171,1,185,102,174,174,92,440
355030863000172,1,330,121,320,320,171,811
355030863000173,1,174,87,152,152,114,418
355030863000175,1,13,11,26,26,11,63
355030863000176,1,80,55,101,101,73,275
355030863000177,1,79,50,159,159,104,422
355030863000178,1,50,32,77,77,66,220
355030863000179,1,45,40,90,90,106,286
355030863000180,1,15,9,39,39,58,136
355030863000181,1,76,43,139,139,117,395
355030863000182,1,94,46,152,152,93,397
355030863000183,1,32,17,45,45,31,121
355030863000184,1,129,66,208,208,171,587
355030863000185,1,51,30,72,72,73,217
355030863000186,1,66,40,123,123,93,339
355030863000187,1,103,58,136,136,99,371
355030863000188,1,126,53,140,140,109,389
355030863000189,1,57,31,81,81,97,259
355030863000190,1,80,50,129,129,110,368
355030863000191,1,67,34,97,97,110,304
355030863000192,1,76,37,101,101,120,322
355030863000193,1,145,72,175,175,140,490
355030863000194,1,42,20,63,63,78,204
355030863000195,1,48,39,95,95,80,270
355030863000196,1,12,18,30,30,39,99
355030863000197,1,72,43,110,110,90,310
355030863000198,1,102,44,121,121,83,325
355030863000199,1,78,37,107,107,86,300
355030863000200,1,59,31,87,87,100,274
355030863000201,1,57,25,64,64,61,189
355030863000202,1,102,53,132,132,122,386
355030863000203,1,28,20,66,66,62,194
355030863000204,1,75,44,124,124,110,358
355030863000205,1,107,37,99,99,102,300
355030863000206,1,19,15,24,24,23,71
355030863000207,1,201,79,171,171,98,440
355030863000208,1,509,237,450,450,258,1158
355030863000209,1,112,54,159,159,112,430
355030863000210,1,110,74,136,136,176,448
355030863000211,1,52,13,71,71,29,171
355030863000212,1,116,47,139,139,102,380
355030863000213,1,96,60,130,130,87,347
355030863000214,1,132,74,155,155,61,371
355030863000215,1,118,70,173,173,113,459
355030863000216,1,44,24,56,56,23,135
355030863000217,1,181,83,174,174,64,412
355030863000218,1,119,34,385,385,109,879
355030863000219,1,91,41,119,119,61,299
355030863000220,1,102,50,87,87,71,245
355030863000221,1,44,27,42,42,39,123
355030863000222,1,8,7,23,23,22,68
355030863000223,1,37,14,120,120,42,282
355030863000224,1,25,11,45,45,81,171
355030863000225,1,24,32,68,68,70,206
355030863000226,1,114,43,298,298,106,702
355030863000227,1,39,6,59,59,40,158
355030863000228,1,119,42,263,263,88,614
355030863000229,1,106,28,266,266,103,635
355030863000230,1,68,16,254,254,59,567
355030863000231,1,161,67,302,302,160,764
355030863000232,1,116,36,227,227,69,523
355030863000233,2,2,4,0,0,0,0
355030863000234,1,72,22,60,60,37,157
355030863000238,2,3,4,6,6,17,29
355030863000242,1,156,51,133,133,39,305
355030863000243,1,68,30,69,69,35,173
355030863000247,1,45,34,55,55,46,156
355030863000248,1,70,26,79,79,50,208
355030863000249,1,28,6,27,27,21,75
355030863000250,1,97,58,89,89,61,239
355030863000251,1,47,26,48,48,37,133
355030863000252,1,190,56,99,99,45,243
355030863000253,1,31,14,30,30,24,84
355030863000254,1,41,9,25,25,11,61
355030863000255,1,186,64,165,165,99,429
355030863000256,1,23,16,21,21,10,52
355030863000257,1,119,64,117,117,58,292
355030863000258,1,208,80,133,133,97,363
355030863000259,1,110,55,83,83,67,233
355030863000260,1,43,25,41,41,23,105
355030863000261,1,26,24,36,36,41,113
355030863000262,1,44,24,39,39,29,107
355030863000263,1,43,19,41,41,28,110
355030863000264,1,27,15,32,32,39,103
355030863000265,1,129,56,129,129,68,326
355030863000266,1,96,41,119,119,63,301
355030863000267,1,172,79,177,177,100,454
355030863000268,1,151,75,139,139,97,375
355030863000269,1,13,7,23,23,15,61
355030864000001,1,117,58,135,135,97,367
355030864000002,1,128,71,167,167,148,482
355030864000003,1,100,67,156,156,144,456
355030864000004,1,75,35,101,101,93,295
355030864000005,1,130,73,181,181,175,537
355030864000006,1,108,42,110,110,102,322
355030864000007,1,126,74,151,151,150,452
355030864000008,1,79,54,109,109,112,330
355030864000009,1,54,33,80,80,70,230
355030864000010,1,106,66,150,150,89,389
355030864000011,1,105,50,136,136,133,405
355030864000012,1,87,66,105,105,107,317
355030864000013,1,67,32,100,100,88,288
355030864000014,1,93,59,111,111,96,318
355030864000015,1,72,49,125,125,95,345
355030864000016,1,163,81,192,192,160,544
355030864000017,1,137,68,180,180,143,503
355030864000018,1,67,34,103,103,62,268
355030864000019,1,89,44,152,152,81,385
355030864000020,1,115,66,136,136,92,364
355030864000021,1,105,49,144,144,119,407
355030864000022,1,70,37,89,89,95,273
355030864000023,1,72,47,96,96,99,291
355030864000024,1,75,46,105,105,101,311
355030864000025,1,91,43,110,110,93,313
355030864000026,1,160,63,204,204,192,600
355030864000027,1,105,51,135,135,100,370
355030864000028,1,89,48,112,112,85,309
355030864000029,1,82,52,145,145,77,367
355030864000030,1,85,44,97,97,61,255
355030864000031,1,119,63,152,152,117,421
355030864000032,1,100,37,118,118,81,317
355030864000033,1,190,87,208,208,144,560
355030864000034,1,50,21,38,38,31,107
355030864000035,1,133,54,140,140,134,414
355030864000036,1,82,48,112,112,116,340
355030864000037,1,165,98,149,149,159,457
355030864000038,1,111,72,177,177,116,470
355030864000039,1,161,93,213,213,200,626
355030864000040,1,123,55,135,135,132,402
355030864000041,1,55,26,88,88,71,247
355030864000042,1,86,56,108,108,93,309
355030864000043,1,53,26,79,79,76,234
355030864000044,1,94,71,166,166,155,487
355030864000045,1,71,44,86,86,88,260
355030864000046,1,51,36,61,61,52,174
355030864000047,1,91,49,129,129,109,367
355030864000048,1,127,76,179,179,154,512
355030864000049,1,134,75,189,189,142,520
355030864000050,1,120,52,146,146,133,425
355030864000051,1,218,127,268,268,204,740
355030864000052,1,156,89,216,216,159,591
355030864000053,1,178,98,207,207,171,585
355030864000054,1,100,42,81,81,66,228
355030864000055,1,147,66,178,178,129,485
355030864000056,1,135,70,147,147,141,435
355030864000057,1,144,71,160,160,138,458
355030864000058,1,144,73,217,217,224,658
355030864000059,1,71,40,125,125,124,374
355030864000060,1,91,37,114,114,70,298
355030864000061,1,74,43,127,127,117,371
355030864000062,1,119,71,162,162,127,451
355030864000063,1,92,42,117,117,101,335
355030864000064,1,79,35,97,97,101,295
355030864000065,1,171,70,170,170,148,488
355030864000066,1,116,50,105,105,75,285
355030864000067,1,104,49,134,134,107,375
355030864000068,1,95,38,161,161,116,438
355030864000069,1,139,54,189,189,144,522
355030864000070,1,71,28,109,109,65,283
355030864000071,1,87,54,121,121,133,375
355030864000072,1,59,40,107,107,87,301
355030864000073,1,106,63,180,180,146,506
355030864000074,1,151,94,193,193,222,608
355030864000075,1,92,47,100,100,61,261
355030864000076,1,58,28,67,67,68,202
355030864000077,1,78,49,103,103,89,295
355030864000078,1,84,45,112,112,92,316
355030864000079,1,105,43,111,111,90,312
355030864000080,1,116,54,144,144,117,405
355030864000081,1,100,63,138,138,118,394
355030864000082,1,117,61,169,169,123,461
355030864000083,1,157,65,167,167,129,463
355030864000084,1,68,55,93,93,89,275
355030864000085,1,156,82,204,204,146,554
355030864000086,1,145,70,158,158,148,464
355030864000087,1,57,29,76,76,64,216
355030864000088,1,40,24,66,66,56,188
355030864000089,1,51,37,78,78,107,263
355030864000090,1,138,75,185,185,184,554
355030864000091,1,121,58,139,139,120,398
355030864000092,1,84,66,122,122,114,358
355030864000093,1,78,43,105,105,92,302
355030864000094,1,91,47,110,110,117,337
355030864000095,1,158,58,176,176,109,461
355030864000096,1,100,66,138,138,118,394
355030864000097,1,117,71,149,149,131,429
355030864000098,1,128,60,182,182,130,494
355030864000099,1,130,54,120,120,94,334
355030864000100,1,180,81,202,202,187,591
355030864000101,1,123,56,161,161,110,432
355030864000102,1,133,75,146,146,143,435
355030864000103,1,121,93,172,172,194,538
355030864000104,1,70,34,90,90,103,283
355030864000105,1,56,34,90,90,76,256
355030864000106,1,96,60,137,137,117,391
355030864000107,1,76,42,112,112,123,347
355030864000108,1,80,33,102,102,94,298
355030864000109,1,137,58,161,161,154,476
355030864000110,1,108,41,105,105,98,308
355030864000111,1,105,42,116,116,70,302
355030864000112,1,38,24,42,42,42,126
355030864000113,1,85,41,124,124,83,331
355030864000114,1,102,57,142,142,103,387
355030864000115,1,126,51,142,142,83,367
355030864000116,1,147,57,167,167,111,445
355030864000117,1,171,72,176,176,191,543
355030864000118,1,116,58,157,157,138,452
355030864000119,1,129,64,171,171,192,534
355030864000120,1,105,48,121,121,128,370
355030864000121,1,67,40,105,105,114,324
355030864000122,1,81,47,146,146,132,424
355030864000123,1,82,48,108,108,98,314
355030864000124,1,88,55,91,91,115,297
355030864000125,1,102,31,101,101,90,292
355030864000126,1,92,65,125,125,105,355
355030864000127,1,131,78,125,125,86,336
355030864000128,1,144,47,161,161,97,419
355030864000129,1,336,98,198,198,106,502
355030864000130,1,100,60,118,118,95,331
355030864000131,1,124,65,127,127,112,366
355030864000132,1,96,47,102,102,103,307
355030864000133,1,88,52,135,135,130,400
355030864000134,1,60,31,111,111,117,339
355030864000135,1,60,33,96,96,76,268
355030864000136,1,128,54,147,147,130,424
355030864000137,1,73,27,110,110,81,301
355030864000138,1,43,34,62,62,50,174
355030864000139,1,82,50,108,108,86,302
355030864000140,1,56,39,95,95,97,287
355030864000141,1,69,51,104,104,95,303
355030864000142,1,72,46,99,99,84,282
355030864000143,1,180,56,113,113,52,278
355030864000144,1,254,67,133,133,46,312
355030864000145,1,117,59,138,138,89,365
355030864000146,1,68,35,59,59,38,156
355030864000147,1,51,29,91,91,38,220
355030864000148,1,87,35,125,125,82,332
355030864000149,1,71,19,175,175,47,397
355030864000150,1,72,41,111,111,99,321
355030864000151,1,67,39,93,93,96,282
355030864000152,1,89,49,127,127,102,356
355030864000153,1,74,44,71,71,71,213
355030864000154,1,86,44,103,103,73,279
355030864000155,1,84,38,113,113,84,310
355030864000156,1,63,35,78,78,89,245
355030864000157,1,75,22,159,159,46,364
355030864000158,1,47,10,79,79,24,182
355030864000159,1,74,39,131,131,80,342
355030864000161,1,54,13,71,71,37,179
355030864000162,1,39,13,27,27,20,74
355030864000163,1,133,55,86,86,59,231
355030865000001,1,205,73,199,199,128,526
355030865000002,1,44,19,37,37,19,93
355030865000003,1,34,23,42,42,15,99
355030865000004,1,161,106,254,254,188,696
355030865000005,1,368,165,317,317,160,794
355030865000006,1,59,20,56,56,25,137
355030865000007,1,28,19,48,48,26,122
355030865000008,1,157,66,193,193,126,512
355030865000009,1,53,19,83,83,40,206
355030865000010,1,44,38,80,80,91,251
355030865000011,1,60,35,122,122,128,372
355030865000012,1,104,58,179,179,161,519
355030865000013,1,306,127,261,261,157,679
355030865000014,1,84,39,109,109,93,311
355030865000015,1,102,47,128,128,79,335
355030865000016,1,74,44,70,70,80,220
355030865000017,1,56,33,94,94,65,253
355030865000018,1,98,50,104,104,87,295
355030865000019,1,269,79,163,163,53,379
355030865000020,1,766,188,526,526,201,1253
355030865000021,1,55,38,45,45,31,121
355030865000022,1,20,12,25,25,26,76
355030865000023,1,53,31,72,72,73,217
355030865000024,1,120,68,156,156,106,418
355030865000025,1,173,76,229,229,104,562
355030865000026,1,104,59,130,130,68,328
355030865000027,1,75,26,110,110,89,309
355030865000028,1,198,97,257,257,134,648
355030865000029,1,207,115,210,210,117,537
355030865000030,1,120,18,125,125,58,308
355030865000031,1,8,4,12,12,9,33
355030865000032,1,143,75,197,197,140,534
355030865000033,1,44,31,57,57,45,159
355030865000034,1,164,80,192,192,108,492
355030865000035,1,67,39,82,82,55,219
355030865000036,1,86,46,104,104,80,288
355030865000037,1,95,58,112,112,83,307
355030865000038,1,136,56,168,168,102,438
355030865000039,1,132,64,124,124,117,365
355030865000040,1,324,149,379,379,199,957
355030865000041,1,49,29,58,58,51,167
355030865000042,1,34,26,73,73,49,195
355030865000043,1,56,29,72,72,68,212
355030865000044,1,130,79,163,163,175,501
355030865000045,1,107,41,67,67,14,148
355030865000046,1,34,11,47,47,33,127
355030865000047,1,37,19,60,60,42,162
355030865000048,1,60,39,96,96,51,243
355030865000049,1,63,20,99,99,44,242
355030865000050,1,87,47,120,120,72,312
355030865000051,1,112,51,117,117,68,302
355030865000052,1,112,22,108,108,69,285
355030865000053,1,115,59,140,140,99,379
355030865000054,1,84,46,112,112,74,298
355030865000055,1,133,48,200,200,108,508
355030865000056,1,76,33,91,91,57,239
355030865000057,1,31,20,36,36,31,103
355030865000058,1,182,101,207,207,98,512
355030865000059,1,64,57,118,118,109,345
355030865000060,1,77,52,109,109,105,323
355030865000061,1,47,32,41,41,44,126
355030865000062,1,122,83,148,148,98,394
355030865000063,1,63,32,76,76,40,192
355030865000064,1,59,42,65,65,76,206
355030865000065,1,143,63,135,135,84,354
355030865000066,1,58,42,71,71,66,208
355030865000067,1,79,45,100,100,53,253
355030865000068,1,79,41,131,131,58,320
355030865000069,1,50,36,77,77,76,230
355030865000070,1,32,18,35,35,35,105
355030865000071,1,45,32,58,58,60,176
355030865000072,1,105,54,289,289,145,723
355030865000073,1,0,0,1,1,3,5
355030865000075,1,45,13,107,107,26,240
355030865000076,1,92,48,113,113,117,343
355030865000077,1,57,28,75,75,98,248
355030865000078,1,127,61,120,120,64,304
355030865000079,1,86,41,122,122,117,361
355030865000080,1,153,72,140,140,83,363
355030865000081,1,48,33,65,65,64,194
355030865000082,1,88,40,130,130,78,338
355030865000083,1,0,0,0,0,2,2
355030865000084,1,84,32,104,104,78,286
355030865000085,1,111,76,161,161,140,462
355030865000086,1,78,27,118,118,76,312
355030865000087,1,112,46,105,105,61,271
355030865000088,1,66,34,89,89,64,242
355030865000089,1,112,78,156,156,107,419
355030865000090,1,144,60,219,219,89,527
355030865000091,1,94,40,120,120,70,310
355030865000092,1,141,90,225,225,136,586
355030865000093,1,41,8,120,120,30,270
355030865000094,1,0,37,0,0,0,0
355030865000095,1,0,57,272,272,62,606
355030865000096,1,125,59,131,131,50,312
355030865000097,1,116,48,156,156,82,394
355030865000098,1,109,47,129,129,60,318
355030865000100,1,41,38,72,72,78,222
355030865000101,1,139,67,144,144,49,337
355030865000102,1,55,33,57,57,36,150
355030865000103,1,129,39,189,189,90,468
355030865000104,1,80,46,130,130,70,330
355030865000105,1,76,42,113,113,91,317
355030865000106,1,73,42,100,100,106,306
355030865000108,1,79,43,125,125,86,336
355030865000110,1,47,15,48,48,33,129
355030865000111,1,120,43,161,161,93,415
355030865000112,1,95,31,205,205,52,462
355030865000113,1,92,46,111,111,46,268
355030865000114,1,43,23,80,80,53,213
355030865000115,1,57,24,84,84,56,224
355030865000116,1,48,16,46,46,25,117
355030865000117,1,120,65,101,101,57,259
355030865000118,1,84,38,62,62,43,167
355030865000119,1,109,55,100,100,55,255
355030865000120,1,138,46,143,143,71,357
355030865000121,1,101,40,111,111,49,271
355030865000122,1,116,64,168,168,94,430
355030865000123,1,68,28,67,67,39,173
355030865000124,1,56,24,66,66,61,193
355030865000125,1,171,73,178,178,99,455
355030865000126,1,185,67,176,176,90,442
355030865000127,1,61,42,93,93,70,256
355030865000128,1,87,52,130,130,78,338
355030865000129,1,57,38,81,81,66,228
355030865000130,1,70,30,147,147,70,364
355030865000131,1,164,65,186,186,117,489
355030865000132,1,91,28,84,84,46,214
355030865000133,1,123,60,146,146,107,399
355030865000134,1,69,32,100,100,68,268
355030865000135,1,108,68,125,125,140,390
355030865000137,1,35,26,63,63,54,180
355030865000138,1,234,96,215,215,72,502
355030865000139,1,269,107,219,219,91,529
355030865000140,1,249,131,218,218,68,504
355030865000141,1,51,27,77,77,62,216
355030865000142,1,51,15,73,73,44,190
355030865000143,1,49,17,70,70,45,185
355030865000144,1,24,9,24,24,31,79
355030865000145,1,61,29,53,53,60,166
355030865000146,1,53,31,62,62,40,164
355030865000147,1,77,48,105,105,119,329
355030865000148,1,45,22,37,37,23,97
355030865000149,1,158,68,160,160,58,378
355030865000150,1,166,55,138,138,73,349
355030865000151,1,33,19,34,34,14,82
355030865000152,1,90,38,50,50,17,117
355030865000153,1,53,29,64,64,70,198
355030865000154,1,47,34,89,89,59,237
355030865000155,1,45,21,75,75,44,194
355030865000156,1,126,50,150,150,91,391
355030865000157,1,82,38,99,99,61,259
355030865000158,1,56,24,71,71,35,177
355030865000159,1,151,29,156,156,109,421
355030865000160,1,89,43,113,113,101,327
355030865000161,1,153,32,147,147,104,398
355030865000162,1,41,23,66,66,58,190
355030865000163,1,48,10,95,95,37,227
355030865000164,1,42,13,90,90,28,208
355030865000165,1,20,5,58,58,6,122
355030865000166,1,67,49,110,110,151,371
355030865000167,1,77,40,108,108,86,302
355030865000168,1,184,91,168,168,113,449
355030865000169,1,70,38,83,83,63,229
355030865000170,1,93,46,67,67,39,173
355030865000171,1,155,59,128,128,50,306
355030865000172,1,133,57,165,165,94,424
355030865000173,1,101,43,104,104,41,249
355030865000174,1,109,46,120,120,76,316
355030865000175,1,130,72,133,133,74,340
355030865000176,1,70,33,88,88,70,246
355030865000177,1,116,65,147,147,95,389
355030865000178,1,122,63,173,173,139,485
355030865000179,1,81,42,105,105,76,286
355030865000180,1,78,26,104,104,58,266
355030865000181,1,60,40,125,125,98,348
355030865000182,1,152,74,171,171,84,426
355030865000183,1,68,18,117,117,32,266
355030865000184,1,135,22,201,201,37,439
355030865000185,1,37,14,44,44,37,125
355030865000186,1,66,25,82,82,72,236
355030865000187,1,192,91,164,164,94,422
355030865000188,1,32,9,40,40,35,115
355030865000189,1,176,67,139,139,93,371
355030865000190,1,67,32,90,90,67,247
355030865000191,1,79,39,87,87,77,251
355030865000192,1,139,68,186,186,106,478
355030865000193,1,103,57,118,118,106,342
355030865000194,1,69,29,79,79,45,203
355030865000195,1,83,47,85,85,47,217
355030865000196,1,75,34,93,93,54,240
355030865000197,1,123,72,189,189,101,479
355030865000198,1,161,62,174,174,96,444
355030865000199,1,108,76,167,167,111,445
355030865000200,1,66,42,77,77,47,201
355030865000201,1,76,34,123,123,71,317
355030865000202,1,54,32,79,79,63,221
355030865000203,1,66,33,101,101,87,289
355030865000204,1,76,31,119,119,62,300
355030865000206,1,174,68,129,129,68,326
355030865000207,1,55,30,68,68,77,213
355030865000208,1,42,36,73,73,58,204
355030865000209,1,80,31,140,140,71,351
355030865000210,1,81,41,84,84,41,209
355030865000211,1,35,28,52,52,34,138
355030865000213,1,183,87,147,147,65,359
355030865000214,1,96,48,76,76,61,213
355030865000218,1,66,28,59,59,38,156
355030865000219,1,46,27,63,63,40,166
355030865000220,1,27,11,21,21,17,59
355030865000221,1,35,8,44,44,15,103
355030865000222,1,52,29,57,57,33,147
355030866000001,1,40,34,106,106,134,346
355030866000002,1,48,28,101,101,84,286
355030866000003,1,61,34,115,115,99,329
355030866000004,1,31,31,109,109,66,284
355030866000005,1,18,18,60,60,31,151
355030866000006,1,32,28,81,81,58,220
355030866000007,1,14,16,79,79,52,210
355030866000008,1,35,31,80,80,57,217
355030866000009,1,28,12,65,65,48,178
355030866000010,1,15,17,118,118,73,309
355030866000011,1,22,12,83,83,54,220
355030866000012,1,22,16,69,69,79,217
355030866000013,1,12,19,105,105,89,299
355030866000014,1,19,17,126,126,61,313
355030866000015,1,22,21,125,125,83,333
355030866000016,1,31,16,114,114,76,304
355030866000017,1,24,16,76,76,79,231
355030866000018,1,63,55,162,162,107,431
355030866000019,1,39,35,125,125,76,326
355030866000020,1,45,45,131,131,82,344
355030866000021,1,29,31,144,144,78,366
355030866000022,1,17,24,95,95,50,240
355030866000023,1,86,42,196,196,116,508
355030866000024,1,5,4,32,32,20,84
355030866000025,1,20,24,107,107,76,290
355030866000026,1,23,16,59,59,74,192
355030866000027,1,68,38,135,135,82,352
355030866000028,1,21,29,120,120,87,327
355030866000029,1,22,11,60,60,50,170
355030866000030,1,13,19,93,93,97,283
355030866000031,1,9,19,136,136,102,374
355030866000032,1,8,5,38,38,25,101
355030866000033,1,43,53,110,110,63,283
355030866000034,1,19,15,52,52,38,142
355030866000035,1,21,24,104,104,88,296
355030866000036,1,40,41,152,152,94,398
355030866000037,1,10,10,32,32,20,84
355030866000038,1,16,18,49,49,30,128
355030866000039,1,108,82,370,370,166,906
355030866000040,1,54,45,128,128,115,371
355030866000041,1,93,87,176,176,121,473
355030866000042,1,56,34,127,127,99,353
355030866000043,1,67,36,136,136,120,392
355030866000044,1,44,35,142,142,73,357
355030866000045,1,28,21,88,88,92,268
355030866000046,1,67,43,173,173,109,455
355030866000047,1,9,16,61,61,60,182
355030866000048,1,8,10,54,54,46,154
355030866000049,1,61,26,129,129,97,355
355030866000050,1,71,37,185,185,118,488
355030866000051,1,29,25,114,114,59,287
355030866000052,1,15,23,120,120,70,310
355030866000053,1,30,37,93,93,68,254
355030866000054,1,45,43,117,117,76,310
355030866000055,1,58,47,166,166,121,453
355030866000056,1,30,10,58,58,47,163
355030866000057,1,35,32,124,124,88,336
355030866000058,1,13,10,96,96,41,233
355030866000059,1,48,36,117,117,92,326
355030866000060,1,22,17,92,92,59,243
355030866000061,1,24,21,147,147,92,386
355030866000062,1,14,21,100,100,62,262
355030866000063,1,49,40,145,145,109,399
355030866000064,1,39,45,163,163,86,412
355030866000065,1,91,78,163,163,107,433
355030866000066,1,63,58,129,129,81,339
355030866000067,1,27,24,78,78,57,213
355030866000068,1,67,61,127,127,75,329
355030866000069,1,32,41,101,101,76,278
355030866000070,1,212,147,261,261,120,642
355030866000071,1,35,32,117,117,78,312
355030866000072,1,44,43,97,97,78,272
355030866000073,1,35,44,203,203,86,492
355030866000074,1,51,42,126,126,75,327
355030866000075,1,32,23,115,115,105,335
355030866000076,1,37,34,120,120,70,310
355030866000077,1,37,30,147,147,83,377
355030866000078,1,16,31,127,127,85,339
355030866000079,1,38,27,139,139,80,358
355030866000080,1,31,22,92,92,81,265
355030866000081,1,68,50,154,154,144,452
355030866000082,1,45,31,104,104,83,291
355030866000083,1,23,14,32,32,36,100
355030866000084,1,65,28,110,110,82,302
355030866000085,1,66,48,159,159,118,436
355030866000086,1,33,29,86,86,64,236
355030866000087,1,34,17,86,86,55,227
355030866000088,1,24,21,167,167,59,393
355030866000089,1,35,26,135,135,84,354
355030866000090,1,13,12,97,97,57,251
355030866000091,1,25,14,81,81,68,230
355030866000092,1,31,26,95,95,86,276
355030866000093,1,69,38,160,160,107,427
355030866000094,1,34,35,83,83,68,234
355030866000095,1,97,89,185,185,101,471
355030866000096,1,88,49,122,122,79,323
355030866000098,1,72,43,177,177,93,447
355030866000099,1,52,45,174,174,125,473
355030866000100,1,63,34,127,127,115,369
355030866000101,1,30,25,78,78,55,211
355030866000102,1,15,13,103,103,88,294
355030866000103,1,33,29,124,124,86,334
355030866000104,1,48,47,180,180,108,468
355030866000105,1,66,46,132,132,96,360
355030866000106,1,41,29,66,66,31,163
355030866000107,1,98,46,132,132,69,333
355030866000108,1,41,24,77,77,50,204
355030866000109,1,135,69,195,195,151,541
355030866000110,1,69,43,146,146,128,420
355030866000111,1,80,46,140,140,68,348
355030866000112,1,43,47,94,94,51,239
355030866000113,1,96,82,178,178,97,453
355030866000114,1,70,36,87,87,63,237
355030866000115,1,16,19,23,23,12,58
355030866000116,1,9,16,59,59,52,170
355030866000117,1,20,7,56,56,63,175
355030866000118,1,32,19,69,69,39,177
355030866000119,1,86,64,182,182,142,506
355030866000120,1,7,7,54,54,38,146
355030866000121,1,45,19,82,82,68,232
355030866000122,1,22,10,57,57,39,153
355030866000123,1,19,9,47,47,29,123
355030866000124,1,30,47,106,106,71,283
355030866000125,1,21,18,55,55,79,189
355030866000126,1,37,35,153,153,106,412
355030866000127,1,8,6,39,39,38,116
355030866000128,1,19,19,85,85,53,223
355030866000129,1,81,78,155,155,55,365
355030866000130,1,42,33,98,98,44,240
355030866000131,1,14,11,39,39,28,106
355030866000132,1,34,36,70,70,69,209
355030866000133,1,17,18,131,131,58,320
355030866000134,1,25,27,84,84,64,232
355030866000135,1,12,9,19,19,14,52
355030866000136,1,35,26,74,74,77,225
355030866000137,1,145,73,160,160,82,402
355030866000141,1,59,33,96,96,69,261
355030867000001,1,31,24,56,56,59,171
355030867000002,1,123,55,173,173,91,437
355030867000003,1,53,49,87,87,88,262
355030867000004,1,49,43,82,82,87,251
355030867000005,1,69,27,114,114,85,313
355030867000006,1,83,37,115,115,82,312
355030867000007,1,88,35,129,129,99,357
355030867000008,1,93,36,54,54,21,129
355030867000009,1,90,54,121,121,97,339
355030867000010,1,65,35,106,106,57,269
355030867000011,1,111,60,158,158,104,420
355030867000012,1,91,58,188,188,113,489
355030867000013,1,0,0,0,0,0,0
355030867000014,1,72,49,107,107,141,355
355030867000015,1,36,17,89,89,56,234
355030867000016,1,162,81,237,237,164,638
355030867000017,1,75,47,122,122,125,369
355030867000018,1,65,32,73,73,69,215
355030867000019,1,99,59,109,109,98,316
355030867000020,1,35,10,30,30,26,86
355030867000021,1,90,39,127,127,84,338
355030867000022,1,131,41,114,114,39,267
355030867000023,1,248,87,176,176,79,431
355030867000024,1,54,24,71,71,45,187
355030867000025,1,90,40,119,119,94,332
355030867000026,1,94,54,152,152,164,468
355030867000027,1,151,65,187,187,156,530
355030867000028,1,54,26,47,47,17,111
355030867000029,1,46,30,60,60,45,165
355030867000030,1,61,31,83,83,67,233
355030867000031,1,74,34,119,119,118,356
355030867000032,1,76,28,165,165,90,420
355030867000033,1,104,47,145,145,129,419
355030867000034,1,90,50,101,101,59,261
355030867000035,1,80,40,110,110,91,311
355030867000036,1,203,93,191,191,106,488
355030867000037,1,70,30,81,81,57,219
355030867000038,1,128,66,220,220,179,619
355030867000039,1,83,36,141,141,105,387
355030867000040,1,54,57,102,102,150,354
355030867000041,1,22,17,39,39,49,127
355030867000042,1,22,14,91,91,89,271
355030867000043,1,35,18,77,77,59,213
355030867000044,1,34,25,94,94,95,283
355030867000045,1,29,29,81,81,87,249
355030867000046,1,92,45,110,110,101,321
355030867000047,1,56,17,72,72,51,195
355030867000048,1,265,139,245,245,119,609
355030867000049,1,47,35,87,87,45,219
355030867000050,1,29,16,67,67,73,207
355030867000051,1,44,36,38,38,32,108
355030867000052,1,55,23,62,62,49,173
355030867000053,1,49,25,102,102,76,280
355030867000054,1,66,24,89,89,75,253
355030867000055,1,120,52,112,112,72,296
355030867000056,1,125,42,140,140,134,414
355030867000057,1,319,167,281,281,126,688
355030867000058,1,89,36,73,73,30,176
355030867000059,1,71,32,109,109,103,321
355030867000060,1,38,22,35,35,7,77
355030867000061,1,61,35,67,67,67,201
355030867000062,1,58,22,90,90,74,254
355030867000063,1,105,47,130,130,143,403
355030867000064,1,63,42,69,69,64,202
355030867000065,1,55,30,55,55,35,145
355030867000066,1,62,43,71,71,53,195
355030867000067,1,33,24,91,91,111,293
355030867000068,1,24,18,66,66,51,183
355030867000069,1,27,18,89,89,77,255
355030867000070,1,52,37,111,111,115,337
355030867000071,1,25,18,51,51,49,151
355030867000074,1,522,278,482,482,236,1200
355030867000075,1,246,159,239,239,133,611
355030867000076,1,324,164,299,299,161,759
355030867000077,1,309,168,263,263,130,656
355030867000078,1,34,26,66,66,66,198
355030867000079,1,43,49,74,74,129,277
355030867000080,1,23,15,48,48,41,137
355030867000081,1,350,116,222,222,109,553
355030867000082,1,27,11,55,55,19,129
355030867000083,1,38,26,44,44,78,166
355030867000084,1,55,21,44,44,49,137
355030867000085,1,79,37,80,80,45,205
355030867000086,1,91,35,119,119,99,337
355030867000087,1,86,40,109,109,112,330
355030867000088,1,82,50,124,124,74,322
355030867000089,1,127,56,148,148,124,420
355030867000090,1,51,29,72,72,63,207
355030867000091,1,47,30,88,88,70,246
355030867000092,1,47,20,100,100,39,239
355030867000093,1,76,35,170,170,99,439
355030867000094,1,106,25,218,218,62,498
355030867000095,1,64,32,123,123,105,351
355030867000096,1,148,72,166,166,90,422
355030867000097,1,175,79,178,178,39,395
355030867000098,1,148,80,185,185,78,448
355030867000099,1,212,93,176,176,107,459
355030867000100,1,72,39,94,94,62,250
355030867000101,1,123,79,189,189,134,512
355030867000102,1,42,26,72,72,62,206
355030867000103,1,24,15,42,42,45,129
355030867000104,1,30,12,50,50,50,150
355030867000105,1,45,27,90,90,94,274
355030867000106,1,23,10,41,41,42,124
355030867000107,1,27,18,66,66,57,189
355030867000108,1,78,51,128,128,116,372
355030867000109,1,21,11,27,27,25,79
355030867000110,1,94,47,102,102,54,258
355030867000111,1,73,42,78,78,86,242
355030867000112,1,406,156,272,272,108,652
355030867000113,1,98,58,142,142,140,424
355030867000114,1,45,37,64,64,89,217
355030867000115,1,40,17,85,85,80,250
355030867000116,1,46,32,46,46,35,127
355030867000117,1,66,45,107,107,99,313
355030867000118,1,79,22,169,169,56,394
355030867000119,1,41,12,169,169,34,372
355030867000120,1,51,24,68,68,73,209
355030867000121,1,74,55,143,143,111,397
355030867000122,1,106,44,123,123,95,341
355030867000123,1,59,22,101,101,77,279
355030867000124,1,52,13,125,125,40,290
355030867000125,1,64,38,99,99,76,274
355030867000126,1,72,20,98,98,56,252
355030867000127,1,93,39,114,114,95,323
355030867000128,1,74,23,102,102,64,268
355030867000129,1,57,37,67,67,74,208
355030867000130,1,137,70,157,157,127,441
355030867000131,1,81,36,90,90,47,227
355030867000132,1,66,35,101,101,68,270
355030867000133,1,79,35,180,180,97,457
355030867000134,1,70,34,128,128,53,309
355030867000135,1,37,34,127,127,111,365
355030867000136,1,83,24,162,162,69,393
355030867000137,1,97,29,169,169,102,440
355030867000138,1,34,17,111,111,68,290
355030867000139,1,72,25,86,86,60,232
355030867000140,1,51,15,68,68,50,186
355030867000141,1,42,11,79,79,50,208
355030867000142,1,18,5,50,50,31,131
355030867000143,1,28,8,130,130,25,285
355030867000144,1,15,11,69,69,10,148
355030867000145,1,13,6,45,45,13,103
355030867000146,1,58,27,84,84,68,236
355030867000147,1,57,22,82,82,94,258
355030867000148,1,37,9,138,138,44,320
355030867000149,1,36,7,133,133,34,300
355030867000150,1,45,9,81,81,54,216
355030867000151,1,47,27,81,81,90,252
355030867000152,1,68,37,121,121,92,334
355030867000153,1,50,34,74,74,81,229
355030867000155,1,139,80,145,145,102,392
355030867000156,1,105,51,143,143,97,383
355030867000157,1,18,13,61,61,27,149
355030867000158,1,170,96,170,170,126,466
355030867000159,1,36,22,44,44,14,102
355030867000160,1,135,63,157,157,88,402
355030867000161,1,76,31,142,142,98,382
355030867000162,1,52,19,81,81,78,240
355030867000164,1,58,33,88,88,94,270
355030867000165,1,279,105,188,188,67,443
355030867000166,1,92,55,107,107,144,358
355030867000167,1,73,38,132,132,119,383
355030867000168,1,121,55,146,146,163,455
355030867000169,1,64,26,78,78,61,217
355030867000170,1,146,89,181,181,148,510
355030867000171,1,34,24,69,69,53,191
355030867000172,1,86,37,117,117,71,305
355030867000173,1,95,43,116,116,79,311
355030867000174,1,65,46,102,102,81,285
355030867000175,1,84,53,238,238,98,574
355030867000176,1,19,9,39,39,16,94
355030867000177,1,36,23,91,91,76,258
355030867000178,1,53,40,96,96,79,271
355030867000179,1,25,20,108,108,30,246
355030867000180,1,18,8,76,76,22,174
355030867000181,1,47,39,109,109,120,338
355030867000182,1,67,49,125,125,116,366
355030867000183,1,34,27,41,41,41,123
355030867000184,1,55,63,101,101,117,319
355030867000185,1,104,43,141,141,60,342
355030867000186,1,48,30,84,84,66,234
355030867000187,1,144,47,85,85,22,192
355030867000188,1,71,38,95,95,56,246
355030867000189,1,29,23,63,63,65,191
355030867000190,1,38,24,49,49,42,140
355030867000191,1,39,39,111,111,66,288
355030867000192,1,64,18,80,80,40,200
355030867000193,1,32,27,62,62,59,183
355030867000194,1,105,52,164,164,97,425
355030867000195,1,366,185,267,267,136,670
355030867000196,1,47,34,92,92,96,280
355030867000197,1,126,43,99,99,18,216
355030867000198,1,80,33,87,87,54,228
355030867000199,1,103,70,122,122,89,333
355030867000200,1,153,82,161,161,121,443
355030867000201,1,71,29,113,113,88,314
355030867000202,1,52,47,119,119,112,350
355030867000203,1,15,7,92,92,16,200
355030867000204,1,89,35,217,217,75,509
355030867000205,1,50,28,113,113,60,286
355030867000206,1,90,33,155,155,82,392
355030867000207,1,43,32,67,67,101,235
355030867000208,1,79,53,101,101,97,299
355030867000209,1,36,40,58,58,109,225
355030867000210,1,271,151,211,211,108,530
355030867000211,1,24,18,58,58,63,179
355030867000212,1,51,42,96,96,91,283
355030867000213,1,114,37,156,156,95,407
355030867000214,1,83,30,183,183,67,433
355030867000215,1,49,15,106,106,35,247
355030867000216,1,18,60,53,53,35,141
355030867000217,1,283,87,255,255,96,606
355030867000218,1,178,110,169,169,74,412
355030867000219,1,22,29,45,45,82,172
355030867000220,1,36,72,64,64,40,168
355030867000221,1,22,62,121,121,23,265
355030867000222,1,32,66,116,116,29,261
355030867000224,1,78,33,111,111,101,323
355030867000225,1,63,40,93,93,86,272
355030867000226,1,58,28,72,72,67,211
355030867000227,1,42,17,59,59,65,183
355030867000228,1,53,30,64,64,61,189
355030867000229,1,104,52,180,180,139,499
355030867000230,1,52,35,70,70,93,233
355030867000231,1,29,8,45,45,19,109
355030867000232,1,65,34,97,97,90,284
355030867000233,1,65,27,172,172,109,453
355030867000234,1,35,22,62,62,107,231
355030867000235,1,59,8,135,135,66,336
355030867000236,1,76,30,153,153,96,402
355030867000237,1,41,18,96,96,40,232
355030867000238,1,36,17,51,51,79,181
355030867000239,1,41,31,64,64,68,196
355030867000240,1,50,21,122,122,67,311
355030867000241,1,43,34,83,83,99,265
355030867000242,1,83,41,153,153,105,411
355030867000243,1,36,26,76,76,68,220
355030867000248,1,0,0,0,0,0,0
355030867000249,1,101,42,112,112,49,273
355030867000250,1,61,25,88,88,75,251
355030867000251,1,103,53,108,108,81,297
355030867000252,1,124,54,120,120,82,322
355030867000253,1,63,39,92,92,70,254
355030867000254,1,55,20,106,106,99,311
355030867000255,1,33,28,57,57,66,180
355030867000256,1,26,21,48,48,84,180
355030867000259,1,23,34,88,88,21,197
355030867000260,1,30,30,82,82,78,242
355030867000261,1,30,15,60,60,62,182
355030867000262,1,28,28,54,54,56,164
355030867000263,1,169,101,193,193,132,518
355030867000264,1,155,52,107,107,63,277
355030867000265,1,151,74,176,176,122,474
355030867000266,1,35,11,43,43,39,125
355030867000267,1,31,17,34,34,17,85
355030867000268,1,88,43,78,78,50,206
355030867000269,1,158,59,119,119,43,281
355030867000270,1,68,36,65,65,40,170
355030867000271,1,142,62,90,90,29,209
355030868000001,1,106,43,154,154,130,438
355030868000002,1,89,35,131,131,99,361
355030868000003,1,73,48,116,116,125,357
355030868000004,1,82,46,174,174,131,479
355030868000005,1,92,39,195,195,90,480
355030868000006,1,37,27,68,68,85,221
355030868000007,1,58,54,111,111,124,346
355030868000008,1,140,78,209,209,184,602
355030868000009,1,81,42,160,160,138,458
355030868000010,1,55,36,86,86,89,261
355030868000011,1,113,72,178,178,137,493
355030868000012,1,128,54,203,203,125,531
355030868000013,1,113,76,181,181,135,497
355030868000014,1,149,75,234,234,213,681
355030868000015,1,133,65,166,166,147,479
355030868000016,1,104,70,131,131,148,410
355030868000017,1,91,53,143,143,176,462
355030868000018,1,112,30,233,233,118,584
355030868000019,1,128,84,219,219,193,631
355030868000020,1,115,64,209,209,170,588
355030868000021,1,103,52,156,156,163,475
355030868000022,1,77,51,106,106,115,327
355030868000023,1,71,40,96,96,68,260
355030868000024,1,75,45,114,114,123,351
355030868000025,1,122,66,179,179,140,498
355030868000026,1,231,111,232,232,137,601
355030868000027,1,156,94,193,193,189,575
355030868000028,1,150,75,216,216,166,598
355030868000029,1,85,52,156,156,163,475
355030868000030,1,158,81,289,289,199,777
355030868000031,1,55,42,102,102,182,386
355030868000032,1,81,55,98,98,40,236
355030868000033,1,73,45,139,139,132,410
355030868000034,1,32,20,61,61,76,198
355030868000035,1,98,64,226,226,183,635
355030868000036,1,105,76,196,196,167,559
355030868000037,1,97,49,149,149,178,476
355030868000038,1,76,53,171,171,194,536
355030868000039,1,61,53,118,118,164,400
355030868000040,1,62,41,110,110,174,394
355030868000041,1,57,39,89,89,119,297
355030868000042,1,37,15,54,54,60,168
355030868000043,1,71,34,118,118,113,349
355030868000044,1,89,50,100,100,112,312
355030868000045,1,73,25,84,84,79,247
355030868000046,1,43,35,60,60,99,219
355030868000047,1,71,45,98,98,111,307
355030868000048,1,78,42,94,94,98,286
355030868000049,1,139,64,207,207,168,582
355030868000050,1,131,71,141,141,168,450
355030868000051,1,98,52,131,131,98,360
355030868000052,1,133,67,220,220,181,621
355030868000053,1,80,63,124,124,130,378
355030868000054,1,98,52,162,162,172,496
355030868000055,1,166,105,254,254,181,689
355030868000056,1,134,64,184,184,160,528
355030868000057,1,97,70,127,127,174,428
355030868000058,1,66,38,96,96,100,292
355030868000059,1,61,38,91,91,69,251
355030868000060,1,125,71,132,132,134,398
355030868000061,1,104,72,150,150,215,515
355030868000062,1,211,100,270,270,196,736
355030868000063,1,102,55,69,69,40,178
355030868000064,1,188,80,207,207,71,485
355030868000065,1,187,108,248,248,130,626
355030868000066,1,106,72,159,159,124,442
355030868000067,1,313,144,389,389,154,932
355030868000068,1,115,52,142,142,106,390
355030868000069,1,105,64,166,166,119,451
355030868000070,1,61,31,64,64,64,192
355030868000071,1,77,34,91,91,97,279
355030868000072,1,117,63,210,210,179,599
355030868000073,1,50,31,80,80,91,251
355030868000074,1,91,53,133,133,145,411
355030868000075,1,155,82,186,186,195,567
355030868000076,1,91,66,145,145,153,443
355030868000077,1,81,56,133,133,90,356
355030868000078,1,136,85,196,196,170,562
355030868000079,1,129,64,184,184,149,517
355030868000080,1,128,85,173,173,128,474
355030868000081,1,88,52,152,152,124,428
355030868000082,1,71,46,118,118,96,332
355030868000083,1,149,78,201,201,183,585
355030868000084,1,165,90,226,226,208,660
355030868000085,1,77,44,143,143,142,428
355030868000086,1,67,41,119,119,134,372
355030868000087,1,137,72,270,270,268,808
355030868000088,1,111,80,207,207,267,681
355030868000089,1,83,51,122,122,112,356
355030868000090,1,153,81,176,176,114,466
355030868000091,1,117,57,190,190,129,509
355030868000092,1,147,68,209,209,161,579
355030868000093,1,164,86,176,176,120,472
355030868000094,1,95,67,137,137,130,404
355030868000095,1,187,99,221,221,198,640
355030868000096,1,58,26,80,80,93,253
355030868000097,1,107,85,182,182,170,534
355030868000098,1,129,88,168,168,184,520
355030868000099,1,127,70,229,229,194,652
355030868000100,1,113,77,172,172,216,560
355030868000101,1,77,40,116,116,133,365
355030868000102,1,328,177,446,446,276,1168
355030868000103,1,142,67,231,231,175,637
355030868000104,1,178,69,376,376,119,871
355030868000105,1,103,63,131,131,116,378
355030868000106,1,174,65,188,188,161,537
355030868000107,1,131,58,168,168,126,462
355030868000108,1,255,106,360,360,235,955
355030868000109,1,223,113,289,289,174,752
355030868000110,1,100,74,188,188,217,593
355030868000111,1,201,94,249,249,149,647
355030868000112,1,73,45,111,111,113,335
355030868000113,1,141,69,157,157,133,447
355030868000114,1,138,76,219,219,161,599
355030868000115,1,176,91,210,210,197,617
355030868000116,1,140,72,198,198,198,594
355030868000117,1,264,120,403,403,243,1049
355030868000118,1,106,48,114,114,105,333
355030868000119,1,113,37,72,72,49,193
355030868000120,1,76,42,117,117,106,340
355030868000121,1,51,29,83,83,91,257
355030868000122,1,60,26,133,133,101,367
355030868000123,1,79,46,147,147,156,450
355030868000124,1,74,51,148,148,115,411
355030868000125,1,59,36,122,122,131,375
355030868000126,1,50,28,87,87,107,281
355030868000127,1,49,30,71,71,101,243
355030868000128,1,51,42,131,131,89,351
355030868000129,1,130,60,199,199,162,560
355030868000130,1,114,52,159,159,98,416
355030868000131,1,134,66,165,165,135,465
355030868000132,1,97,63,178,178,219,575
355030868000133,1,151,81,212,212,173,597
355030868000134,1,119,64,145,145,130,420
355030868000135,1,62,15,109,109,23,241
355030868000136,1,52,15,80,80,52,212
355030868000137,1,137,55,253,253,139,645
355030868000138,1,87,18,169,169,43,381
355030868000139,1,119,52,153,153,114,420
355030868000140,1,76,40,125,125,134,384
355030868000141,1,106,56,195,195,120,510
355030868000142,1,107,29,179,179,84,442
355030868000143,1,276,124,284,284,183,751
355030868000144,1,117,58,142,142,89,373
355030868000145,1,207,93,237,237,140,614
355030868000146,1,154,87,159,159,165,483
355030868000147,1,54,23,79,79,44,202
355030868000148,1,92,51,116,116,84,316
355030868000149,1,152,73,194,194,137,525
355030868000150,1,68,35,90,90,90,270
355030868000151,1,250,102,319,319,195,833
355030868000152,1,105,42,92,92,68,252
355030868000153,1,90,46,142,142,160,444
355030868000154,1,108,55,136,136,119,391
355030868000155,1,102,73,155,155,153,463
355030868000156,1,90,29,191,191,132,514
355030868000157,1,104,56,150,150,160,460
355030868000158,1,91,67,174,174,139,487
355030868000159,1,79,54,144,144,158,446
355030868000160,1,131,87,236,236,219,691
355030868000161,1,90,42,147,147,97,391
355030868000162,1,73,44,115,115,126,356
355030868000163,1,84,48,129,129,143,401
355030868000164,1,82,51,114,114,109,337
355030868000165,1,98,64,170,170,128,468
355030868000166,1,146,68,185,185,127,497
355030868000167,1,76,52,204,204,126,534
355030868000168,1,117,50,164,164,127,455
355030868000169,1,96,55,150,150,139,439
355030868000170,1,66,42,105,105,120,330
355030868000171,1,116,66,173,173,168,514
355030868000172,1,67,42,114,114,98,326
355030868000173,1,129,96,205,205,176,586
355030868000174,1,103,40,120,120,81,321
355030868000175,1,170,98,181,181,145,507
355030868000176,1,233,69,147,147,87,381
355030868000177,1,590,293,632,632,474,1738
355030868000178,1,380,179,335,335,154,824
355030868000179,1,566,191,413,413,124,950
355030868000180,1,247,108,261,261,148,670
355030868000181,1,270,133,256,256,212,724
355030868000182,1,89,39,101,101,60,262
355030868000183,1,138,54,165,165,87,417
355030868000184,1,138,49,124,124,98,346
355030868000185,1,245,106,249,249,115,613
355030868000186,1,174,96,198,198,111,507
355030868000187,1,88,30,80,80,70,230
355030868000188,1,170,94,211,211,135,557
355030868000189,1,82,50,87,87,78,252
355030868000190,1,66,35,90,90,76,256
355030868000191,1,177,77,178,178,155,511
355030868000192,1,91,67,144,144,141,429
355030868000193,1,116,63,138,138,131,407
355030868000194,1,268,67,204,204,67,475
355030868000195,1,73,46,115,115,119,349
355030868000196,1,67,33,119,119,95,333
355030868000197,1,84,50,148,148,139,435
355030868000198,1,78,40,119,119,105,343
355030868000199,1,68,32,136,136,92,364
355030868000200,1,71,34,99,99,86,284
355030868000201,1,86,56,141,141,129,411
355030868000202,1,185,85,208,208,126,542
355030868000203,1,68,54,97,97,89,283
355030868000204,1,110,55,167,167,136,470
355030868000205,1,67,37,99,99,80,278
355030868000206,1,111,47,155,155,87,397
355030868000207,1,263,138,315,315,179,809
355030868000208,1,98,47,144,144,78,366
355030868000209,1,250,103,213,213,126,552
355030868000210,1,111,47,182,182,105,469
355030868000211,1,127,73,210,210,110,530
355030868000212,1,96,63,201,201,196,598
355030868000213,1,150,72,236,236,118,590
355030868000214,1,108,38,207,207,74,488
355030868000215,1,80,14,162,162,73,397
355030868000216,1,56,45,91,91,100,282
355030868000217,1,131,43,299,299,119,717
355030868000218,1,239,55,507,507,167,1181
355030868000219,1,68,64,136,136,176,448
355030868000220,1,165,102,281,281,277,839
355030868000221,1,89,55,141,141,174,456
355030868000222,1,58,26,98,98,84,280
355030868000223,1,57,36,91,91,97,279
355030868000225,1,142,67,171,171,77,419
355030868000226,1,68,27,131,131,97,359
355030868000227,1,74,42,158,158,113,429
355030868000228,1,115,60,203,203,181,587
355030868000229,1,66,50,111,111,138,360
355030868000230,1,81,47,129,129,100,358
355030868000231,1,73,36,124,124,141,389
355030868000232,1,57,33,108,108,119,335
355030868000233,1,131,73,244,244,165,653
355030868000234,1,167,84,217,217,133,567
355030868000235,1,211,106,212,212,140,564
355030868000236,1,85,43,63,63,20,146
355030868000237,1,219,104,221,221,97,539
355030868000238,1,206,106,226,226,81,533
355030868000239,1,137,56,140,140,71,351
355030868000240,1,200,78,178,178,66,422
355030868000241,1,77,44,102,102,54,258
355030868000242,1,203,85,226,226,101,553
355030868000243,1,242,126,274,274,83,631
355030868000244,1,89,56,120,120,55,295
355030868000245,1,298,107,233,233,45,511
355030868000246,1,173,86,159,159,102,420
355030868000247,1,249,155,297,297,179,773
355030868000248,1,148,68,140,140,75,355
355030868000249,1,401,100,359,359,164,882
355030868000250,1,25,20,45,45,62,152
355030868000251,1,105,65,114,114,75,303
355030868000252,1,279,149,293,293,157,743
355030868000253,1,449,222,420,420,207,1047
355030868000254,1,192,95,178,178,109,465
355030868000255,1,226,103,218,218,122,558
355030868000256,1,238,101,229,229,132,590
355030868000257,1,254,124,271,271,171,713
355030868000258,1,341,167,324,324,157,805
355030868000259,1,229,151,238,238,90,566
355030868000260,1,214,124,224,224,104,552
355030868000261,1,414,164,365,365,177,907
355030868000262,1,122,79,114,114,81,309
355030868000263,1,190,108,186,186,156,528
355030868000264,1,228,124,239,239,137,615
355030868000265,1,271,169,293,293,181,767
355030868000266,1,334,185,337,337,148,822
355030868000267,1,303,146,299,299,181,779
355030868000268,1,299,144,233,233,149,615
355030868000269,1,322,108,332,332,132,796
355030868000270,1,191,97,205,205,140,550
355030868000271,1,169,79,201,201,120,522
355030868000272,1,278,155,299,299,158,756
355030868000273,1,302,127,272,272,150,694
355030868000274,1,595,246,627,627,399,1653
355030868000275,1,316,158,321,321,213,855
355030868000276,1,186,83,178,178,107,463
355030868000277,1,196,113,214,214,121,549
355030868000278,1,121,41,221,221,92,534
355030868000279,1,61,40,78,78,102,258
355030868000280,1,76,35,139,139,131,409
355030868000282,1,42,30,80,80,84,244
355030868000283,1,118,66,215,215,149,579
355030868000284,1,71,47,109,109,115,333
355030868000285,1,479,213,517,517,141,1175
355030868000286,1,107,62,193,193,101,487
355030868000287,1,80,43,164,164,130,458
355030868000288,1,48,31,76,76,74,226
355030868000289,1,77,34,96,96,66,258
355030868000290,1,107,44,124,124,134,382
355030868000291,1,60,46,98,98,71,267
355030868000292,1,60,17,243,243,63,549
355030868000293,1,57,13,216,216,48,480
355030868000294,1,39,16,143,143,31,317
355030868000295,1,95,34,123,123,89,335
355030868000296,1,16,3,28,28,11,67
355030868000297,1,63,40,91,91,117,299
355030868000298,1,57,38,81,81,121,283
355030868000299,1,96,30,148,148,77,373
355030868000300,1,94,62,121,121,72,314
355030868000301,1,24,14,50,50,19,119
355030868000302,1,20,8,35,35,10,80
355030868000303,1,31,10,46,46,28,120
355030868000304,1,97,26,147,147,33,327
355030868000305,1,82,43,141,141,70,352
355030868000306,1,49,30,81,81,73,235
355030868000307,1,65,41,126,126,95,347
355030868000308,1,57,47,106,106,120,332
355030868000309,1,88,39,153,153,67,373
355030868000310,1,83,20,207,207,40,454
355030868000311,1,56,19,113,113,22,248
355030868000312,1,61,9,95,95,22,212
355030868000313,1,47,21,71,71,25,167
355030868000314,1,153,61,162,162,74,398
355030868000315,1,209,73,321,321,129,771
355030868000316,1,106,66,154,154,119,427
355030868000317,1,168,74,192,192,97,481
355030868000318,1,133,52,178,178,46,402
355030868000319,1,34,7,123,123,29,275
355030868000320,1,55,26,86,86,64,236
355030868000321,1,130,57,117,117,31,265
355030868000322,1,125,65,161,161,107,429
355030868000323,1,54,19,68,68,53,189
355030868000324,1,77,41,107,107,84,298
355030868000325,1,166,83,191,191,129,511
355030868000326,1,33,17,23,23,11,57
355030868000327,1,77,47,160,160,116,436
355030868000328,1,79,29,320,320,62,702
355030868000329,1,53,30,63,63,77,203
355030868000330,1,88,61,114,114,64,292
355030868000331,1,79,46,114,114,95,323
355030868000332,1,24,6,91,91,13,195
355030868000334,1,80,53,161,161,147,469
355030868000335,1,43,25,76,76,63,215
355030868000336,1,121,68,87,87,99,273
355030868000337,1,175,81,259,259,135,653
355030868000338,1,209,60,193,193,99,485
355030868000339,1,112,61,123,123,75,321
355030868000340,1,226,111,260,260,139,659
355030868000341,1,84,17,193,193,34,420
355030868000342,1,31,17,142,142,31,315
355030868000343,1,12,8,10,10,18,38
355030868000344,1,3,3,7,7,2,16
355030868000345,1,82,32,73,73,60,206
355030868000349,1,167,71,201,201,100,502
355030868000350,1,99,41,85,85,48,218
355030868000351,1,169,93,181,181,83,445
355030868000352,1,221,126,225,225,130,580
355030868000353,1,95,35,98,98,47,243
355030868000354,1,138,71,117,117,72,306
355030868000355,1,28,18,36,36,22,94
355030869000001,1,22,15,107,107,90,304
355030869000002,1,49,29,201,201,177,579
355030869000003,1,64,23,126,126,103,355
355030869000004,1,53,40,125,125,98,348
355030869000005,1,30,20,101,101,81,283
355030869000006,1,42,51,118,118,145,381
355030869000007,1,61,47,164,164,133,461
355030869000008,1,51,37,99,99,98,296
355030869000009,1,51,33,104,104,101,309
355030869000010,1,18,18,96,96,53,245
355030869000011,1,38,33,72,72,85,229
355030869000012,1,58,40,113,113,123,349
355030869000013,1,23,5,86,86,61,233
355030869000014,1,109,62,188,188,104,480
355030869000015,1,31,19,87,87,70,244
355030869000016,1,49,36,140,140,103,383
355030869000017,1,85,38,180,180,162,522
355030869000018,1,50,55,278,278,144,700
355030869000019,1,75,58,164,164,111,439
355030869000020,1,33,20,88,88,68,244
355030869000021,1,65,34,143,143,86,372
355030869000022,1,21,35,109,109,104,322
355030869000023,1,21,21,70,70,59,199
355030869000024,1,52,32,108,108,87,303
355030869000025,1,28,19,91,91,76,258
355030869000026,1,34,42,105,105,131,341
355030869000027,1,108,57,184,184,147,515
355030869000028,1,48,50,121,121,115,357
355030869000029,1,80,47,191,191,83,465
355030869000030,1,57,37,130,130,136,396
355030869000031,1,71,55,143,143,145,431
355030869000032,1,58,46,135,135,128,398
355030869000033,1,57,55,167,167,103,437
355030869000034,1,70,70,206,206,164,576
355030869000035,1,25,22,76,76,61,213
355030869000036,1,97,74,219,219,149,587
355030869000037,1,83,61,174,174,116,464
355030869000038,1,92,62,363,363,131,857
355030869000039,1,71,32,86,86,73,245
355030869000040,1,35,18,83,83,35,201
355030869000041,1,96,57,136,136,116,388
355030869000042,1,112,61,134,134,104,372
355030869000043,1,43,27,85,85,68,238
355030869000044,1,82,48,142,142,84,368
355030869000045,1,110,79,221,221,153,595
355030869000046,1,62,45,143,143,122,408
355030869000047,1,50,44,118,118,100,336
355030869000048,1,31,23,89,89,76,254
355030869000049,1,66,40,143,143,92,378
355030869000050,1,97,70,179,179,108,466
355030869000051,1,54,32,123,123,119,365
355030869000052,1,56,48,122,122,113,357
355030869000053,1,67,73,177,177,130,484
355030869000054,1,48,37,90,90,95,275
355030869000055,1,64,49,149,149,123,421
355030869000056,1,52,30,133,133,59,325
355030869000057,1,82,51,196,196,140,532
355030869000058,1,61,42,135,135,110,380
355030869000059,1,73,31,153,153,105,411
355030869000060,1,75,45,193,193,156,542
355030869000061,1,43,47,127,127,102,356
355030869000062,1,114,60,223,223,148,594
355030869000063,1,52,41,148,148,103,399
355030869000064,1,38,39,146,146,90,382
355030869000065,1,46,50,109,109,77,295
355030869000066,1,28,25,62,62,51,175
355030869000067,1,34,37,115,115,82,312
355030869000068,1,55,31,107,107,109,323
355030869000069,1,17,17,65,65,58,188
355030869000070,1,39,27,104,104,69,277
355030869000071,1,26,19,85,85,106,276
355030869000072,1,50,47,128,128,86,342
355030869000073,1,81,47,184,184,131,499
355030869000074,1,5,20,48,48,51,147
355030869000075,1,37,36,147,147,114,408
355030869000076,1,47,38,136,136,105,377
355030869000077,1,59,40,155,155,150,460
355030869000078,1,15,18,93,93,65,251
355030869000079,1,47,41,103,103,131,337
355030869000080,1,30,17,50,50,77,177
355030869000081,1,100,58,110,110,125,345
355030869000082,1,137,55,165,165,158,488
355030869000083,1,101,43,168,168,132,468
355030869000084,1,105,70,156,156,169,481
355030869000085,1,89,56,156,156,175,487
355030869000086,1,134,59,198,198,168,564
355030869000087,1,147,66,207,207,172,586
355030869000088,1,107,47,142,142,160,444
355030869000089,1,130,64,196,196,201,593
355030869000090,1,34,16,56,56,68,180
355030869000091,1,49,52,153,153,123,429
355030869000092,1,48,25,124,124,92,340
355030869000093,1,51,30,147,147,144,438
355030869000094,1,92,37,167,167,107,441
355030869000095,1,94,49,140,140,122,402
355030869000096,1,9,10,15,15,16,46
355030869000097,1,55,49,154,154,105,413
355030869000098,1,115,104,222,222,153,597
355030869000099,1,100,46,156,156,94,406
355030869000100,1,19,14,33,33,13,79
355030869000101,1,177,89,246,246,151,643
355030869000102,1,27,33,70,70,72,212
355030869000103,1,26,41,120,120,81,321
355030869000104,1,22,24,84,84,84,252
355030869000105,1,37,53,127,127,97,351
355030869000106,1,20,29,95,95,60,250
355030869000107,1,27,21,71,71,69,211
355030869000108,1,38,33,82,82,65,229
355030869000109,1,47,45,110,110,91,311
355030869000110,1,38,37,122,122,90,334
355030869000111,1,38,31,107,107,68,282
355030869000112,1,36,20,116,116,79,311
355030869000113,1,27,49,100,100,81,281
355030869000114,1,25,27,110,110,96,316
355030869000115,1,17,21,51,51,64,166
355030869000116,1,53,44,92,92,110,294
355030869000117,1,42,22,72,72,76,220
355030869000118,1,76,62,173,173,147,493
355030869000119,1,49,59,109,109,139,357
355030869000120,1,104,58,163,163,145,471
355030869000121,1,73,33,123,123,109,355
355030869000122,1,143,74,227,227,182,636
355030869000123,1,37,30,88,88,69,245
355030869000124,1,129,94,180,180,189,549
355030869000125,1,53,50,127,127,90,344
355030869000126,1,87,68,175,175,176,526
355030869000127,1,24,19,88,88,50,226
355030869000128,1,11,9,35,35,46,116
355030869000129,1,15,14,54,54,31,139
355030869000130,1,40,39,74,74,73,221
355030869000131,1,33,13,59,59,40,158
355030869000132,1,87,33,276,276,146,698
355030869000133,1,94,52,144,144,108,396
355030869000134,1,51,28,100,100,106,306
355030869000135,1,20,13,110,110,68,288
355030869000136,1,10,9,48,48,29,125
355030869000137,1,64,28,134,134,103,371
355030869000138,1,63,30,126,126,83,335
355030869000139,1,45,34,138,138,100,376
355030869000140,1,16,14,48,48,40,136
355030869000141,1,4,25,77,77,51,205
355030869000142,1,1,12,47,47,36,130
355030869000143,1,34,22,112,112,81,305
355030869000144,1,55,19,182,182,108,472
355030869000145,1,29,19,65,65,94,224
355030869000146,1,76,29,74,74,64,212
355030869000147,1,113,38,222,222,79,523
355030869000148,1,141,40,222,222,76,520
355030869000149,1,1,0,9,9,11,29
355030869000150,1,11,17,58,58,42,158
355030869000151,1,31,26,98,98,99,295
355030869000152,1,35,20,84,84,37,205
355030869000153,1,35,35,92,92,76,260
355030869000154,1,5,11,36,36,31,103
355030869000155,1,44,19,59,59,65,183
355030869000156,1,48,33,124,124,76,324
355030869000157,1,73,43,96,96,134,326
355030869000158,1,72,25,237,237,57,531
355030869000159,1,29,16,146,146,59,351
355030869000160,1,52,60,129,129,105,363
355030869000161,1,15,28,71,71,44,186
355030869000162,1,25,25,58,58,78,194
355030869000163,1,11,21,39,39,47,125
355030870000001,1,40,43,119,119,150,388
355030870000002,1,95,52,175,175,206,556
355030870000003,1,101,61,177,177,166,520
355030870000004,1,114,59,180,180,111,471
355030870000005,1,9,7,18,18,17,53
355030870000006,1,51,56,114,114,168,396
355030870000007,1,31,34,89,89,126,304
355030870000008,1,72,60,135,135,168,438
355030870000009,1,85,50,143,143,156,442
355030870000010,1,78,61,144,144,211,499
355030870000011,1,73,43,107,107,146,360
355030870000012,1,44,39,82,82,95,259
355030870000013,1,66,40,122,122,132,376
355030870000014,1,36,31,102,102,85,289
355030870000015,1,45,33,86,86,116,288
355030870000016,1,50,45,101,101,139,341
355030870000017,1,89,45,158,158,119,435
355030870000018,1,118,83,221,221,252,694
355030870000019,1,54,42,109,109,125,343
355030870000020,1,92,57,256,256,147,659
355030870000021,1,66,42,142,142,113,397
355030870000022,1,31,24,140,140,110,390
355030870000023,1,19,15,99,99,80,278
355030870000024,1,58,42,168,168,122,458
355030870000025,1,38,24,65,65,60,190
355030870000026,1,38,15,81,81,109,271
355030870000027,1,27,13,59,59,49,167
355030870000028,1,23,22,62,62,79,203
355030870000029,1,74,37,149,149,171,469
355030870000030,1,108,68,231,231,211,673
355030870000031,1,66,32,83,83,69,235
355030870000032,1,115,53,164,164,149,477
355030870000033,1,153,86,207,207,263,677
355030870000034,1,24,21,39,39,68,146
355030870000035,1,38,26,74,74,87,235
355030870000036,1,30,13,77,77,75,229
355030870000037,1,83,51,131,131,170,432
355030870000038,1,67,49,147,147,152,446
355030870000039,1,74,54,115,115,143,373
355030870000040,1,71,40,117,117,132,366
355030870000041,1,98,54,182,182,177,541
355030870000042,1,41,25,90,90,87,267
355030870000043,1,42,36,88,88,83,259
355030870000044,1,75,39,134,134,123,391
355030870000045,1,38,31,97,97,100,294
355030870000046,1,54,39,115,115,116,346
355030870000047,1,86,58,150,150,136,436
355030870000049,1,0,0,0,0,0,0
355030870000050,1,0,0,52,52,26,130
355030870000051,1,0,76,360,360,117,837
355030870000053,1,90,42,123,123,86,332
355030870000054,1,341,151,279,279,136,694
355030870000055,1,361,190,301,301,172,774
355030870000057,1,15,12,27,27,32,86
355030870000058,1,69,60,120,120,147,387
355030870000059,1,40,35,79,79,75,233
355030870000060,1,103,41,164,164,110,438
355030870000061,1,69,21,116,116,34,266
355030870000062,1,74,31,134,134,45,313
355030870000063,1,60,51,144,144,82,370
355030870000064,1,64,41,113,113,113,339
355030870000065,1,73,51,209,209,101,519
355030870000066,1,80,46,96,96,83,275
355030870000067,1,60,27,97,97,73,267
355030870000068,1,47,22,53,53,69,175
355030870000069,1,119,43,144,144,104,392
355030870000070,1,63,35,93,93,121,307
355030870000071,1,75,43,105,105,114,324
355030870000072,1,71,37,142,142,121,405
355030870000073,1,95,95,181,181,266,628
355030870000074,1,10,15,43,43,35,121
355030870000075,1,100,58,197,197,137,531
355030870000076,1,61,37,111,111,92,314
355030870000077,1,48,28,81,81,92,254
355030870000078,1,89,45,159,159,165,483
355030870000079,1,83,63,164,164,183,511
355030870000080,1,31,15,73,73,59,205
355030870000081,1,31,36,73,73,94,240
355030870000082,1,99,52,155,155,137,447
355030870000083,1,94,46,167,167,140,474
355030870000084,1,48,44,107,107,136,350
355030870000085,1,67,49,156,156,101,413
355030870000086,1,35,42,82,82,90,254
355030870000087,1,18,11,27,27,25,79
355030870000088,1,81,51,136,136,178,450
355030870000089,1,21,16,74,74,85,233
355030870000090,1,25,21,59,59,62,180
355030870000091,1,109,70,199,199,163,561
355030870000092,1,23,16,67,67,79,213
355030870000093,1,46,39,98,98,142,338
355030870000094,1,25,29,71,71,82,224
355030870000095,1,68,46,138,138,110,386
355030870000096,1,67,32,91,91,105,287
355030870000097,1,108,66,203,203,187,593
355030870000098,1,171,92,345,345,303,993
355030870000099,1,34,18,69,69,58,196
355030870000100,1,166,73,209,209,161,579
355030870000101,1,55,19,88,88,54,230
355030870000102,1,140,53,269,269,196,734
355030870000103,1,174,76,276,276,192,744
355030870000104,1,66,30,139,139,130,408
355030870000105,1,64,23,134,134,98,366
355030870000106,1,96,54,203,203,170,576
355030870000107,1,18,17,40,40,72,152
355030870000108,1,65,42,95,95,133,323
355030870000109,1,66,34,115,115,117,347
355030870000110,1,77,52,129,129,106,364
355030870000111,1,94,60,137,137,143,417
355030870000112,1,72,36,97,97,185,379
355030870000113,1,171,63,240,240,255,735
355030870000114,1,65,64,160,160,178,498
355030870000115,1,42,37,64,64,112,240
355030870000116,1,43,41,100,100,123,323
355030870000117,1,147,79,257,257,230,744
355030870000118,1,87,71,152,152,159,463
355030870000119,1,79,62,133,133,191,457
355030870000120,1,75,48,156,156,123,435
355030870000121,1,76,53,141,141,141,423
355030870000122,1,38,25,68,68,83,219
355030870000123,1,45,43,85,85,114,284
355030870000124,1,73,58,131,131,188,450
355030870000125,1,89,47,174,174,171,519
355030870000126,1,22,23,81,81,71,233
355030870000127,1,57,18,89,89,80,258
355030870000128,1,99,54,183,183,164,530
355030870000129,1,51,28,96,96,80,272
355030870000130,1,124,69,144,144,149,437
355030870000131,1,60,41,82,82,121,285
355030870000132,1,66,33,74,74,95,243
355030870000133,1,147,50,160,160,154,474
355030870000134,1,85,44,127,127,117,371
355030870000135,1,47,42,96,96,105,297
355030870000136,1,18,13,32,32,42,106
355030870000137,1,145,64,189,189,172,550
355030870000138,1,79,58,144,144,127,415
355030870000139,1,80,67,174,174,145,493
355030870000140,1,67,47,104,104,140,348
355030870000141,1,93,56,177,177,200,554
355030870000142,1,109,61,175,175,173,523
355030870000143,1,75,48,133,133,142,408
355030870000144,1,69,50,105,105,136,346
355030870000145,1,56,27,104,104,91,299
355030870000146,1,61,29,79,79,80,238
355030870000147,1,69,39,132,132,129,393
355030870000148,1,134,73,232,232,153,617
355030870000149,1,75,41,86,86,114,286
355030870000150,1,70,41,155,155,120,430
355030870000151,1,96,46,155,155,105,415
355030870000152,1,52,44,91,91,108,290
355030870000153,1,64,44,118,118,124,360
355030870000154,1,120,62,188,188,156,532
355030870000155,1,22,12,29,29,48,106
355030870000156,1,38,12,57,57,59,173
355030870000157,1,79,53,173,173,177,523
355030870000158,1,36,18,54,54,111,219
355030870000159,1,62,39,94,94,88,276
355030870000160,1,60,45,95,95,131,321
355030870000161,1,67,46,140,140,159,439
355030870000162,1,75,40,147,147,139,433
355030870000163,1,98,56,184,184,172,540
355030870000164,1,44,22,78,78,77,233
355030870000165,1,122,90,204,204,178,586
355030870000166,1,93,56,128,128,143,399
355030870000167,1,157,82,285,285,251,821
355030870000168,1,35,30,87,87,112,286
355030870000169,1,95,66,179,179,219,577
355030870000170,1,133,55,241,241,212,694
355030870000171,1,36,28,49,49,97,195
355030870000172,1,62,26,113,113,113,339
355030870000173,1,45,21,64,64,82,210
355030870000174,1,113,58,176,176,169,521
355030870000175,1,118,67,204,204,181,589
355030870000176,1,85,50,117,117,161,395
355030870000177,1,26,13,67,67,45,179
355030870000178,1,65,26,83,83,86,252
355030870000179,1,39,18,69,69,88,226
355030870000180,1,50,24,99,99,72,270
355030870000181,1,72,25,80,80,95,255
355030870000182,1,40,18,52,52,66,170
355030870000183,1,71,55,100,100,142,342
355030870000184,1,32,16,81,81,50,212
355030870000185,1,25,18,50,50,56,156
355030870000186,1,50,43,89,89,135,313
355030870000187,1,25,15,55,55,59,169
355030870000188,1,14,9,15,15,27,57
355030870000189,1,34,14,70,70,54,194
355030870000190,1,16,13,45,45,60,150
355030870000191,1,54,54,124,124,122,370
355030870000192,1,10,10,15,15,18,48
355030870000193,1,41,46,79,79,119,277
355030870000194,1,23,16,46,46,67,159
355030870000195,1,48,41,78,78,102,258
355030870000196,1,108,49,164,164,82,410
355030870000197,1,39,23,68,68,73,209
355030870000198,1,43,26,54,54,73,181
355030870000199,1,30,27,68,68,87,223
355030870000200,1,51,17,129,129,52,310
355030870000201,1,55,40,96,96,108,300
355030870000202,1,34,18,70,70,65,205
355030870000203,1,52,39,68,68,94,230
355030870000204,1,26,13,52,52,68,172
355030870000205,1,51,35,98,98,100,296
355030870000206,1,47,28,63,63,71,197
355030870000207,1,57,33,92,92,99,283
355030870000208,1,126,65,186,186,147,519
355030870000209,1,44,29,72,72,61,205
355030870000210,1,20,15,38,38,35,111
355030870000211,1,76,37,111,111,128,350
355030870000212,1,22,18,41,41,57,139
355030870000213,1,66,38,104,104,86,294
355030870000214,1,8,5,21,21,31,73
355030870000215,1,30,17,57,57,49,163
355030870000216,1,5,6,44,44,56,144
355030870000219,1,0,0,0,0,0,0
355030870000227,1,24,25,86,86,92,264
355030870000228,1,48,53,117,117,194,428
355030870000229,1,9,5,13,13,17,43
355030870000230,1,24,20,46,46,36,128
355030871000001,1,61,43,147,147,153,447
355030871000002,1,10,6,24,24,22,70
355030871000003,1,80,52,174,174,184,532
355030871000004,1,96,49,165,165,154,484
355030871000005,1,89,44,136,136,153,425
355030871000006,1,62,35,118,118,107,343
355030871000007,1,86,47,148,148,156,452
355030871000008,1,48,41,130,130,140,400
355030871000009,1,105,56,172,172,170,514
355030871000010,1,44,25,97,97,100,294
355030871000011,1,61,36,134,134,124,392
355030871000012,1,57,36,128,128,147,403
355030871000013,1,52,29,143,143,111,397
355030871000014,1,64,39,126,126,123,375
355030871000015,1,85,49,161,161,155,477
355030871000016,1,85,47,138,138,146,422
355030871000017,1,48,34,107,107,149,363
355030871000018,1,64,44,151,151,126,428
355030871000019,1,59,35,100,100,101,301
355030871000020,1,48,49,122,122,170,414
355030871000021,1,64,42,130,130,179,439
355030871000022,1,56,33,116,116,137,369
355030871000023,1,58,35,100,100,91,291
355030871000024,1,84,34,118,118,122,358
355030871000025,1,102,40,152,152,173,477
355030871000026,1,81,20,119,119,119,357
355030871000027,1,58,25,120,120,117,357
355030871000028,1,60,34,127,127,95,349
355030871000029,1,64,40,90,90,94,274
355030871000030,1,57,37,109,109,86,304
355030871000031,1,58,38,86,86,88,260
355030871000032,1,122,69,187,187,182,556
355030871000033,1,107,72,199,199,190,588
355030871000034,1,51,29,102,102,87,291
355030871000035,1,90,34,135,135,119,389
355030871000036,1,83,45,157,157,130,444
355030871000037,1,91,63,169,169,163,501
355030871000038,1,57,35,151,151,149,451
355030871000039,1,98,57,196,196,194,586
355030871000040,1,136,61,175,175,203,553
355030871000041,1,63,29,119,119,145,383
355030871000042,1,91,38,215,215,156,586
355030871000043,1,58,35,152,152,136,440
355030871000044,1,35,26,80,80,88,248
355030871000045,1,89,41,174,174,152,500
355030871000046,1,25,25,51,51,83,185
355030871000047,1,53,22,88,88,74,250
355030871000048,1,31,27,42,42,85,169
355030871000049,1,47,65,151,151,142,444
355030871000050,1,43,48,75,75,117,267
355030871000051,1,41,32,80,80,73,233
355030871000052,1,46,45,120,120,136,376
355030871000053,1,14,23,35,35,73,143
355030871000055,1,63,28,108,108,81,297
355030871000056,1,143,50,177,177,202,556
355030871000057,1,13,4,31,31,27,89
355030871000058,1,115,50,131,131,159,421
355030871000059,1,96,50,184,184,141,509
355030871000060,1,65,46,143,143,132,418
355030871000061,1,74,44,141,141,111,393
355030871000062,1,140,88,200,200,211,611
355030871000063,1,40,31,79,79,114,272
355030871000064,1,73,35,128,128,91,347
355030871000065,1,105,57,144,144,168,456
355030871000066,1,67,19,109,109,97,315
355030871000067,1,65,41,147,147,128,422
355030871000068,1,43,39,99,99,97,295
355030871000069,1,106,46,196,196,148,540
355030871000070,1,41,26,106,106,70,282
355030871000071,1,61,39,118,118,91,327
355030871000072,1,67,41,132,132,121,385
355030871000073,1,15,15,46,46,56,148
355030871000074,1,39,37,163,163,165,491
355030871000075,1,33,16,92,92,69,253
355030871000076,1,67,39,106,106,122,334
355030871000077,1,99,38,137,137,159,433
355030871000078,1,91,36,185,185,140,510
355030871000079,1,94,55,115,115,172,402
355030871000080,1,0,0,0,0,0,0
355030871000081,1,88,40,138,138,94,370
355030871000082,1,62,36,103,103,108,314
355030871000083,1,105,74,177,177,184,538
355030871000084,1,72,37,137,137,111,385
355030871000085,1,90,41,161,161,133,455
355030871000086,1,53,32,105,105,127,337
355030871000087,1,65,45,130,130,134,394
355030871000088,1,55,43,142,142,124,408
355030871000089,1,80,38,144,144,132,420
355030871000090,1,87,34,158,158,117,433
355030871000091,1,104,51,171,171,166,508
355030871000092,1,42,28,109,109,77,295
355030871000093,1,41,34,109,109,99,317
355030871000094,1,159,59,332,332,124,788
355030871000095,1,68,24,99,99,89,287
355030871000096,1,85,22,216,216,79,511
355030871000098,1,67,37,113,113,99,325
355030871000099,1,45,13,162,162,94,418
355030871000100,1,148,49,202,202,105,509
355030871000101,1,117,40,194,194,91,479
355030871000102,1,26,4,76,76,10,162
355030871000103,1,17,6,104,104,23,231
355030871000104,1,68,43,97,97,148,342
355030871000105,1,52,35,97,97,85,279
355030871000106,1,66,30,144,144,94,382
355030871000107,1,200,46,238,238,151,627
355030871000108,1,48,42,184,184,102,470
355030871000109,1,34,29,73,73,85,231
355030871000110,1,107,42,226,226,142,594
355030871000112,1,18,18,99,99,36,234
355030871000115,1,61,31,125,125,130,380
355030871000116,1,68,27,175,175,97,447
355030871000117,1,49,21,92,92,80,264
355030871000118,1,64,56,136,136,146,418
355030871000119,1,157,37,265,265,104,634
355030871000120,1,133,60,182,182,191,555
355030871000121,1,18,36,94,94,44,232
355030871000122,1,38,16,126,126,80,332
355030871000123,1,77,37,118,118,110,346
355030871000124,1,73,25,101,101,114,316
355030871000125,1,98,42,140,140,80,360
355030871000126,1,68,20,181,181,44,406
355030871000127,1,111,34,172,172,75,419
355030871000128,1,100,40,95,95,118,308
355030871000129,1,107,38,145,145,89,379
355030871000130,1,24,24,89,89,50,228
355030871000131,1,0,0,0,0,0,0
355030871000132,1,56,19,129,129,44,302
355030871000133,1,58,15,116,116,43,275
355030871000134,1,53,23,179,179,68,426
355030872000001,1,98,73,171,171,174,516
355030872000002,1,104,65,177,177,129,483
355030872000003,1,59,47,128,128,188,444
355030872000004,1,101,50,161,161,122,444
355030872000005,1,147,63,175,175,182,532
355030872000006,1,68,47,112,112,82,306
355030872000007,1,231,104,379,379,190,948
355030872000008,1,85,50,106,106,135,347
355030872000009,1,65,50,96,96,100,292
355030872000010,1,110,59,152,152,149,453
355030872000011,1,220,97,252,252,190,694
355030872000012,1,145,83,203,203,166,572
355030872000013,1,84,46,132,132,104,368
355030872000014,1,118,67,172,172,167,511
355030872000015,1,90,64,151,151,131,433
355030872000016,1,59,43,111,111,143,365
355030872000017,1,111,63,191,191,169,551
355030872000018,1,125,59,173,173,191,537
355030872000019,1,105,76,160,160,148,468
355030872000020,1,85,70,132,132,146,410
355030872000021,1,133,71,222,222,171,615
355030872000022,1,116,61,201,201,185,587
355030872000023,1,135,75,191,191,142,524
355030872000024,1,70,33,124,124,107,355
355030872000025,1,100,58,159,159,134,452
355030872000026,1,109,67,174,174,158,506
355030872000027,1,129,57,119,119,151,389
355030872000028,1,87,54,150,150,136,436
355030872000029,1,126,73,188,188,174,550
355030872000030,1,112,66,162,162,149,473
355030872000031,1,68,54,119,119,125,363
355030872000032,1,140,89,207,207,175,589
355030872000033,1,67,54,133,133,152,418
355030872000034,1,95,52,140,140,150,430
355030872000035,1,119,59,191,191,170,552
355030872000036,1,121,58,241,241,134,616
355030872000037,1,91,46,114,114,136,364
355030872000038,1,101,56,150,150,206,506
355030872000039,1,166,103,263,263,222,748
355030872000040,1,57,30,75,75,72,222
355030872000041,1,112,86,158,158,143,459
355030872000042,1,93,41,121,121,132,374
355030872000043,1,200,116,269,269,227,765
355030872000044,1,77,56,112,112,147,371
355030872000045,1,91,50,178,178,154,510
355030872000046,1,117,56,150,150,126,426
355030872000047,1,98,65,150,150,175,475
355030872000048,1,78,51,153,153,128,434
355030872000049,1,110,88,138,138,161,437
355030872000050,1,263,130,370,370,210,950
355030872000051,1,108,89,188,188,243,619
355030872000052,1,138,72,193,193,126,512
355030872000053,1,98,48,148,148,135,431
355030872000054,1,102,47,141,141,137,419
355030872000055,1,109,55,143,143,167,453
355030872000056,1,84,57,118,118,129,365
355030872000057,1,80,49,126,126,129,381
355030872000058,1,100,43,141,141,135,417
355030872000059,1,123,59,195,195,139,529
355030872000060,1,136,68,183,183,184,550
355030872000061,1,108,25,191,191,70,452
355030872000062,1,112,58,194,194,132,520
355030872000063,1,102,67,225,225,199,649
355030872000064,1,126,68,201,201,203,605
355030872000065,1,133,51,163,163,150,476
355030872000066,1,119,69,166,166,144,476
355030872000067,1,113,57,170,170,120,460
355030872000068,1,100,80,165,165,167,497
355030872000069,1,142,76,246,246,182,674
355030872000070,1,92,55,181,181,155,517
355030872000071,1,126,91,193,193,191,577
355030872000072,1,137,74,163,163,143,469
355030872000073,1,87,65,156,156,182,494
355030872000074,1,141,93,208,208,179,595
355030872000075,1,143,76,198,198,139,535
355030872000076,1,64,40,97,97,76,270
355030872000077,1,154,62,330,330,106,766
355030872000078,1,125,32,270,270,92,632
355030872000079,1,122,65,176,176,122,474
355030872000080,1,109,63,173,173,124,470
355030872000081,1,91,44,141,141,117,399
355030872000082,1,128,41,175,175,86,436
355030872000083,1,91,74,141,141,124,406
355030872000084,1,77,72,102,102,159,363
355030872000085,1,77,62,134,134,137,405
355030872000086,1,109,71,142,142,169,453
355030872000087,1,87,49,115,115,140,370
355030872000088,1,135,80,186,186,199,571
355030872000089,1,151,56,218,218,175,611
355030872000090,1,96,48,115,115,135,365
355030872000091,1,112,66,183,183,158,524
355030872000092,1,187,102,245,245,220,710
355030872000093,1,66,29,81,81,95,257
355030872000094,1,173,80,162,162,111,435
355030872000095,1,185,45,137,137,82,356
355030872000096,1,113,71,158,158,179,495
355030872000097,1,158,77,192,192,183,567
355030872000098,1,154,82,188,188,178,554
355030872000099,1,182,91,287,287,193,767
355030872000100,1,100,57,146,146,98,390
355030872000101,1,105,40,122,122,80,324
355030872000102,1,117,88,170,170,229,569
355030872000103,1,118,80,181,181,192,554
355030872000104,1,129,70,165,165,172,502
355030872000105,1,125,69,186,186,160,532
355030872000106,1,78,54,113,113,153,379
355030872000107,1,112,54,164,164,176,504
355030872000108,1,142,76,211,211,177,599
355030872000109,1,127,51,220,220,149,589
355030872000110,1,101,68,153,153,151,457
355030872000111,1,288,126,262,262,79,603
355030872000112,1,136,67,185,185,167,537
355030872000113,1,117,51,173,173,132,478
355030872000114,1,117,60,164,164,177,505
355030872000115,1,131,84,203,203,170,576
355030872000116,1,148,86,159,159,129,447
355030872000117,1,139,54,158,158,143,459
355030872000118,1,189,91,225,225,153,603
355030872000119,1,184,71,146,146,120,412
355030872000120,1,533,220,364,364,172,900
355030872000121,1,37,43,76,76,88,240
355030872000122,1,135,65,191,191,145,527
355030872000123,1,93,62,202,202,120,524
355030872000124,1,120,67,176,176,150,502
355030872000125,1,110,81,179,179,254,612
355030872000126,1,87,52,154,154,170,478
355030872000127,1,83,48,143,143,163,449
355030872000128,1,60,42,86,86,90,262
355030872000129,1,80,46,137,137,169,443
355030872000130,1,72,28,78,78,85,241
355030872000131,1,119,58,181,181,153,515
355030872000132,1,83,61,162,162,167,491
355030872000133,1,129,71,190,190,154,534
355030872000134,1,156,85,200,200,155,555
355030872000135,1,150,99,197,197,198,592
355030872000136,1,135,80,194,194,122,510
355030872000137,1,188,117,250,250,192,692
355030872000138,1,154,78,200,200,127,527
355030872000139,1,199,75,205,205,97,507
355030872000140,1,114,58,147,147,111,405
355030872000141,1,142,93,212,212,200,624
355030872000142,1,88,43,121,121,124,366
355030872000143,1,105,74,154,154,147,455
355030872000144,1,120,72,181,181,184,546
355030872000145,1,143,93,198,198,200,596
355030872000146,1,121,61,149,149,122,420
355030872000147,1,112,44,135,135,136,406
355030872000148,1,179,75,216,216,181,613
355030872000149,1,112,63,164,164,110,438
355030872000150,1,103,76,178,178,157,513
355030872000151,1,112,46,155,155,140,450
355030872000152,1,124,67,176,176,144,496
355030872000153,1,285,158,293,293,232,818
355030872000154,1,75,51,107,107,73,287
355030872000155,1,170,105,223,223,188,634
355030872000156,1,117,71,157,157,164,478
355030872000157,1,140,84,184,184,168,536
355030872000158,1,130,73,171,171,140,482
355030872000159,1,137,76,161,161,148,470
355030872000160,1,263,118,209,209,171,589
355030872000161,1,67,50,99,99,144,342
355030872000162,1,157,35,218,218,63,499
355030872000163,1,146,45,215,215,71,501
355030872000164,1,160,70,311,311,198,820
355030872000165,1,95,80,163,163,180,506
355030872000166,1,89,40,157,157,76,390
355030872000167,1,96,35,157,157,95,409
355030872000168,1,99,66,144,144,144,432
355030872000169,1,160,102,185,185,174,544
355030872000170,1,180,97,208,208,133,549
355030872000171,1,156,95,173,173,158,504
355030872000172,1,205,115,199,199,162,560
355030872000173,1,175,92,190,190,196,576
355030872000174,1,152,67,140,140,110,390
355030872000175,1,65,47,92,92,75,259
355030872000176,1,107,51,133,133,101,367
355030872000177,1,57,27,27,27,18,72
355030872000178,1,78,25,172,172,47,391
355030872000179,1,110,31,189,189,77,455
355030872000180,1,19,21,27,27,34,88
355030872000181,1,139,38,321,321,68,710
355030872000182,1,286,85,624,624,164,1412
355030872000184,1,50,12,79,79,39,197
355030872000185,1,25,5,49,49,15,113
355030872000186,1,49,14,141,141,23,305
355030872000187,1,21,4,25,25,18,68
355030872000188,1,59,36,53,53,28,134
355030872000189,1,91,46,71,71,54,196
355030872000190,1,90,51,75,75,57,207
355030873000001,1,123,65,137,137,95,369
355030873000002,1,116,47,90,90,42,222
355030873000003,1,135,78,172,172,163,507
355030873000004,1,85,53,119,119,101,339
355030873000005,1,132,62,155,155,114,424
355030873000006,1,172,104,177,177,168,522
355030873000007,1,117,69,149,149,138,436
355030873000008,1,115,62,155,155,104,414
355030873000009,1,57,29,68,68,59,195
355030873000010,1,134,67,212,212,139,563
355030873000011,1,153,95,154,154,108,416
355030873000012,1,138,79,115,115,77,307
355030873000013,1,107,62,96,96,107,299
355030873000014,1,87,49,101,101,90,292
355030873000015,1,170,93,207,207,171,585
355030873000016,1,153,86,206,206,179,591
355030873000017,1,87,37,115,115,97,327
355030873000018,1,189,83,211,211,146,568
355030873000019,1,184,69,160,160,88,408
355030873000020,1,117,58,104,104,49,257
355030873000021,1,127,91,159,159,153,471
355030873000022,1,434,233,385,385,207,977
355030873000023,1,302,153,296,296,156,748
355030873000024,1,170,63,110,110,70,290
355030873000025,1,181,127,194,194,187,575
355030873000026,1,166,94,209,209,128,546
355030873000027,1,93,47,97,97,66,260
355030873000028,1,91,47,157,157,112,426
355030873000029,1,91,65,121,121,101,343
355030873000030,1,129,70,184,184,202,570
355030873000031,1,111,66,155,155,129,439
355030873000032,1,135,62,135,135,106,376
355030873000033,1,177,87,232,232,152,616
355030873000034,1,149,78,111,111,82,304
355030873000035,1,181,81,182,182,124,488
355030873000036,1,116,72,134,134,138,406
355030873000037,1,108,58,121,121,104,346
355030873000038,1,90,37,129,129,103,361
355030873000039,1,116,43,121,121,75,317
355030873000040,1,255,109,265,265,191,721
355030873000041,1,142,75,162,162,126,450
355030873000042,1,34,33,43,43,43,129
355030873000043,1,256,111,187,187,84,458
355030873000044,1,216,107,194,194,87,475
355030873000045,1,554,226,407,407,169,983
355030873000046,1,73,27,70,70,85,225
355030873000047,1,79,52,98,98,95,291
355030873000048,1,89,47,94,94,101,289
355030873000049,1,67,22,86,86,90,262
355030873000050,1,89,50,124,124,89,337
355030873000051,1,84,55,119,119,94,332
355030873000052,1,156,64,170,170,122,462
355030873000053,1,217,113,228,228,160,616
355030873000054,1,183,120,203,203,187,593
355030873000055,1,84,63,107,107,98,312
355030873000056,1,152,65,160,160,95,415
355030873000057,1,125,67,146,146,109,401
355030873000058,1,128,77,160,160,124,444
355030873000059,1,124,51,152,152,99,403
355030873000060,1,113,77,156,156,156,468
355030873000061,1,114,82,156,156,127,439
355030873000062,1,85,39,111,111,104,326
355030873000063,1,139,81,201,201,128,530
355030873000064,1,191,117,229,229,158,616
355030873000065,1,357,173,353,353,167,873
355030873000066,1,157,67,149,149,120,418
355030873000067,1,167,75,154,154,150,458
355030873000068,1,351,131,267,267,118,652
355030873000069,1,117,59,145,145,104,394
355030873000070,1,245,109,233,233,103,569
355030873000071,1,121,64,185,185,172,542
355030873000072,1,100,45,111,111,113,335
355030873000073,1,101,48,131,131,105,367
355030873000074,1,81,54,125,125,110,360
355030873000075,1,94,54,105,105,94,304
355030873000076,1,136,80,127,127,120,374
355030873000077,1,118,62,131,131,74,336
355030873000078,1,141,62,156,156,116,428
355030873000079,1,69,23,91,91,80,262
355030873000080,1,125,54,130,130,116,376
355030873000081,1,192,102,218,218,159,595
355030873000082,1,144,60,173,173,128,474
355030873000083,1,183,101,183,183,169,535
355030873000084,1,104,80,144,144,112,400
355030873000085,1,90,51,118,118,138,374
355030873000086,1,118,52,162,162,154,478
355030873000087,1,115,72,140,140,89,369
355030873000088,1,105,55,99,99,125,323
355030873000089,1,69,41,95,95,100,290
355030873000090,1,66,29,90,90,74,254
355030873000091,1,155,97,202,202,146,550
355030873000092,1,110,61,121,121,98,340
355030873000093,1,83,46,126,126,85,337
355030873000094,1,218,111,268,268,212,748
355030873000095,1,282,140,262,262,174,698
355030873000096,1,136,52,136,136,101,373
355030873000097,1,127,65,135,135,137,407
355030873000098,1,149,71,183,183,176,542
355030873000099,1,171,84,179,179,163,521
355030873000100,1,105,52,115,115,148,378
355030873000101,1,140,65,200,200,109,509
355030873000102,1,136,71,185,185,131,501
355030873000103,1,169,118,187,187,156,530
355030873000104,1,364,123,560,560,212,1332
355030873000105,1,147,69,169,169,128,466
355030873000106,1,104,49,120,120,70,310
355030873000107,1,204,93,237,237,178,652
355030873000108,1,135,58,231,231,106,568
355030873000109,1,88,64,156,156,132,444
355030873000110,1,131,65,155,155,137,447
355030873000111,1,114,71,185,185,130,500
355030873000112,1,140,76,183,183,167,533
355030873000113,1,120,63,179,179,168,526
355030873000114,1,105,47,138,138,113,389
355030873000115,1,115,50,150,150,117,417
355030873000116,1,97,46,125,125,91,341
355030873000117,1,88,56,126,126,107,359
355030873000118,1,58,48,94,94,99,287
355030873000119,1,107,48,134,134,99,367
355030873000120,1,122,56,145,145,153,443
355030873000121,1,180,111,232,232,166,630
355030873000122,1,173,101,184,184,176,544
355030873000123,1,95,43,119,119,112,350
355030873000124,1,132,61,220,220,143,583
355030873000125,1,137,63,141,141,123,405
355030873000126,1,134,69,148,148,79,375
355030873000127,1,120,70,159,159,108,426
355030873000128,1,139,44,129,129,114,372
355030873000129,1,115,43,119,119,121,359
355030873000130,1,147,83,176,176,119,471
355030873000131,1,114,67,145,145,121,411
355030873000132,1,91,37,128,128,103,359
355030873000133,1,102,42,108,108,86,302
355030873000134,1,175,72,129,129,69,327
355030873000135,1,125,60,173,173,117,463
355030873000136,1,136,77,191,191,109,491
355030873000137,1,50,24,63,63,32,158
355030873000138,1,199,102,222,222,126,570
355030873000139,1,139,84,172,172,114,458
355030873000140,1,185,106,245,245,192,682
355030873000141,1,166,83,194,194,186,574
355030873000142,1,119,81,182,182,137,501
355030873000143,1,101,64,121,121,122,364
355030873000144,1,138,60,136,136,76,348
355030873000145,1,68,20,60,60,28,148
355030873000146,1,212,98,247,247,159,653
355030873000147,1,130,70,181,181,114,476
355030873000148,1,143,43,216,216,80,512
355030873000149,1,149,57,201,201,87,489
355030873000150,1,158,60,219,219,88,526
355030873000151,1,118,51,186,186,77,449
355030873000152,1,59,31,90,90,88,268
355030873000153,1,142,67,204,204,158,566
355030873000154,1,76,37,123,123,109,355
355030873000155,1,91,59,135,135,121,391
355030873000156,1,148,92,194,194,168,556
355030873000157,1,171,87,228,228,130,586
355030873000158,1,67,47,109,109,90,308
355030873000159,1,81,40,106,106,67,279
355030873000160,1,300,112,334,334,256,924
355030873000161,1,147,65,144,144,106,394
355030873000162,1,269,122,260,260,144,664
355030873000163,1,50,20,42,42,15,99
355030873000164,1,164,72,154,154,121,429
355030873000165,1,151,62,143,143,102,388
355030873000166,1,134,66,150,150,100,400
355030873000167,1,138,87,166,166,121,453
355030873000168,1,202,107,245,245,142,632
355030873000169,1,347,149,422,422,166,1010
355030873000170,1,164,71,171,171,109,451
355030873000171,1,111,52,135,135,101,371
355030873000172,1,124,58,136,136,106,378
355030873000173,1,102,58,137,137,86,360
355030873000174,1,95,55,123,123,89,335
355030873000175,1,196,106,249,249,181,679
355030873000176,1,86,44,97,97,108,302
355030873000177,1,64,33,96,96,88,280
355030873000178,1,97,59,139,139,120,398
355030873000179,1,114,60,203,203,127,533
355030873000180,1,156,84,176,176,134,486
355030873000181,1,133,66,178,178,133,489
355030873000182,1,151,59,216,216,110,542
355030873000183,1,126,46,189,189,72,450
355030873000184,1,157,78,229,229,193,651
355030873000185,1,184,51,265,265,107,637
355030873000186,1,134,68,169,169,170,508
355030873000187,1,107,69,151,151,119,421
355030873000188,1,66,38,81,81,70,232
355030873000189,1,146,73,166,166,106,438
355030873000190,1,115,54,136,136,111,383
355030873000191,1,164,103,214,214,158,586
355030873000192,1,108,52,138,138,118,394
355030873000193,1,105,51,134,134,117,385
355030873000194,1,78,42,84,84,66,234
355030873000195,1,83,36,135,135,90,360
355030873000196,1,123,52,134,134,96,364
355030873000197,1,269,131,322,322,182,826
355030873000198,1,173,91,202,202,159,563
355030873000199,1,125,52,153,153,109,415
355030873000200,1,172,81,197,197,114,508
355030873000201,1,108,61,117,117,77,311
355030873000202,1,129,89,145,145,129,419
355030873000203,1,118,54,140,140,132,412
355030873000204,1,91,47,117,117,80,314
355030873000205,1,61,32,78,78,77,233
355030873000206,1,82,47,122,122,106,350
355030873000207,1,143,59,150,150,121,421
355030873000208,1,150,79,161,161,145,467
355030873000209,1,118,50,142,142,81,365
355030873000210,1,121,50,114,114,75,303
355030873000211,1,84,47,104,104,57,265
355030873000212,1,145,70,148,148,106,402
355030873000213,1,63,41,137,137,77,351
355030873000214,1,171,64,122,122,54,298
355030873000215,1,80,32,65,65,36,166
355030873000217,1,91,55,78,78,45,201
355030873000218,1,157,73,135,135,107,377
355030873000219,1,47,17,49,49,13,111
355030873000220,1,78,16,74,74,19,167
355030873000221,1,98,48,98,98,43,239
355030873000222,1,188,107,202,202,110,514
355030873000223,1,137,69,149,149,108,406
355030873000224,1,74,21,65,65,25,155
355030873000225,1,67,28,72,72,35,179
355030874000001,1,98,48,143,143,100,386
355030874000002,1,123,79,149,149,132,430
355030874000003,1,152,64,157,157,104,418
355030874000004,1,172,82,211,211,90,512
355030874000005,1,156,97,244,244,174,662
355030874000006,1,182,120,240,240,174,654
355030874000007,1,198,104,246,246,160,652
355030874000008,1,112,69,149,149,118,416
355030874000009,1,106,58,125,125,92,342
355030874000010,1,158,76,204,204,140,548
355030874000011,1,167,87,184,184,134,502
355030874000012,1,147,103,170,170,164,504
355030874000013,1,162,75,169,169,135,473
355030874000014,1,113,77,135,135,173,443
355030874000015,1,118,71,154,154,139,447
355030874000016,1,208,111,273,273,152,698
355030874000017,1,175,101,179,179,127,485
355030874000018,1,77,34,103,103,76,282
355030874000019,1,144,67,135,135,120,390
355030874000020,1,183,80,254,254,118,626
355030874000021,1,85,60,117,117,110,344
355030874000022,1,145,85,191,191,138,520
355030874000023,1,78,43,111,111,105,327
355030874000024,1,110,51,128,128,99,355
355030874000025,1,109,62,146,146,114,406
355030874000026,1,188,81,231,231,137,599
355030874000027,1,166,95,188,188,142,518
355030874000028,1,113,57,141,141,111,393
355030874000029,1,97,39,90,90,78,258
355030874000030,1,160,75,184,184,141,509
355030874000031,1,137,85,165,165,155,485
355030874000032,1,174,98,198,198,117,513
355030874000033,1,110,82,140,140,119,399
355030874000034,1,136,76,155,155,97,407
355030874000035,1,148,75,181,181,130,492
355030874000036,1,209,99,209,209,141,559
355030874000037,1,127,66,164,164,124,452
355030874000038,1,110,58,148,148,76,372
355030874000039,1,154,69,175,175,122,472
355030874000040,1,88,33,108,108,75,291
355030874000041,1,168,93,172,172,138,482
355030874000042,1,227,104,261,261,182,704
355030874000043,1,79,38,81,81,59,221
355030874000044,1,127,53,138,138,100,376
355030874000045,1,85,45,100,100,67,267
355030874000046,1,139,76,158,158,118,434
355030874000047,1,161,71,166,166,102,434
355030874000048,1,155,77,161,161,88,410
355030874000049,1,80,42,102,102,68,272
355030874000050,1,148,72,143,143,105,391
355030874000051,1,113,47,138,138,66,342
355030874000052,1,136,77,134,134,83,351
355030874000053,1,109,71,151,151,147,449
355030874000054,1,162,82,225,225,140,590
355030874000055,1,77,37,92,92,98,282
355030874000056,1,187,96,229,229,161,619
355030874000057,1,133,83,170,170,148,488
355030874000058,1,145,69,155,155,113,423
355030874000059,1,64,36,61,61,30,152
355030874000060,1,136,72,181,181,110,472
355030874000061,1,156,84,165,165,107,437
355030874000062,1,113,53,124,124,88,336
355030874000063,1,148,62,217,217,129,563
355030874000064,1,109,54,129,129,89,347
355030874000065,1,196,97,262,262,206,730
355030874000066,1,80,48,113,113,120,346
355030874000067,1,134,68,202,202,126,530
355030874000068,1,93,48,110,110,94,314
355030874000069,1,90,57,90,90,121,301
355030874000070,1,129,61,195,195,97,487
355030874000071,1,124,70,144,144,132,420
355030874000072,1,120,74,154,154,122,430
355030874000073,1,174,97,221,221,163,605
355030874000074,1,156,69,161,161,92,414
355030874000075,1,232,99,225,225,144,594
355030874000076,1,126,46,89,89,68,246
355030874000077,1,123,52,85,85,36,206
355030874000078,1,78,41,85,85,57,227
355030874000079,1,231,95,188,188,52,428
355030874000080,1,74,38,106,106,107,319
355030874000081,1,71,35,92,92,93,277
355030874000082,1,82,38,128,128,101,357
355030874000083,1,114,60,158,158,127,443
355030874000084,1,129,81,177,177,164,518
355030874000085,1,144,55,143,143,135,421
355030874000086,1,116,57,131,131,123,385
355030874000087,1,214,112,248,248,212,708
355030874000088,1,97,54,124,124,105,353
355030874000089,1,120,57,122,122,113,357
355030874000090,1,96,44,112,112,102,326
355030874000091,1,41,19,57,57,52,166
355030874000092,1,58,27,88,88,99,275
355030874000093,1,15,6,34,34,38,106
355030874000094,1,62,49,76,76,134,286
355030874000095,1,50,52,63,63,74,200
355030874000096,1,105,46,136,136,78,350
355030874000097,1,74,33,112,112,92,316
355030874000098,1,134,81,182,182,150,514
355030874000099,1,169,58,144,144,111,399
355030874000100,1,167,55,176,176,140,492
355030874000101,1,100,66,159,159,123,441
355030874000102,1,118,79,164,164,184,512
355030874000103,1,108,65,141,141,123,405
355030874000104,1,74,60,103,103,78,284
355030874000105,1,141,72,175,175,128,478
355030874000106,1,82,49,101,101,73,275
355030874000107,1,83,46,98,98,94,290
355030874000108,1,68,29,89,89,68,246
355030874000109,1,134,76,166,166,192,524
355030874000110,1,75,25,79,79,67,225
355030874000111,1,43,23,74,74,62,210
355030874000112,1,18,5,32,32,35,99
355030874000113,1,75,52,77,77,67,221
355030874000114,1,79,36,88,88,89,265
355030874000115,1,74,35,71,71,58,200
355030874000116,1,115,41,103,103,67,273
355030874000117,1,224,96,231,231,173,635
355030874000118,1,131,45,116,116,106,338
355030874000119,1,209,113,220,220,138,578
355030874000120,1,142,86,190,190,224,604
355030874000121,1,60,43,84,84,61,229
355030874000122,1,93,48,122,122,84,328
355030874000123,1,250,128,239,239,134,612
355030874000124,1,69,40,91,91,38,220
355030874000125,1,60,37,84,84,60,228
355030874000126,1,77,45,101,101,71,273
355030874000127,1,82,33,82,82,87,251
355030874000128,1,120,73,160,160,90,410
355030874000129,1,35,21,40,40,18,98
355030874000130,1,76,24,73,73,52,198
355030874000131,1,230,93,202,202,85,489
355030874000134,1,303,122,256,256,94,606
355030874000135,1,291,131,273,273,126,672
355030874000136,1,147,57,161,161,105,427
355030874000137,1,126,51,144,144,87,375
355030874000138,1,106,78,130,130,98,358
355030874000139,1,109,62,139,139,118,396
355030874000140,1,87,46,72,72,30,174
355030874000141,1,128,72,160,160,113,433
355030874000143,1,132,42,101,101,67,269
355030874000144,1,46,24,39,39,29,107
355030874000145,1,96,29,62,62,50,174
355030874000146,1,92,43,87,87,47,221
355030874000147,1,79,41,65,65,33,163
355030874000148,1,49,25,50,50,13,113
355030875000001,1,143,71,195,195,139,529
355030875000002,1,74,42,96,96,75,267
355030875000003,1,65,22,68,68,43,179
355030875000004,1,102,51,127,127,106,360
355030875000005,1,178,76,268,268,163,699
355030875000006,1,133,81,194,194,158,546
355030875000007,1,109,50,156,156,90,402
355030875000008,1,154,65,119,119,83,321
355030875000009,1,82,34,91,91,85,267
355030875000010,1,140,74,170,170,118,458
355030875000011,1,136,86,194,194,170,558
355030875000012,1,163,110,239,239,167,645
355030875000013,1,128,79,179,179,126,484
355030875000014,1,138,81,213,213,177,603
355030875000015,1,96,69,128,128,122,378
355030875000016,1,74,50,126,126,95,347
355030875000017,1,108,83,151,151,147,449
355030875000018,1,90,92,169,169,246,584
355030875000019,1,119,58,143,143,149,435
355030875000020,1,110,62,138,138,82,358
355030875000021,1,169,62,170,170,143,483
355030875000022,1,136,63,153,153,118,424
355030875000023,1,121,47,135,135,104,374
355030875000024,1,225,134,261,261,190,712
355030875000025,1,102,59,145,145,105,395
355030875000026,1,165,87,198,198,154,550
355030875000027,1,129,80,136,136,73,345
355030875000028,1,191,102,212,212,142,566
355030875000029,1,156,71,147,147,89,383
355030875000030,1,110,55,134,134,81,349
355030875000031,1,120,53,147,147,109,403
355030875000032,1,132,74,192,192,145,529
355030875000033,1,156,56,219,219,152,590
355030875000034,1,120,64,195,195,132,522
355030875000035,1,102,63,157,157,103,417
355030875000036,1,68,40,118,118,86,322
355030875000037,1,93,69,184,184,172,540
355030875000038,1,98,44,160,160,98,418
355030875000039,1,115,67,145,145,148,438
355030875000040,1,102,55,134,134,118,386
355030875000041,1,137,49,173,173,114,460
355030875000042,1,127,78,167,167,158,492
355030875000043,1,100,71,145,145,126,416
355030875000044,1,118,59,147,147,102,396
355030875000045,1,120,44,134,134,106,374
355030875000046,1,120,38,132,132,45,309
355030875000047,1,72,38,86,86,82,254
355030875000048,1,103,55,135,135,83,353
355030875000049,1,122,68,149,149,99,397
355030875000050,1,232,128,219,219,179,617
355030875000051,1,145,66,148,148,117,413
355030875000052,1,110,45,87,87,45,219
355030875000053,1,288,114,267,267,146,680
355030875000054,1,246,105,224,224,104,552
355030875000055,1,360,143,332,332,163,827
355030875000056,1,129,62,143,143,88,374
355030875000057,1,98,43,122,122,96,340
355030875000058,1,116,66,106,106,124,336
355030875000059,1,233,108,209,209,205,623
355030875000060,1,48,19,34,34,20,88
355030875000061,1,93,39,124,124,102,350
355030875000062,1,186,88,170,170,103,443
355030875000063,1,181,95,176,176,120,472
355030875000064,1,352,141,359,359,171,889
355030875000065,1,581,207,470,470,236,1176
355030875000066,1,117,59,137,137,78,352
355030875000067,1,132,75,167,167,131,465
355030875000068,1,20,19,35,35,20,90
355030875000069,1,91,56,112,112,83,307
355030875000070,1,135,70,173,173,145,491
355030875000071,1,70,58,113,113,109,335
355030875000072,1,314,109,415,415,168,998
355030875000073,1,72,53,100,100,102,302
355030875000074,1,91,35,103,103,71,277
355030875000075,1,159,69,237,237,120,594
355030875000076,1,258,112,293,293,149,735
355030875000077,1,108,50,138,138,92,368
355030875000078,1,157,66,193,193,145,531
355030875000079,1,148,55,186,186,132,504
355030875000080,1,120,62,145,145,127,417
355030875000081,1,75,51,111,111,82,304
355030875000082,1,151,71,153,153,126,432
355030875000084,1,110,66,142,142,103,387
355030875000085,1,113,55,112,112,115,339
355030875000086,1,123,57,158,158,93,409
355030875000087,1,149,73,181,181,117,479
355030875000088,1,134,84,150,150,164,464
355030875000089,1,113,73,157,157,133,447
355030875000090,1,145,70,155,155,119,429
355030875000091,1,161,70,190,190,116,496
355030875000092,1,199,99,208,208,139,555
355030875000093,1,118,62,132,132,98,362
355030875000094,1,115,84,152,152,93,397
355030875000095,1,137,64,147,147,100,394
355030875000096,1,202,93,222,222,134,578
355030875000097,1,187,80,181,181,94,456
355030875000098,1,113,28,93,93,29,215
355030875000099,1,95,45,94,94,87,275
355030875000100,1,148,79,173,173,117,463
355030875000101,1,186,82,225,225,137,587
355030875000102,1,361,144,290,290,112,692
355030875000103,1,158,89,140,140,76,356
355030875000104,1,155,102,183,183,178,544
355030875000105,1,131,65,100,100,111,311
355030875000106,1,199,87,208,208,87,503
355030875000107,1,134,50,124,124,70,318
355030875000108,1,232,106,250,250,159,659
355030875000109,1,112,69,125,125,77,327
355030875000110,1,140,57,153,153,94,400
355030875000111,1,127,48,111,111,109,331
355030875000112,1,120,81,141,141,70,352
355030875000113,1,160,75,165,165,105,435
355030875000114,1,89,57,85,85,65,235
355030875000115,1,91,75,105,105,75,285
355030875000116,1,123,53,124,124,76,324
355030875000117,1,125,42,126,126,89,341
355030875000118,1,62,32,79,79,49,207
355030875000119,1,390,116,377,377,84,838
355030875000120,1,106,47,88,88,31,207
355030875000121,1,102,42,68,68,50,186
355030875000122,1,425,161,368,368,129,865
355030875000123,1,691,205,603,603,190,1396
355030875000124,1,279,171,272,272,92,636
355030875000125,1,310,138,247,247,117,611
355030875000126,1,98,68,117,117,93,327
355030875000127,1,287,131,262,262,97,621
355030875000128,1,227,97,218,218,100,536
355030875000129,1,327,136,284,284,93,661
355030875000130,1,113,36,81,81,47,209
355030875000131,1,582,204,547,547,173,1267
355030875000132,1,367,106,313,313,98,724
355030875000133,1,405,169,414,414,155,983
355030875000135,1,157,58,138,138,75,351
355030875000136,1,238,96,248,248,80,576
355030875000137,1,227,102,225,225,129,579
355030875000138,1,501,186,402,402,213,1017
355030875000139,1,286,131,274,274,124,672
355030875000140,1,417,144,436,436,172,1044
355030875000141,1,484,178,415,415,174,1004
355030875000142,1,181,82,168,168,97,433
355030875000143,1,378,144,293,293,115,701
355030875000144,1,504,190,451,451,144,1046
355030875000145,8,67,29,55,55,27,137
355030875000146,1,212,86,202,202,100,504
355030875000147,1,178,89,167,167,116,450
355030875000148,1,233,107,170,170,93,433
355030875000149,1,144,76,123,123,63,309
355030875000150,1,242,72,173,173,65,411
355030875000151,1,123,76,122,122,144,388
355030875000152,1,148,115,140,140,169,449
355030875000153,1,326,108,261,261,85,607
355030875000154,1,101,54,93,93,62,248
355030875000155,1,138,66,90,90,92,272
355030875000156,1,74,45,74,74,67,215
355030875000157,1,237,105,192,192,99,483
355030875000158,1,407,141,323,323,138,784
355030875000159,1,70,51,77,77,50,204
355030875000160,1,255,86,223,223,88,534
355030875000161,1,77,39,98,98,40,236
355030875000162,1,672,237,518,518,208,1244
355030875000163,1,482,137,319,319,154,792
355030875000164,1,133,56,89,89,47,225
355030875000165,1,200,74,138,138,69,345
355030875000166,1,141,70,120,120,56,296
355030875000167,1,474,179,329,329,109,767
355030875000168,1,51,33,46,46,52,144
355030875000169,1,186,101,193,193,205,591
355030875000170,1,146,67,124,124,36,284
355030875000171,1,355,100,300,300,115,715
355030875000172,1,56,19,44,44,17,105
355030875000173,1,31,17,36,36,38,110
355030875000174,1,63,31,74,74,35,183
355030875000175,1,426,145,389,389,146,924
355030875000176,1,85,35,67,67,34,168
355030875000177,1,197,101,209,209,100,518
355030875000178,1,417,179,378,378,136,892
355030875000179,8,22,9,12,12,16,40
355030875000180,4,40,26,60,60,24,144
355030875000182,4,4,2,6,6,0,12
355030875000183,4,13,7,18,18,7,43
355030875000184,1,86,47,95,95,32,222
355030875000188,1,56,26,48,48,17,113
355030875000189,4,116,41,87,87,34,208
355030875000190,4,60,29,49,49,12,110
355030875000191,4,139,56,126,126,50,302
355030875000195,1,12,6,15,15,3,33
355030875000196,1,34,23,34,34,31,99
355030875000199,1,11,17,15,15,12,42
355030875000200,4,89,42,89,89,45,223
355030875000201,1,86,32,67,67,20,154
355030875000203,4,76,32,71,71,30,172
355030875000204,1,48,27,39,39,16,94
355030875000205,1,70,25,68,68,27,163
355030875000206,1,64,30,76,76,42,194
355030875000207,1,185,87,125,125,62,312
355030875000208,1,49,30,28,28,7,63
355030875000209,1,230,76,181,181,46,408
355030875000210,1,474,186,292,292,122,706
355030875000211,1,205,79,118,118,48,284
355030875000212,1,162,51,160,160,49,369
355030876000001,1,111,48,180,180,104,464
355030876000002,1,98,48,154,154,116,424
355030876000003,1,52,27,51,51,49,151
355030876000004,1,127,50,153,153,127,433
355030876000005,1,151,77,211,211,145,567
355030876000006,1,88,45,109,109,137,355
355030876000007,1,151,68,191,191,120,502
355030876000008,1,125,67,161,161,157,479
355030876000009,1,176,78,221,221,172,614
355030876000010,1,151,84,179,179,183,541
355030876000011,1,88,40,119,119,61,299
355030876000012,1,122,64,143,143,147,433
355030876000013,1,99,50,120,120,97,337
355030876000014,1,48,13,50,50,41,141
355030876000015,1,284,124,264,264,207,735
355030876000016,1,217,92,215,215,150,580
355030876000017,1,76,48,77,77,34,188
355030876000018,1,140,57,224,224,154,602
355030876000019,1,112,78,178,178,161,517
355030876000020,1,120,66,167,167,124,458
355030876000021,1,160,90,201,201,179,581
355030876000022,1,140,74,188,188,106,482
355030876000023,1,85,55,137,137,157,431
355030876000024,1,184,79,194,194,150,538
355030876000025,1,210,79,326,326,186,838
355030876000026,1,133,87,179,179,151,509
355030876000027,1,154,76,205,205,165,575
355030876000028,1,74,54,114,114,109,337
355030876000029,1,154,85,187,187,184,558
355030876000030,1,125,66,206,206,213,625
355030876000031,1,131,72,131,131,87,349
355030876000032,1,88,39,114,114,55,283
355030876000033,1,88,45,110,110,73,293
355030876000034,1,208,99,215,215,167,597
355030876000035,1,178,86,198,198,149,545
355030876000036,1,180,98,227,227,167,621
355030876000037,1,212,104,245,245,165,655
355030876000038,1,111,61,180,180,110,470
355030876000039,1,116,66,214,214,141,569
355030876000040,1,219,114,284,284,181,749
355030876000041,1,132,65,134,134,134,402
355030876000042,1,138,118,220,220,158,598
355030876000043,1,199,79,239,239,140,618
355030876000044,1,150,71,194,194,151,539
355030876000045,1,112,49,161,161,131,453
355030876000046,1,337,150,419,419,245,1083
355030876000047,1,165,73,197,197,165,559
355030876000048,1,211,95,263,263,203,729
355030876000049,1,230,99,246,246,186,678
355030876000050,1,154,72,199,199,167,565
355030876000051,1,120,48,163,163,148,474
355030876000052,1,99,53,136,136,130,402
355030876000053,1,325,153,387,387,281,1055
355030876000054,1,59,43,96,96,73,265
355030876000055,1,93,56,129,129,93,351
355030876000056,1,99,48,144,144,108,396
355030876000057,1,114,57,130,130,95,355
355030876000058,1,103,58,108,108,110,326
355030876000059,1,173,60,194,194,111,499
355030876000060,1,171,80,213,213,157,583
355030876000061,1,153,78,169,169,105,443
355030876000062,1,91,57,100,100,94,294
355030876000063,1,116,83,178,178,126,482
355030876000064,1,203,85,234,234,138,606
355030876000065,1,184,79,193,193,121,507
355030876000066,1,366,142,322,322,170,814
355030876000067,1,133,52,139,139,138,416
355030876000068,1,378,143,324,324,136,784
355030876000069,1,105,63,151,151,127,429
355030876000070,1,111,77,143,143,178,464
355030876000071,1,115,70,178,178,164,520
355030876000072,1,130,60,162,162,145,469
355030876000073,1,136,63,232,232,197,661
355030876000074,1,142,52,107,107,53,267
355030876000075,1,109,84,171,171,165,507
355030876000076,1,111,84,158,158,169,485
355030876000077,1,127,73,177,177,144,498
355030876000078,1,93,49,128,128,117,373
355030876000079,1,44,28,61,61,57,179
355030876000080,1,42,16,57,57,49,163
355030876000081,1,181,123,222,222,173,617
355030876000082,1,81,33,87,87,51,225
355030876000083,1,125,63,141,141,120,402
355030876000084,1,217,108,235,235,161,631
355030876000085,1,261,112,255,255,172,682
355030876000086,1,167,79,180,180,97,457
355030876000087,1,163,74,154,154,106,414
355030876000088,1,48,28,38,38,40,116
355030876000089,1,182,85,161,161,114,436
355030876000090,1,105,39,79,79,36,194
355030876000091,1,605,271,455,455,263,1173
355030876000092,1,199,113,168,168,112,448
355030876000093,1,200,123,242,242,270,754
355030876000094,1,214,95,269,269,159,697
355030876000095,1,138,72,160,160,130,450
355030876000096,1,91,38,105,105,61,271
355030876000097,1,106,60,127,127,108,362
355030876000098,1,182,102,202,202,197,601
355030876000099,1,143,60,173,173,102,448
355030876000100,1,95,71,111,111,95,317
355030876000101,1,258,101,221,221,151,593
355030876000102,1,225,90,190,190,116,496
355030876000103,1,257,147,210,210,136,556
355030876000104,1,170,65,211,211,121,543
355030876000105,1,181,87,228,228,199,655
355030876000106,1,114,52,158,158,157,473
355030876000107,1,183,82,213,213,197,623
355030876000108,1,128,41,139,139,129,407
355030876000109,1,152,72,180,180,153,513
355030876000110,1,199,90,139,139,104,382
355030876000111,1,182,104,182,182,88,452
355030876000112,1,173,94,123,123,65,311
355030876000113,1,208,66,225,225,163,613
355030876000114,1,58,38,88,88,64,240
355030876000115,1,159,66,192,192,136,520
355030876000116,1,131,75,160,160,109,429
355030876000117,1,142,80,174,174,158,506
355030876000118,1,118,50,179,179,116,474
355030876000119,1,142,75,205,205,143,553
355030876000120,1,165,81,221,221,148,590
355030876000121,1,132,57,128,128,77,333
355030876000122,1,423,177,315,315,178,808
355030876000123,1,316,133,219,219,129,567
355030876000124,1,231,92,178,178,70,426
355030876000125,1,138,43,142,142,42,326
355030876000126,1,374,176,326,326,231,883
355030876000127,1,152,83,189,189,153,531
355030876000128,1,125,43,147,147,90,384
355030876000129,1,87,61,141,141,65,347
355030876000130,1,196,114,273,273,133,679
355030876000131,1,71,36,101,101,56,258
355030876000132,1,235,107,229,229,111,569
355030876000133,1,97,41,99,99,44,242
355030876000134,1,175,64,202,202,108,512
355030876000135,1,171,99,228,228,154,610
355030876000136,1,112,78,151,151,76,378
355030876000137,1,193,100,239,239,122,600
355030876000138,1,129,63,144,144,99,387
355030876000139,1,220,100,274,274,149,697
355030876000140,1,313,143,277,277,170,724
355030876000141,1,57,38,64,64,57,185
355030876000142,1,193,102,195,195,144,534
355030876000143,1,149,69,180,180,155,515
355030876000144,1,172,87,212,212,229,653
355030876000145,1,78,59,115,115,120,350
355030876000146,1,82,57,114,114,125,353
355030876000147,1,159,74,181,181,170,532
355030876000148,1,167,93,215,215,171,601
355030876000149,1,138,65,174,174,136,484
355030876000150,1,118,53,131,131,79,341
355030876000151,1,89,36,98,98,94,290
355030876000152,1,201,116,247,247,217,711
355030876000153,1,167,77,213,213,147,573
355030876000154,1,136,58,139,139,120,398
355030876000155,1,211,119,229,229,182,640
355030876000156,1,267,142,290,290,196,776
355030876000157,1,39,17,37,37,21,95
355030876000158,1,269,95,239,239,119,597
355030876000159,1,277,123,290,290,130,710
355030876000160,1,373,207,294,294,178,766
355030876000161,1,134,44,93,93,65,251
355030876000162,1,172,108,214,214,190,618
355030876000163,1,52,27,86,86,68,240
355030876000164,1,233,90,256,256,171,683
355030876000165,1,59,14,56,56,29,141
355030876000166,1,64,22,53,53,12,118
355030876000167,1,92,38,96,96,82,274
355030876000168,1,245,112,263,263,125,651
355030876000169,1,421,159,266,266,157,689
355030876000170,1,106,45,111,111,102,324
355030876000171,1,148,75,201,201,130,532
355030876000172,1,12,2,8,8,12,28
355030876000173,1,259,97,286,286,185,757
355030876000174,1,120,77,174,174,149,497
355030876000175,1,132,78,169,169,128,466
355030876000176,1,101,29,101,101,91,293
355030876000177,1,170,93,216,216,170,602
355030876000178,1,113,56,145,145,92,382
355030876000179,1,312,118,255,255,84,594
355030876000180,1,466,206,390,390,165,945
355030876000181,1,108,70,131,131,117,379
355030876000182,1,119,54,157,157,130,444
355030876000183,1,135,38,140,140,108,388
355030876000184,1,113,52,143,143,97,383
355030876000185,1,111,57,157,157,132,446
355030876000186,1,150,83,199,199,137,535
355030876000187,1,203,98,254,254,174,682
355030876000188,1,140,75,136,136,133,405
355030876000189,1,115,47,136,136,101,373
355030876000190,1,174,95,229,229,134,592
355030876000191,1,207,115,263,263,174,700
355030876000192,1,217,117,246,246,154,646
355030876000193,1,154,74,201,201,119,521
355030876000194,1,181,105,256,256,159,671
355030876000195,1,240,119,278,278,147,703
355030876000196,1,223,118,205,205,123,533
355030876000197,1,136,51,87,87,45,219
355030876000198,1,167,65,129,129,79,337
355030876000199,1,506,208,326,326,160,812
355030876000200,1,163,95,202,202,144,548
355030876000201,1,123,78,214,214,171,599
355030876000202,1,132,80,189,189,170,548
355030876000203,1,100,69,179,179,133,491
355030876000204,1,84,62,144,144,162,450
355030876000205,1,137,78,191,191,168,550
355030876000206,1,140,91,178,178,150,506
355030876000207,1,46,23,63,63,49,175
355030876000208,1,192,90,166,166,111,443
355030876000209,1,145,88,157,157,131,445
355030876000210,1,227,96,236,236,161,633
355030876000211,1,124,61,136,136,127,399
355030876000212,1,125,54,119,119,99,337
355030876000213,1,92,53,128,128,88,344
355030876000214,1,130,67,154,154,115,423
355030876000215,1,106,60,159,159,136,454
355030876000216,1,217,130,264,264,191,719
355030876000217,1,124,49,159,159,115,433
355030876000218,1,95,54,139,139,116,394
355030876000219,1,303,148,251,251,169,671
355030876000220,1,235,129,241,241,203,685
355030876000221,1,237,134,248,248,182,678
355030876000222,1,177,90,158,158,135,451
355030876000223,1,129,64,115,115,103,333
355030876000224,1,103,49,91,91,84,266
355030876000225,1,163,70,173,173,110,456
355030876000226,1,298,125,244,244,134,622
355030876000227,1,98,52,74,74,60,208
355030876000228,1,142,66,127,127,77,331
355030876000229,1,239,160,296,296,236,828
355030876000230,1,162,72,244,244,109,597
355030876000231,1,92,52,130,130,137,397
355030876000232,1,82,41,129,129,143,401
355030876000233,1,102,70,175,175,158,508
355030876000234,1,114,65,160,160,196,516
355030876000235,1,154,77,202,202,207,611
355030876000236,1,155,70,192,192,197,581
355030876000237,1,310,134,267,267,192,726
355030876000238,1,149,86,204,204,147,555
355030876000239,1,211,95,214,214,183,611
355030876000240,1,241,141,230,230,104,564
355030876000241,1,57,25,60,60,35,155
355030876000242,1,183,114,234,234,174,642
355030876000243,1,157,87,159,159,130,448
355030876000244,1,373,190,326,326,156,808
355030876000245,1,168,92,218,218,192,628
355030876000246,1,59,35,98,98,99,295
355030876000247,1,95,73,117,117,149,383
355030876000248,1,164,77,203,203,187,593
355030876000249,1,111,76,158,158,192,508
355030876000250,1,131,63,157,157,167,481
355030876000251,1,173,101,228,228,196,652
355030876000252,1,105,66,188,188,170,546
355030876000253,1,192,102,197,197,208,602
355030876000254,1,94,49,134,134,123,391
355030876000255,1,69,28,70,70,44,184
355030876000256,1,153,75,197,197,134,528
355030876000257,1,166,92,202,202,154,558
355030876000258,1,266,108,258,258,136,652
355030876000259,1,144,79,191,191,140,522
355030876000260,1,154,98,205,205,166,576
355030876000261,1,203,81,214,214,165,593
355030876000262,1,129,58,165,165,146,476
355030876000263,1,141,69,198,198,135,531
355030876000264,1,87,56,105,105,104,314
355030876000265,1,204,123,222,222,192,636
355030876000266,1,144,82,150,150,174,474
355030876000267,1,213,93,204,204,173,581
355030876000268,1,330,174,360,360,198,918
355030876000269,1,184,93,217,217,143,577
355030876000270,1,273,163,253,253,211,717
355030876000271,1,149,107,142,142,136,420
355030876000272,1,28,16,38,38,62,138
355030876000273,1,87,29,127,127,119,373
355030876000274,1,99,40,139,139,100,378
355030876000275,1,65,36,99,99,97,295
355030876000276,1,91,53,149,149,94,392
355030876000277,1,69,58,101,101,146,348
355030876000278,1,102,41,144,144,142,430
355030876000279,1,108,77,149,149,136,434
355030876000280,1,108,71,186,186,167,539
355030876000281,1,104,71,162,162,131,455
355030876000282,1,85,72,117,117,159,393
355030876000283,1,85,42,117,117,101,335
355030876000284,1,132,81,229,229,195,653
355030876000285,1,141,79,181,181,161,523
355030876000286,1,167,92,177,177,161,515
355030876000287,1,156,66,181,181,115,477
355030876000288,1,132,66,175,175,172,522
355030876000289,1,99,50,171,171,144,486
355030876000290,1,9,5,7,7,12,26
355030876000291,1,143,79,203,203,145,551
355030876000292,1,97,44,133,133,99,365
355030876000293,1,180,108,210,210,161,581
355030876000294,1,237,143,269,269,178,716
355030876000295,1,101,57,143,143,107,393
355030876000296,1,77,43,81,81,43,205
355030876000297,1,139,73,159,159,118,436
355030876000298,1,121,58,129,129,79,337
355030876000299,1,66,33,59,59,30,148
355030876000300,1,119,44,106,106,44,256
355030876000301,1,50,24,59,59,18,136
355030876000302,1,381,190,390,390,235,1015
355030876000303,1,276,149,275,275,196,746
355030876000304,1,274,143,249,249,148,646
355030876000305,1,150,82,165,165,113,443
355030876000306,1,200,108,214,214,135,563
355030876000307,1,125,88,167,167,203,537
355030876000308,1,127,53,145,145,152,442
355030876000309,1,97,46,134,134,106,374
355030876000310,1,63,48,96,96,103,295
355030876000311,1,155,65,172,172,127,471
355030876000312,1,108,62,162,162,134,458
355030876000313,1,130,88,173,173,190,536
355030876000314,1,136,71,142,142,151,435
355030876000315,1,238,117,256,256,235,747
355030876000316,1,203,148,243,243,199,685
355030876000317,1,297,123,284,284,129,697
355030876000318,1,63,31,53,53,33,139
355030876000319,1,344,147,338,338,177,853
355030876000320,1,376,171,402,402,292,1096
355030876000321,1,251,72,235,235,166,636
355030876000322,1,237,112,239,239,145,623
355030876000323,1,81,51,85,85,54,224
355030876000324,1,120,54,145,145,140,430
355030876000325,1,121,65,148,148,89,385
355030876000326,1,101,70,122,122,97,341
355030876000327,1,78,34,97,97,72,266
355030876000328,1,130,85,185,185,124,494
355030876000329,1,167,76,205,205,160,570
355030876000330,1,51,30,51,51,63,165
355030876000331,1,137,57,176,176,127,479
355030876000332,1,122,48,181,181,80,442
355030876000333,1,147,64,152,152,85,389
355030876000334,1,93,32,121,121,106,348
355030876000335,1,80,16,115,115,39,269
355030876000336,1,162,104,166,166,107,439
355030876000337,1,140,101,148,148,140,436
355030876000338,1,191,85,141,141,68,350
355030876000339,1,94,33,107,107,72,286
355030876000340,1,248,122,244,244,172,660
355030876000341,1,88,34,105,105,55,265
355030876000342,1,299,134,227,227,116,570
355030876000343,1,87,42,112,112,102,326
355030876000344,1,32,18,44,44,35,123
355030876000345,1,28,14,31,31,27,89
355030876000346,1,86,50,89,89,90,268
355030876000347,1,4,4,8,8,5,21
355030876000348,1,29,29,35,35,37,107
355030876000350,1,38,20,59,59,71,189
355030876000351,1,53,28,57,57,38,152
355030876000352,1,45,25,61,61,37,159
355030876000354,1,94,51,102,102,80,284
355030876000355,1,148,71,145,145,69,359
355030876000356,1,66,36,61,61,25,147
355030876000357,1,42,37,69,69,40,178
355030876000358,1,101,32,84,84,58,226
355030876000359,1,59,21,47,47,37,131
355030876000360,1,36,25,43,43,29,115
355030876000361,1,111,73,128,128,84,340
355030876000362,1,50,30,48,48,35,131
355030876000363,1,114,42,96,96,28,220
355030876000364,1,245,133,254,254,133,641
355030876000365,1,44,27,54,54,28,136
355030876000366,1,161,64,115,115,73,303
355030876000367,1,181,76,159,159,99,417
355030876000368,1,180,84,149,149,66,364
355030876000369,1,91,42,102,102,44,248
355030876000370,1,49,30,62,62,39,163
355030876000371,1,200,104,210,210,74,494
355030876000372,1,66,37,45,45,46,136
355030876000373,1,107,38,60,60,44,164
355030876000374,1,115,54,90,90,69,249
355030876000375,1,88,49,105,105,41,251
355030876000376,1,158,93,193,193,67,453
355030876000377,1,184,72,142,142,44,328
355030876000378,1,158,81,179,179,138,496
355030876000379,1,101,43,89,89,53,231
355030876000380,1,22,11,19,19,16,54
355030876000381,1,62,33,77,77,42,196
355030876000382,1,160,55,114,114,39,267
355030876000383,1,59,36,55,55,31,141
355030877000001,1,56,30,138,138,141,417
355030877000002,1,57,40,121,121,154,396
355030877000003,1,70,42,191,191,156,538
355030877000004,1,48,28,124,124,108,356
355030877000005,1,49,44,139,139,142,420
355030877000006,1,46,36,201,201,114,516
355030877000007,1,44,39,117,117,129,363
355030877000008,1,73,50,135,135,160,430
355030877000009,1,48,39,125,125,101,351
355030877000010,1,81,52,157,157,174,488
355030877000011,1,90,55,148,148,176,472
355030877000012,1,86,51,137,137,157,431
355030877000013,1,8,3,21,21,22,64
355030877000014,1,55,21,114,114,101,329
355030877000015,1,49,39,96,96,134,326
355030877000016,1,31,53,132,132,158,422
355030877000017,1,49,42,103,103,124,330
355030877000018,1,52,32,112,112,111,335
355030877000019,1,70,36,136,136,129,401
355030877000020,1,108,65,149,149,182,480
355030877000021,1,67,23,120,120,93,333
355030877000022,1,125,73,281,281,156,718
355030877000023,1,52,37,170,170,90,430
355030877000024,1,163,90,341,341,255,937
355030877000025,1,73,43,176,176,146,498
355030877000026,1,116,69,237,237,236,710
355030877000027,1,43,35,94,94,134,322
355030877000028,1,10,8,45,45,53,143
355030877000029,1,26,35,105,105,92,302
355030877000030,1,34,31,103,103,120,326
355030877000031,1,33,48,124,124,116,364
355030877000032,1,117,49,232,232,190,654
355030877000033,1,4,4,23,23,11,57
355030877000034,1,158,74,240,240,191,671
355030877000035,1,68,38,78,78,30,186
355030877000036,1,70,46,148,148,153,449
355030877000037,1,71,41,145,145,165,455
355030877000038,1,60,43,147,147,163,457
355030877000039,1,55,31,101,101,123,325
355030877000040,1,31,21,137,137,89,363
355030877000041,1,22,29,83,83,108,274
355030877000042,1,18,13,49,49,42,140
355030877000043,1,20,14,95,95,52,242
355030877000044,1,57,34,172,172,118,462
355030877000045,1,84,49,193,193,130,516
355030877000046,1,48,21,145,145,56,346
355030877000047,1,154,73,327,327,207,861
355030877000048,1,53,44,92,92,113,297
355030877000049,1,121,53,230,230,149,609
355030877000050,1,173,64,370,370,236,976
355030877000051,1,94,36,308,308,118,734
355030877000052,1,150,75,358,358,186,902
355030877000053,1,97,47,255,255,172,682
355030877000054,1,119,55,294,294,167,755
355030877000055,1,116,77,284,284,163,731
355030877000056,1,73,58,140,140,138,418
355030877000057,1,67,28,120,120,116,356
355030877000058,1,96,63,153,153,209,515
355030877000059,1,72,41,106,106,173,385
355030877000060,1,57,33,104,104,109,317
355030877000061,1,141,60,207,207,189,603
355030877000062,1,128,62,99,99,53,251
355030877000063,1,81,61,126,126,107,359
355030877000064,1,65,37,129,129,109,367
355030877000065,1,64,43,126,126,154,406
355030877000066,1,66,29,116,116,126,358
355030877000067,1,48,32,85,85,80,250
355030877000068,1,69,49,154,154,177,485
355030877000069,1,62,34,122,122,155,399
355030877000070,1,41,35,146,146,126,418
355030877000071,1,56,26,141,141,137,419
355030877000072,1,32,24,81,81,86,248
355030877000073,1,66,39,148,148,146,442
355030877000074,1,32,21,115,115,56,286
355030877000075,1,84,51,163,163,154,480
355030877000076,1,98,40,144,144,132,420
355030877000077,1,65,32,120,120,101,341
355030877000078,1,22,14,34,34,32,100
355030877000079,1,103,57,271,271,160,702
355030877000080,1,56,28,131,131,88,350
355030877000081,1,74,45,128,128,167,423
355030877000082,1,117,46,202,202,161,565
355030877000083,1,82,36,129,129,145,403
355030877000084,1,95,52,197,197,151,545
355030877000085,1,79,50,119,119,187,425
355030877000086,1,32,31,84,84,92,260
355030877000087,1,71,42,139,139,126,404
355030877000088,1,65,42,133,133,122,388
355030877000089,1,31,28,103,103,90,296
355030877000090,1,48,50,170,170,167,507
355030877000091,1,108,55,201,201,191,593
355030877000092,1,0,0,0,0,0,0
355030877000093,1,49,37,134,134,140,408
355030877000094,1,47,35,106,106,126,338
355030877000095,1,73,48,155,155,150,460
355030877000096,1,57,48,100,100,126,326
355030877000097,1,63,36,116,116,143,375
355030877000098,1,80,60,178,178,207,563
355030877000099,1,58,42,123,123,182,428
355030877000100,1,48,35,90,90,103,283
355030877000101,1,65,22,141,141,116,398
355030877000102,1,60,35,127,127,111,365
355030877000103,1,45,32,100,100,122,322
355030877000104,1,54,34,113,113,139,365
355030877000105,1,26,18,95,95,94,284
355030877000106,1,69,42,140,140,131,411
355030877000107,1,92,31,169,169,139,477
355030877000108,1,92,39,265,265,115,645
355030877000109,1,128,57,173,173,121,467
355030877000110,1,92,46,173,173,210,556
355030877000111,1,124,65,188,188,158,534
355030877000112,1,43,34,93,93,84,270
355030877000113,1,77,40,136,136,125,397
355030877000114,1,93,61,177,177,141,495
355030877000115,1,83,41,173,173,103,449
355030877000116,1,34,22,57,57,68,182
355030877000117,1,80,41,141,141,131,413
355030877000118,1,86,53,184,184,167,535
355030877000119,1,80,39,218,218,114,550
355030877000120,1,67,27,106,106,64,276
355030877000121,1,45,37,134,134,99,367
355030877000122,1,70,32,176,176,163,515
355030877000123,1,75,43,181,181,148,510
355030877000124,1,44,25,142,142,130,414
355030877000125,1,82,48,166,166,178,510
355030877000126,1,38,28,77,77,85,239
355030877000127,1,93,20,139,139,96,374
355030877000128,1,57,59,91,91,156,338
355030877000129,1,40,29,82,82,81,245
355030877000130,1,34,29,116,116,102,334
355030877000131,1,42,25,73,73,105,251
355030877000132,1,23,17,70,70,73,213
355030877000133,1,29,28,94,94,110,298
355030877000134,1,41,31,146,146,127,419
355030877000135,1,76,48,242,242,150,634
355030877000136,1,149,82,284,284,241,809
355030877000137,1,42,42,76,76,110,262
355030877000138,1,29,22,103,103,113,319
355030877000139,1,31,19,77,77,95,249
355030877000140,1,150,73,293,293,165,751
355030877000141,1,116,75,158,158,140,456
355030877000142,1,60,40,141,141,162,444
355030877000143,1,40,24,101,101,93,295
355030877000144,1,61,42,135,135,149,419
355030877000145,1,140,72,336,336,181,853
355030877000146,1,69,73,160,160,227,547
355030877000147,1,33,26,155,155,92,402
355030877000148,1,100,74,169,169,217,555
355030877000149,1,73,44,132,132,143,407
355030877000150,1,0,0,0,0,0,0
355030877000151,1,61,35,157,157,148,462
355030877000152,1,61,32,96,96,108,300
355030877000153,1,54,28,114,114,81,309
355030877000154,1,66,48,153,153,156,462
355030877000155,1,75,36,130,130,112,372
355030877000156,1,34,45,95,95,110,300
355030877000157,1,21,21,87,87,58,232
355030877000158,1,46,25,156,156,134,446
355030877000159,1,31,23,64,64,72,200
355030877000160,1,140,62,271,271,190,732
355030877000161,1,65,36,123,123,102,348
355030877000162,1,55,30,126,126,104,356
355030877000163,1,24,18,120,120,73,313
355030877000164,1,10,10,59,59,49,167
355030877000165,1,87,33,162,162,116,440
355030877000166,1,34,45,113,113,91,317
355030877000167,1,85,51,157,157,126,440
355030877000168,1,58,51,174,174,151,499
355030877000169,1,98,55,252,252,172,676
355030877000170,1,115,66,178,178,137,493
355030877000171,1,98,49,133,133,86,352
355030877000172,1,103,36,182,182,134,498
355030877000173,1,43,33,104,104,78,286
355030877000174,1,66,89,151,151,199,501
355030877000175,1,53,21,102,102,78,282
355030877000176,1,19,20,73,73,83,229
355030877000177,1,36,22,115,115,87,317
355030877000178,1,33,36,126,126,88,340
355030877000179,1,20,36,112,112,105,329
355030877000180,1,33,55,197,197,118,512
355030877000181,1,38,9,109,109,77,295
355030877000182,1,57,36,135,135,111,381
355030877000183,1,29,7,108,108,59,275
355030877000184,1,10,9,17,17,28,62
355030877000185,1,122,68,207,207,202,616
355030877000186,1,34,42,128,128,138,394
355030877000187,1,85,39,190,190,120,500
355030877000188,1,44,47,126,126,107,359
355030877000189,1,57,48,176,176,99,451
355030877000190,1,54,42,163,163,107,433
355030877000191,1,84,52,194,194,165,553
355030877000192,1,76,18,196,196,96,488
355030877000193,1,117,57,185,185,165,535
355030877000194,1,67,33,110,110,137,357
355030877000195,1,38,22,83,83,132,298
355030877000196,1,58,25,98,98,145,341
355030877000197,1,83,38,113,113,146,372
355030877000198,1,51,35,66,66,92,224
355030877000199,1,73,50,179,179,110,468
355030877000200,1,71,34,159,159,108,426
355030877000201,1,41,19,209,209,124,542
355030877000202,1,67,44,151,151,158,460
355030877000203,1,38,35,81,81,109,271
355030877000204,1,20,11,50,50,36,136
355030877000205,1,16,5,47,47,41,135
355030877000206,1,84,35,256,256,153,665
355030877000207,1,42,38,101,101,126,328
355030877000208,1,16,5,49,49,17,115
355030877000209,1,20,11,36,36,47,119
355030877000210,1,51,39,58,58,41,157
355030877000211,1,113,65,101,101,35,237
355030877000212,1,58,27,188,188,101,477
355030877000213,1,27,22,73,73,76,222
355030877000214,1,88,31,154,154,110,418
355030877000215,1,88,31,169,169,153,491
355030877000216,1,46,31,118,118,118,354
355030877000217,1,58,34,130,130,106,366
355030877000218,1,36,15,46,46,40,132
355030877000219,1,65,35,147,147,124,418
355030877000220,1,69,57,116,116,149,381
355030877000221,1,7,4,28,28,29,85
355030877000222,1,29,15,80,80,68,228
355030877000223,1,31,21,108,108,81,297
355030877000224,1,49,38,117,117,97,331
355030878000001,1,38,47,87,87,57,231
355030878000002,1,105,59,149,149,125,423
355030878000003,1,77,46,161,161,73,395
355030878000004,1,75,48,164,164,100,428
355030878000005,1,305,159,484,484,178,1146
355030878000006,1,0,0,0,0,0,0
355030878000007,1,131,59,167,167,114,448
355030878000008,1,45,46,70,70,31,171
355030878000009,1,19,29,46,46,13,105
355030878000012,1,0,0,0,0,0,0
355030878000013,1,44,43,99,99,24,222
355030878000014,1,73,42,118,118,99,335
355030878000015,1,66,47,173,173,86,432
355030878000016,1,64,49,141,141,105,387
355030878000017,1,123,59,182,182,143,507
355030878000018,1,52,29,108,108,52,268
355030878000019,1,75,67,141,141,75,357
355030878000020,1,100,53,153,153,83,389
355030878000021,1,92,67,189,189,89,467
355030878000022,1,89,60,143,143,109,395
355030878000023,1,92,64,134,134,64,332
355030878000024,1,96,53,145,145,82,372
355030878000025,1,75,57,108,108,99,315
355030878000026,1,161,103,210,210,95,515
355030878000027,1,174,64,306,306,142,754
355030878000028,1,171,58,170,170,48,388
355030878000029,1,153,72,223,223,138,584
355030878000030,1,128,52,113,113,66,292
355030878000031,1,117,66,199,199,128,526
355030878000032,1,41,46,136,136,91,363
355030878000033,1,36,30,73,73,49,195
355030878000034,1,206,45,440,440,96,976
355030878000035,1,190,75,383,383,43,809
355030878000036,1,79,70,184,184,88,456
355030878000037,1,4,15,50,50,8,108
355030878000038,1,77,74,182,182,109,473
355030878000039,1,12,9,59,59,42,160
355030878000041,1,93,54,138,138,104,380
355030878000042,1,43,28,54,54,21,129
355030878000043,1,84,47,83,83,35,201
355030878000044,1,41,94,136,136,76,348
355030878000045,1,29,18,71,71,52,194
355030878000046,1,98,47,209,209,96,514
355030879000001,1,76,59,177,177,172,526
355030879000002,1,120,68,179,179,168,526
355030879000003,1,199,107,256,256,225,737
355030879000004,1,117,57,158,158,196,512
355030879000005,1,124,50,211,211,214,636
355030879000006,1,112,52,186,186,182,554
355030879000007,1,52,34,86,86,87,259
355030879000008,1,151,58,185,185,123,493
355030879000009,1,181,99,218,218,166,602
355030879000010,1,58,29,92,92,74,258
355030879000011,1,76,43,128,128,103,359
355030879000012,1,98,60,151,151,166,468
355030879000013,1,83,49,105,105,149,359
355030879000014,1,157,88,213,213,175,601
355030879000015,1,72,29,116,116,107,339
355030879000016,1,63,39,74,74,92,240
355030879000017,1,70,34,117,117,95,329
355030879000018,1,67,43,125,125,140,390
355030879000019,1,94,41,140,140,133,413
355030879000020,1,133,48,171,171,142,484
355030879000021,1,161,67,293,293,171,757
355030879000022,1,40,31,81,81,74,236
355030879000023,1,77,43,144,144,129,417
355030879000024,1,84,59,133,133,135,401
355030879000025,1,80,56,152,152,142,446
355030879000026,1,178,88,220,220,180,620
355030879000027,1,99,55,187,187,161,535
355030879000028,1,108,67,138,138,129,405
355030879000029,1,84,42,105,105,108,318
355030879000030,1,68,36,73,73,46,192
355030879000031,1,6,7,7,7,5,19
355030879000032,1,76,51,92,92,54,238
355030879000033,1,80,42,116,116,144,376
355030879000034,1,96,86,172,172,227,571
355030879000035,1,68,61,119,119,152,390
355030879000036,1,126,111,196,196,230,622
355030879000037,1,91,48,197,197,177,571
355030879000038,1,124,76,208,208,139,555
355030879000039,1,112,60,196,196,217,609
355030879000040,1,96,45,198,198,198,594
355030879000041,1,89,59,153,153,157,463
355030879000042,1,96,42,156,156,152,464
355030879000043,1,97,41,147,147,135,429
355030879000044,1,126,67,246,246,198,690
355030879000045,1,154,90,289,289,279,857
355030879000046,1,130,91,203,203,190,596
355030879000047,1,87,40,124,124,143,391
355030879000048,1,71,28,97,97,75,269
355030879000049,1,74,24,176,176,58,410
355030879000050,1,66,42,126,126,87,339
355030879000051,1,79,46,118,118,92,328
355030879000052,1,70,40,80,80,26,186
355030879000053,1,61,25,164,164,65,393
355030879000054,1,48,17,183,183,42,408
355030879000055,1,90,54,104,104,135,343
355030879000056,1,32,15,36,36,14,86
355030880000001,1,67,81,109,109,173,391
355030880000002,1,3,6,9,9,15,33
355030880000003,1,39,24,103,103,87,293
355030880000004,1,83,61,111,111,144,366
355030880000005,1,39,20,90,90,78,258
355030880000006,1,94,57,169,169,150,488
355030880000007,1,86,39,172,172,127,471
355030880000008,1,72,40,144,144,110,398
355030880000009,1,107,61,237,237,200,674
355030880000010,1,46,29,79,79,104,262
355030880000011,1,67,40,103,103,116,322
355030880000012,1,36,22,91,91,117,299
355030880000013,1,51,37,99,99,105,303
355030880000014,1,39,36,96,96,105,297
355030880000015,1,40,49,92,92,176,360
355030880000016,1,44,33,55,55,68,178
355030880000017,1,96,60,163,163,129,455
355030880000018,1,142,63,232,232,200,664
355030880000019,1,97,67,175,175,167,517
355030880000020,1,28,30,87,87,78,252
355030880000021,1,34,26,66,66,70,202
355030880000022,1,44,35,95,95,90,280
355030880000023,1,33,19,67,67,60,194
355030880000024,1,14,15,44,44,69,157
355030880000025,1,47,28,90,90,90,270
355030880000026,1,60,39,127,127,131,385
355030880000027,1,75,47,117,117,138,372
355030880000028,1,35,23,67,67,85,219
355030880000029,1,72,48,141,141,133,415
355030880000030,1,95,64,151,151,181,483
355030880000031,1,47,28,109,109,81,299
355030880000032,1,89,59,178,178,161,517
355030880000033,1,42,26,78,78,81,237
355030880000034,1,24,25,67,67,82,216
355030880000035,1,121,48,224,224,173,621
355030880000036,1,34,37,69,69,112,250
355030880000037,1,65,60,121,121,163,405
355030880000038,1,42,33,75,75,87,237
355030880000039,1,39,30,47,47,88,182
355030880000040,1,156,73,234,234,263,731
355030880000041,1,76,65,112,112,142,366
355030880000042,1,95,39,128,128,135,391
355030880000043,1,33,22,48,48,67,163
355030880000044,1,56,37,124,124,86,334
355030880000045,1,49,26,126,126,94,346
355030880000046,1,145,90,249,249,234,732
355030880000047,1,174,94,370,370,275,1015
355030880000048,1,51,37,114,114,84,312
355030880000049,1,109,81,166,166,202,534
355030880000050,1,64,37,88,88,81,257
355030880000051,1,77,41,119,119,122,360
355030880000052,1,81,42,159,159,145,463
355030880000053,1,70,36,122,122,133,377
355030880000054,1,62,35,117,117,136,370
355030880000055,1,44,37,115,115,124,354
355030880000056,1,63,46,117,117,141,375
355030880000057,1,61,40,112,112,127,351
355030880000058,1,56,30,90,90,71,251
355030880000059,1,110,73,153,153,222,528
355030880000060,1,72,35,127,127,125,379
355030880000061,1,11,11,17,17,23,57
355030880000062,1,106,48,188,188,161,537
355030880000063,1,82,41,149,149,110,408
355030880000064,1,54,35,119,119,127,365
355030880000065,1,28,32,82,82,87,251
355030880000066,1,54,33,100,100,109,309
355030880000067,1,79,43,128,128,169,425
355030880000068,1,13,16,34,34,58,126
355030880000069,1,25,27,62,62,100,224
355030880000070,1,9,12,24,24,27,75
355030880000071,1,60,98,148,148,179,475
355030880000072,1,38,28,67,67,86,220
355030880000073,1,75,39,111,111,93,315
355030880000074,1,73,45,164,164,154,482
355030880000075,1,160,56,332,332,152,816
355030880000076,1,68,48,98,98,105,301
355030880000077,1,35,19,46,46,61,153
355030880000078,1,153,68,227,227,161,615
355030880000079,1,118,45,191,191,90,472
355030880000080,1,35,24,57,57,67,181
355030880000081,1,52,34,69,69,125,263
355030880000082,1,88,44,139,139,92,370
355030880000083,1,75,34,103,103,103,309
355030880000084,1,28,13,43,43,57,143
355030880000085,1,40,34,69,69,87,225
355030880000086,1,44,39,93,93,114,300
355030880000087,1,98,69,125,125,193,443
355030880000088,1,41,34,96,96,104,296
355030880000089,1,45,48,62,62,132,256
355030880000090,1,44,30,79,79,134,292
355030880000091,1,87,43,178,178,163,519
355030880000092,1,59,62,126,126,161,413
355030880000093,1,56,55,125,125,160,410
355030880000094,1,41,31,109,109,112,330
355030880000095,1,41,28,77,77,92,246
355030880000096,1,59,25,74,74,82,230
355030880000097,1,76,42,156,156,111,423
355030880000098,1,35,28,71,71,80,222
355030880000099,1,44,20,76,76,53,205
355030880000100,1,60,51,95,95,86,276
355030880000101,1,86,62,143,143,105,391
355030880000102,1,37,21,87,87,76,250
355030880000103,1,74,51,164,164,167,495
355030880000104,1,58,30,143,143,116,402
355030880000105,1,150,73,215,215,230,660
355030880000106,1,23,20,52,52,57,161
355030880000107,1,29,7,40,40,38,118
355030880000108,1,28,22,52,52,54,158
355030880000109,1,151,67,262,262,148,672
355030880000110,1,223,113,211,211,161,583
355030880000111,1,52,35,148,148,94,390
355030880000112,1,212,89,243,243,227,713
355030880000113,1,68,50,120,120,146,386
355030880000114,1,45,35,102,102,105,309
355030880000115,1,24,11,43,43,56,142
355030880000116,1,135,73,206,206,184,596
355030880000117,1,31,30,56,56,83,195
355030880000118,1,71,55,104,104,152,360
355030880000119,1,73,48,121,121,138,380
355030880000120,1,74,45,110,110,93,313
355030880000121,1,86,50,137,137,124,398
355030880000122,1,54,23,110,110,87,307
355030880000123,1,129,42,217,217,190,624
355030880000124,1,32,25,48,48,46,142
355030880000125,1,83,60,178,178,196,552
355030880000126,1,75,58,132,132,171,435
355030880000127,1,45,44,92,92,141,325
355030880000128,1,75,62,130,130,121,381
355030880000129,1,67,28,102,102,77,281
355030880000130,1,47,27,62,62,61,185
355030880000131,1,20,19,42,42,55,139
355030880000132,1,27,27,49,49,65,163
355030880000133,1,93,51,163,163,124,450
355030880000134,1,87,34,135,135,62,332
355030880000135,1,55,25,82,82,83,247
355030880000136,1,65,56,84,84,159,327
355030880000137,1,9,8,40,40,37,117
355030880000138,1,41,24,67,67,78,212
355030880000139,1,14,6,68,68,29,165
355030880000140,1,86,31,139,139,79,357
355030880000141,1,28,17,162,162,68,392
355030880000142,1,17,10,64,64,19,147
355030880000143,1,61,45,104,104,136,344
355030880000145,1,86,55,185,185,141,511
355030880000146,1,165,92,219,219,176,614
355030880000147,1,103,61,190,190,153,533
355030880000148,1,64,24,104,104,60,268
355030880000149,1,84,17,158,158,70,386
355030880000150,1,82,7,147,147,64,358
355030880000151,1,57,23,129,129,78,336
355030880000152,1,38,14,85,85,60,230
355030880000153,1,272,109,233,233,98,564
355030880000154,1,46,15,140,140,56,336
355030880000155,1,38,24,142,142,38,322
355030880000156,1,118,47,209,209,89,507
355030880000157,1,117,40,198,198,76,472
355030880000158,1,126,51,210,210,114,534
355030880000159,1,49,14,75,75,44,194
355030880000160,1,125,46,211,211,101,523
355030880000161,1,67,30,147,147,75,369
355030880000163,1,7,2,77,77,22,176
355030880000164,1,120,42,224,224,127,575
355030880000165,1,47,45,184,184,86,454
355030880000166,1,78,32,188,188,109,485
355030880000167,1,36,12,112,112,41,265
355030880000168,1,100,31,178,178,87,443
355030880000169,1,22,9,92,92,30,214
355030880000170,1,50,24,68,68,57,193
355030880000171,1,27,17,112,112,21,245
355030880000172,1,75,33,90,90,122,302
355030880000173,1,120,52,208,208,131,547
355030880000174,1,80,35,111,111,82,304
355030880000175,1,63,33,190,190,77,457
355030880000176,1,3,6,50,50,29,129
355030880000177,1,117,56,188,188,117,493
355030880000178,1,27,23,70,70,72,212
355030881000001,1,45,29,70,70,68,208
355030881000002,1,135,65,193,193,166,552
355030881000003,1,87,42,114,114,144,372
355030881000004,1,100,54,139,139,125,403
355030881000005,1,138,67,154,154,127,435
355030881000006,1,213,101,211,211,209,631
355030881000007,1,121,53,190,190,177,557
355030881000008,1,43,23,77,77,97,251
355030881000009,1,107,71,157,157,142,456
355030881000010,1,79,59,155,155,185,495
355030881000011,1,122,48,133,133,119,385
355030881000012,1,196,106,262,262,190,714
355030881000013,1,198,115,257,257,196,710
355030881000014,1,145,77,179,179,136,494
355030881000015,1,121,65,188,188,160,536
355030881000016,1,137,76,190,190,190,570
355030881000017,1,63,42,87,87,107,281
355030881000018,1,78,44,130,130,124,384
355030881000019,1,170,84,195,195,153,543
355030881000020,1,107,51,149,149,156,454
355030881000021,1,173,91,204,204,190,598
355030881000022,1,137,89,166,166,199,531
355030881000023,1,49,27,75,75,51,201
355030881000024,1,69,32,63,63,64,190
355030881000025,1,108,64,186,186,184,556
355030881000026,1,112,48,171,171,140,482
355030881000027,1,98,53,135,135,177,447
355030881000028,1,125,56,194,194,178,566
355030881000029,1,104,47,136,136,127,399
355030881000030,1,268,115,245,245,163,653
355030881000031,1,78,28,72,72,55,199
355030881000032,1,135,52,111,111,62,284
355030881000033,1,110,67,161,161,153,475
355030881000034,1,157,75,198,198,208,604
355030881000035,1,75,49,111,111,148,370
355030881000036,1,53,37,73,73,65,211
355030881000037,1,65,55,121,121,111,353
355030881000038,1,42,29,77,77,86,240
355030881000039,1,123,77,125,125,96,346
355030881000040,1,120,71,207,207,154,568
355030881000041,1,61,36,89,89,66,244
355030881000042,1,102,50,129,129,124,382
355030881000043,1,106,58,142,142,142,426
355030881000044,1,83,34,131,131,79,341
355030881000045,1,104,83,169,169,168,506
355030881000046,1,113,49,154,154,106,414
355030881000047,1,72,51,155,155,138,448
355030881000048,1,77,42,132,132,133,397
355030881000049,1,69,40,106,106,100,312
355030881000050,1,176,98,297,297,202,796
355030881000051,1,71,27,91,91,59,241
355030881000052,1,184,97,167,167,97,431
355030881000053,1,238,114,324,324,232,880
355030881000054,1,106,121,168,168,170,506
355030881000055,1,66,46,101,101,88,290
355030881000056,1,93,27,87,87,88,262
355030881000057,1,151,68,169,169,121,459
355030881000058,1,20,15,28,28,16,72
355030881000059,1,68,46,104,104,111,319
355030881000060,1,95,48,124,124,104,352
355030881000061,1,93,52,144,144,122,410
355030881000062,1,49,41,105,105,140,350
355030881000063,1,49,25,108,108,123,339
355030881000064,1,96,61,130,130,135,395
355030881000065,1,89,45,124,124,113,361
355030881000066,1,84,53,130,130,109,369
355030881000067,1,112,55,160,160,127,447
355030881000068,1,38,26,56,56,29,141
355030881000069,1,88,40,134,134,92,360
355030881000070,1,86,42,73,73,40,186
355030881000071,1,74,39,87,87,80,254
355030881000072,1,97,52,111,111,69,291
355030881000073,1,379,165,328,328,191,847
355030881000074,1,196,135,265,265,207,737
355030881000075,1,154,64,226,226,166,618
355030881000076,1,93,51,123,123,88,334
355030881000077,1,96,26,163,163,176,502
355030881000078,1,172,72,203,203,117,523
355030881000079,1,176,97,182,182,138,502
355030881000080,1,145,59,173,173,127,473
355030881000081,1,99,38,117,117,90,324
355030881000082,1,202,91,224,224,145,593
355030881000083,1,42,18,49,49,39,137
355030881000084,1,148,62,126,126,111,363
355030881000085,1,202,78,168,168,110,446
355030881000086,1,75,29,88,88,97,273
355030881000087,1,410,239,426,426,296,1148
355030881000088,1,322,125,237,237,175,649
355030881000089,1,116,77,188,188,63,439
355030881000090,1,99,55,139,139,168,446
355030881000091,1,101,66,175,175,182,532
355030881000092,1,60,35,88,88,102,278
355030881000093,1,81,45,110,110,139,359
355030881000094,1,99,57,125,125,148,398
355030881000095,1,86,54,176,176,166,518
355030881000096,1,82,59,142,142,190,474
355030881000097,1,114,94,236,236,253,725
355030881000098,1,95,59,146,146,146,438
355030881000099,1,8,4,10,10,13,33
355030881000100,1,44,42,82,82,78,242
355030881000101,1,93,48,106,106,85,297
355030881000102,1,152,46,183,183,119,485
355030881000103,1,98,34,97,97,51,245
355030881000104,1,91,37,78,78,52,208
355030881000105,1,187,87,202,202,147,551
355030881000106,1,184,54,189,189,100,478
355030881000107,1,229,124,261,261,225,747
355030881000108,1,59,37,78,78,56,212
355030881000109,1,98,60,133,133,84,350
355030881000110,1,140,67,153,153,101,407
355030881000111,1,85,56,120,120,100,340
355030881000112,1,186,88,167,167,107,441
355030881000113,1,24,16,21,21,31,73
355030881000114,1,70,49,121,121,129,371
355030881000115,1,108,42,116,116,89,321
355030881000116,1,277,112,302,302,139,743
355030881000117,1,108,52,140,140,84,364
355030881000118,1,97,27,106,106,71,283
355030881000119,1,219,124,270,270,136,676
355030881000120,1,188,96,263,263,147,673
355030881000121,1,44,33,78,78,94,250
355030881000122,1,90,38,120,120,120,360
355030881000123,1,41,17,52,52,60,164
355030881000124,1,86,45,101,101,140,342
355030881000125,1,130,55,204,204,160,568
355030881000126,1,99,67,174,174,129,477
355030881000127,1,59,31,108,108,81,297
355030881000128,1,60,24,82,82,83,247
355030881000129,1,45,19,56,56,35,147
355030881000130,1,65,35,98,98,81,277
355030881000131,1,105,35,192,192,72,456
355030881000132,1,113,87,122,122,109,353
355030881000133,1,107,47,146,146,142,434
355030881000134,1,39,27,72,72,71,215
355030881000135,1,104,62,124,124,125,373
355030881000136,1,163,95,185,185,64,434
355030881000137,1,104,51,125,125,173,423
355030881000138,1,114,44,149,149,75,373
355030881000139,1,134,69,166,166,119,451
355030881000140,1,68,55,111,111,116,338
355030881000141,1,150,82,215,215,117,547
355030881000142,1,141,65,186,186,109,481
355030881000143,1,144,65,155,155,98,408
355030881000144,1,74,48,112,112,80,304
355030881000145,1,104,47,85,85,100,270
355030881000146,1,193,89,236,236,173,645
355030881000147,1,307,172,264,264,186,714
355030881000148,1,115,39,93,93,50,236
355030881000150,8,14,6,12,12,7,31
355030881000151,8,11,5,13,13,5,31
355030881000152,8,7,8,9,9,13,31
355030881000153,1,264,100,257,257,90,604
355030881000154,1,99,51,104,104,71,279
355030881000155,1,142,75,146,146,120,412
355030881000156,1,223,155,267,267,143,677
355030881000157,1,315,143,383,383,199,965
355030881000158,1,302,139,311,311,183,805
355030881000159,1,191,81,258,258,181,697
355030881000160,1,182,92,148,148,99,395
355030881000161,1,71,26,104,104,45,253
355030881000162,1,214,101,295,295,122,712
355030881000163,1,189,85,157,157,64,378
355030881000164,1,141,61,148,148,73,369
355030881000165,1,225,88,190,190,66,446
355030881000166,1,91,36,73,73,27,173
355030881000167,1,333,321,522,522,222,1266
355030881000168,4,105,56,135,135,88,358
355030881000169,1,253,100,273,273,160,706
355030881000171,2,341,114,341,341,180,862
355030881000172,1,475,164,574,574,219,1367
355030881000173,1,154,63,173,173,94,440
355030881000174,1,194,107,225,225,157,607
355030881000175,1,230,112,217,217,141,575
355030881000176,1,203,108,164,164,133,461
355030881000177,1,185,110,201,201,174,576
355030881000178,1,270,106,255,255,98,608
355030881000179,1,68,50,71,71,58,200
355030881000180,1,616,249,505,505,216,1226
355030881000181,1,322,152,332,332,163,827
355030881000182,1,258,112,235,235,71,541
355030881000183,1,223,101,190,190,98,478
355030881000184,1,119,58,116,116,78,310
355030881000185,1,130,53,106,106,64,276
355030881000186,1,39,17,34,34,20,88
355030881000187,8,14,11,30,30,38,98
355030881000189,2,88,43,100,100,90,290
355030881000190,2,37,17,35,35,13,83
355030881000191,2,110,58,107,107,59,273
355030881000192,1,272,91,216,216,100,532
355030881000193,1,420,162,424,424,154,1002
355030881000194,1,370,188,439,439,169,1047
355030881000195,1,103,63,128,128,55,311
355030881000196,1,480,272,499,499,284,1282
355030881000197,1,358,153,336,336,172,844
355030881000198,1,190,121,177,177,117,471
355030881000199,1,318,145,319,319,134,772
355030881000200,1,220,78,251,251,136,638
355030881000201,1,204,76,187,187,83,457
355030881000202,1,250,125,309,309,100,718
355030881000203,1,415,189,357,357,169,883
355030881000204,1,106,56,135,135,74,344
355030881000205,1,108,59,96,96,49,241
355030881000206,1,102,39,82,82,30,194
355030881000207,1,179,85,192,192,99,483
355030881000208,1,297,117,266,266,115,647
355030881000210,8,0,0,0,0,0,0
355030881000211,1,92,54,127,127,89,343
355030881000212,1,95,41,117,117,81,315
355030881000213,1,43,40,65,65,88,218
355030881000214,1,22,13,26,26,25,77
355030881000215,4,67,30,75,75,80,230
355030881000216,1,28,13,32,32,13,77
355030881000217,2,302,126,372,372,217,961
355030881000218,2,126,75,138,138,98,374
355030881000219,1,282,133,251,251,124,626
355030881000220,1,300,195,357,357,238,952
355030881000221,1,292,161,262,262,163,687
355030881000222,1,319,180,314,314,213,841
355030881000223,1,41,25,44,44,33,121
355030881000224,1,115,56,134,134,76,344
355030881000225,1,300,119,248,248,131,627
355030881000226,1,343,117,340,340,115,795
355030881000227,1,232,82,222,222,121,565
355030881000228,1,201,102,206,206,112,524
355030881000229,8,0,0,0,0,0,0
355030881000230,1,261,107,322,322,165,809
355030881000231,1,236,84,218,218,129,565
355030881000232,1,247,82,197,197,87,481
355030881000234,1,194,85,145,145,98,388
355030881000235,8,11,8,11,11,5,27
355030881000236,1,236,99,208,208,119,535
355030881000237,1,147,69,130,130,66,326
355030881000238,1,137,71,129,129,53,311
355030881000239,1,29,11,26,26,24,76
355030881000240,1,143,49,124,124,30,278
355030881000241,1,88,42,87,87,29,203
355030881000242,1,126,58,147,147,203,497
355030881000243,1,73,58,87,87,171,345
355030881000244,1,54,28,81,81,91,253
355030881000245,1,38,16,42,42,56,140
355030881000246,1,184,82,205,205,109,519
355030881000247,1,13,3,43,43,79,165
355030881000248,1,60,29,96,96,79,271
355030881000249,1,68,41,92,92,60,244
355030881000250,1,89,71,151,151,211,513
355030881000251,1,46,17,56,56,27,139
355030881000252,1,87,49,86,86,86,258
355030881000253,1,11,14,21,21,34,76
355030881000256,4,69,29,79,79,39,197
355030881000257,8,2,3,4,4,5,13
355030881000258,8,6,1,5,5,1,11
355030881000263,8,0,0,0,0,0,0
355030881000265,8,0,0,0,0,0,0
355030881000266,8,17,8,20,20,17,57
355030881000268,8,19,8,21,21,14,56
355030881000270,1,49,17,51,51,44,146
355030881000271,1,33,12,40,40,25,105
355030881000272,1,433,160,471,471,226,1168
355030881000273,2,184,84,185,185,115,485
355030881000274,8,0,0,0,0,0,0
355030881000275,8,0,0,0,0,0,0
355030881000276,8,1,2,1,1,7,9
355030881000277,8,6,3,5,5,5,15
355030881000279,1,154,67,146,146,73,365
355030881000280,4,375,160,360,360,165,885
355030881000284,8,0,0,0,0,0,0
355030881000285,1,381,198,456,456,327,1239
355030881000286,2,32,11,31,31,21,83
355030881000287,2,239,144,250,250,171,671
355030881000288,1,311,123,400,400,196,996
355030881000289,8,0,0,0,0,0,0
355030881000290,2,131,76,121,121,105,347
355030881000292,1,349,173,375,375,204,954
355030881000293,1,142,69,219,219,149,587
355030881000294,1,278,202,327,327,239,893
355030881000295,1,566,201,547,547,184,1278
355030881000297,1,21,17,52,52,18,122
355030881000298,1,32,11,37,37,25,99
355030881000299,1,13,6,14,14,10,38
355030881000300,1,11,6,13,13,16,42
355030881000301,1,100,41,101,101,67,269
355030881000303,1,0,0,0,0,0,0
355030881000304,1,127,72,111,111,92,314
355030881000305,1,61,34,60,60,31,151
355030881000306,1,31,10,28,28,18,74
355030881000307,1,6,7,14,14,18,46
355030881000308,1,41,20,27,27,32,86
355030881000309,1,77,20,52,52,58,162
355030881000310,1,49,28,70,70,24,164
355030881000311,1,86,40,79,79,29,187
355030881000312,1,225,74,142,142,88,372
355030881000315,1,100,59,98,98,54,250
355030881000316,1,38,15,61,61,16,138
355030881000317,1,263,125,270,270,101,641
355030881000318,1,78,17,60,60,29,149
355030881000319,1,57,26,46,46,23,115
355030881000320,1,27,23,32,32,38,102
355030881000321,1,116,54,114,114,57,285
355030881000322,1,196,104,177,177,120,474
355030881000323,1,56,25,57,57,30,144
355030881000324,1,94,38,87,87,60,234
355030881000325,1,13,9,17,17,9,43
355030882000001,1,96,77,173,173,163,509
355030882000002,1,55,70,115,115,107,337
355030882000003,1,82,40,123,123,94,340
355030882000004,1,69,45,145,145,121,411
355030882000005,1,97,46,154,154,127,435
355030882000006,1,42,38,75,75,93,243
355030882000007,1,31,28,82,82,76,240
355030882000008,1,66,43,121,121,115,357
355030882000009,1,90,76,196,196,153,545
355030882000010,1,50,36,104,104,93,301
355030882000011,1,52,36,103,103,99,305
355030882000012,1,83,48,160,160,132,452
355030882000013,1,66,45,120,120,112,352
355030882000014,1,137,82,192,192,190,574
355030882000015,1,57,37,88,88,90,266
355030882000016,1,67,29,96,96,89,281
355030882000017,1,62,54,94,94,115,303
355030882000018,1,58,36,81,81,88,250
355030882000019,1,91,35,126,126,114,366
355030882000020,1,103,57,143,143,163,449
355030882000021,1,65,35,121,121,137,379
355030882000022,1,89,46,131,131,110,372
355030882000023,1,134,66,179,179,144,502
355030882000024,1,93,72,172,172,170,514
355030882000025,1,111,80,225,225,160,610
355030882000026,1,68,33,74,74,57,205
355030882000027,1,104,61,162,162,167,491
355030882000028,1,124,61,176,176,150,502
355030882000029,1,68,54,111,111,115,337
355030882000030,1,82,42,127,127,82,336
355030882000031,1,91,55,147,147,156,450
355030882000032,1,46,43,86,86,106,278
355030882000033,1,89,44,136,136,107,379
355030882000034,1,99,64,180,180,149,509
355030882000035,1,100,66,176,176,154,506
355030882000036,1,84,43,125,125,114,364
355030882000037,1,66,44,109,109,115,333
355030882000038,1,57,36,109,109,87,305
355030882000039,1,76,41,116,116,114,346
355030882000040,1,115,74,162,162,187,511
355030882000041,1,82,50,155,155,153,463
355030882000042,1,87,52,141,141,110,392
355030882000043,1,55,38,115,115,127,357
355030882000044,1,50,42,104,104,177,385
355030882000045,1,29,14,71,71,62,204
355030882000046,1,98,65,151,151,184,486
355030882000047,1,74,45,123,123,127,373
355030882000048,1,45,13,80,80,67,227
355030882000049,1,78,49,157,157,127,441
355030882000050,1,92,50,150,150,127,427
355030882000051,1,90,81,109,109,175,393
355030882000052,1,74,63,120,120,150,390
355030882000053,1,105,59,155,155,145,455
355030882000054,1,53,31,76,76,81,233
355030882000055,1,93,49,152,152,109,413
355030882000056,1,131,56,196,196,159,551
355030882000057,1,112,70,136,136,155,427
355030882000058,1,107,75,140,140,145,425
355030882000059,1,130,55,175,175,117,467
355030882000060,1,91,37,140,140,86,366
355030882000061,1,72,38,128,128,74,330
355030882000062,1,80,44,134,134,126,394
355030882000063,1,46,23,143,143,83,369
355030882000064,1,53,32,137,137,83,357
355030882000065,1,115,73,208,208,205,621
355030882000066,1,98,55,158,158,141,457
355030882000067,1,51,29,89,89,101,279
355030882000068,1,58,28,129,129,121,379
355030882000069,1,73,52,113,113,119,345
355030882000070,1,20,18,40,40,29,109
355030882000071,1,59,38,147,147,104,398
355030882000072,1,82,51,114,114,158,386
355030882000074,1,63,36,95,95,133,323
355030882000075,1,117,94,250,250,267,767
355030882000076,1,42,26,64,64,85,213
355030882000077,1,90,54,147,147,161,455
355030882000078,1,36,30,78,78,91,247
355030882000079,1,171,110,329,329,321,979
355030882000080,1,54,24,97,97,89,283
355030882000081,1,103,65,180,180,137,497
355030882000082,1,106,62,204,204,190,598
355030882000083,1,102,48,177,177,117,471
355030882000084,1,54,38,85,85,107,277
355030882000085,1,61,30,70,70,86,226
355030882000086,1,93,61,150,150,146,446
355030882000087,1,108,87,194,194,195,583
355030882000088,1,33,23,90,90,71,251
355030882000089,1,77,39,134,134,135,403
355030882000090,1,61,41,106,106,70,282
355030882000091,1,65,36,95,95,90,280
355030882000092,1,79,39,127,127,125,379
355030882000093,1,94,52,142,142,107,391
355030882000094,1,156,53,192,192,125,509
355030882000095,1,108,60,189,189,185,563
355030882000096,1,76,42,111,111,98,320
355030882000097,1,77,36,99,99,92,290
355030882000098,1,101,71,140,140,116,396
355030882000099,1,74,42,120,120,142,382
355030882000100,1,125,72,180,180,179,539
355030882000101,1,68,49,131,131,127,389
355030882000102,1,72,38,128,128,124,380
355030882000103,1,65,30,96,96,97,289
355030882000104,1,96,49,175,175,118,468
355030882000105,1,36,36,91,91,94,276
355030882000106,1,38,37,88,88,93,269
355030882000107,1,27,9,37,37,21,95
355030882000108,1,77,58,91,91,152,334
355030882000109,1,41,51,86,86,131,303
355030882000110,1,80,69,124,124,151,399
355030882000111,1,119,87,216,216,226,658
355030882000112,1,87,38,112,112,114,338
355030882000113,1,55,47,104,104,137,345
355030882000114,1,32,21,62,62,60,184
355030882000115,1,127,62,179,179,139,497
355030882000116,1,53,24,54,54,78,186
355030882000117,1,44,33,89,89,90,268
355030882000118,1,67,32,121,121,133,375
355030882000119,1,84,72,134,134,146,414
355030882000120,1,78,39,82,82,117,281
355030882000121,1,92,41,123,123,142,388
355030882000122,1,80,39,113,113,105,331
355030882000123,1,112,44,138,138,111,387
355030882000124,1,116,72,168,168,164,500
355030882000125,1,79,58,109,109,123,341
355030882000126,1,26,23,58,58,65,181
355030882000127,1,0,0,0,0,0,0
355030882000128,1,41,23,45,45,33,123
355030882000129,1,59,36,79,79,65,223
355030882000130,1,45,23,90,90,65,245
355030882000131,1,113,65,163,163,182,508
355030882000132,1,66,48,112,112,112,336
355030882000133,1,75,33,100,100,85,285
355030882000134,1,72,46,113,113,108,334
355030882000135,1,54,43,103,103,118,324
355030882000136,1,120,47,124,124,157,405
355030882000137,1,75,46,110,110,99,319
355030882000138,1,84,42,118,118,97,333
355030882000139,1,25,19,73,73,34,180
355030882000140,1,66,33,93,93,93,279
355030882000141,1,87,69,131,131,107,369
355030882000142,1,104,56,132,132,108,372
355030882000143,1,82,43,167,167,146,480
355030882000144,1,33,40,75,75,101,251
355030882000145,1,39,23,65,65,59,189
355030882000146,1,67,38,98,98,94,290
355030882000147,1,64,37,94,94,95,283
355030882000148,1,69,42,122,122,120,364
355030882000149,1,40,26,67,67,78,212
355030882000150,1,99,44,154,154,127,435
355030882000151,1,87,40,141,141,93,375
355030882000152,1,76,41,129,129,123,381
355030882000153,1,154,71,195,195,221,611
355030882000154,1,125,76,221,221,202,644
355030882000155,1,44,30,67,67,66,200
355030882000156,1,70,50,140,140,90,370
355030882000157,1,100,63,211,211,130,552
355030882000158,1,88,50,97,97,132,326
355030882000159,1,87,42,135,135,130,400
355030882000160,1,52,33,102,102,76,280
355030882000161,1,61,30,163,163,92,418
355030882000162,1,42,35,85,85,77,247
355030882000163,1,44,52,86,86,94,266
355030882000164,1,44,31,81,81,70,232
355030882000165,1,40,11,54,54,42,150
355030882000166,1,73,47,106,106,114,326
355030882000167,1,51,28,84,84,66,234
355030882000168,1,34,12,102,102,29,233
355030882000169,1,51,29,88,88,87,263
355030882000170,1,54,45,101,101,101,303
355030882000171,1,64,50,104,104,111,319
355030882000172,1,0,0,0,0,0,0
355030882000173,1,95,38,217,217,103,537
355030882000174,1,48,34,85,85,59,229
355030882000175,1,48,20,35,35,15,85
355030883000001,1,149,53,172,172,140,484
355030883000002,1,87,39,156,156,92,404
355030883000003,1,157,59,286,286,160,732
355030883000004,1,143,38,110,110,33,253
355030883000005,1,78,44,92,92,137,321
355030883000006,1,148,56,222,222,124,568
355030883000007,1,19,4,35,35,27,97
355030883000008,1,452,253,465,465,128,1058
355030883000009,1,117,41,57,57,21,135
355030883000010,1,38,19,94,94,59,247
355030883000011,1,595,269,550,550,198,1298
355030883000012,1,33,17,43,43,49,135
355030883000013,1,6,9,24,24,28,76
355030883000014,1,599,272,452,452,222,1126
355030883000015,1,172,94,176,176,112,464
355030883000016,1,187,81,303,303,193,799
355030883000017,1,52,22,119,119,75,313
355030883000018,1,61,31,132,132,56,320
355030883000019,1,80,29,152,152,67,371
355030883000020,1,36,24,84,84,46,214
355030883000021,1,32,18,82,82,44,208
355030883000022,1,52,20,94,94,56,244
355030883000023,1,456,115,675,675,349,1699
355030883000024,1,44,17,137,137,61,335
355030883000025,1,39,14,86,86,38,210
355030883000026,1,26,14,97,97,50,244
355030883000027,1,11,14,26,26,21,73
355030883000028,1,30,26,72,72,76,220
355030883000029,1,39,36,66,66,75,207
355030883000030,1,26,13,86,86,65,237
355030883000031,1,201,108,204,204,117,525
355030883000032,1,490,258,537,537,199,1273
355030883000033,1,471,206,394,394,148,936
355030883000034,1,410,219,405,405,122,932
355030883000035,1,473,233,442,442,189,1073
355030883000036,1,503,259,431,431,148,1010
355030883000037,1,456,259,483,483,113,1079
355030883000038,1,661,332,686,686,246,1618
355030883000039,1,554,221,532,532,172,1236
355030883000040,1,125,59,147,147,46,340
355030883000041,1,348,154,360,360,106,826
355030883000042,1,386,239,351,351,168,870
355030883000043,1,9,5,12,12,5,29
355030883000044,1,297,173,319,319,144,782
355030883000045,1,31,12,44,44,62,150
355030883000046,1,484,204,419,419,320,1158
355030883000047,1,47,40,58,58,44,160
355030883000048,1,266,139,330,330,183,843
355030883000049,1,140,105,247,247,224,718
355030883000050,1,65,29,94,94,65,253
355030883000051,1,388,260,348,348,345,1041
355030883000052,1,164,110,180,180,134,494
355030883000053,1,15,4,20,20,18,58
355030883000054,1,25,11,45,45,31,121
355030883000055,1,119,58,160,160,98,418
355030883000056,1,130,64,108,108,51,267
355030883000057,1,87,45,200,200,137,537
355030883000058,1,65,36,85,85,85,255
355030883000059,1,34,18,53,53,55,161
355030883000060,1,52,28,101,101,75,277
355030883000061,1,6,6,17,17,15,49
355030883000062,1,100,54,160,160,136,456
355030883000063,1,74,55,101,101,106,308
355030883000064,1,185,72,259,259,169,687
355030883000065,1,42,16,90,90,71,251
355030883000066,1,50,19,57,57,42,156
355030883000067,1,27,19,58,58,46,162
355030883000068,1,51,18,35,35,18,88
355030883000069,1,191,113,214,214,94,522
355030883000070,1,476,249,483,483,234,1200
355030883000071,1,433,156,432,432,189,1053
355030883000072,1,49,21,47,47,10,104
355030883000073,1,181,60,122,122,25,269
355030883000074,1,268,90,201,201,69,471
355030883000075,1,24,5,54,54,40,148
355030883000076,1,244,109,209,209,57,475
355030883000077,1,102,31,108,108,122,338
355030883000078,1,61,16,128,128,61,317
355030883000079,1,15,14,37,37,53,127
355030883000080,1,19,22,46,46,51,143
355030883000081,1,30,23,43,43,48,134
355030883000082,1,61,38,79,79,102,260
355030883000083,1,37,14,38,38,51,127
355030883000084,1,130,62,165,165,97,427
355030883000085,1,186,78,114,114,42,270
355030883000086,1,213,114,256,256,144,656
355030883000087,1,117,79,144,144,85,373
355030883000088,1,34,23,56,56,60,172
355030883000089,1,32,9,53,53,34,140
355030883000090,1,42,25,78,78,73,229
355030883000091,1,38,14,83,83,26,192
355030883000092,1,23,23,58,58,44,160
355030883000093,1,35,17,113,113,25,251
355030883000094,1,76,14,160,160,70,390
355030883000095,1,46,19,71,71,36,178
355030883000096,1,32,20,59,59,56,174
355030883000097,1,42,16,70,70,43,183
355030883000098,1,50,32,95,95,91,281
355030883000099,1,40,33,69,69,41,179
355030883000100,1,29,7,79,79,20,178
355030883000101,1,42,18,88,88,42,218
355030883000102,1,57,22,79,79,68,226
355030883000103,1,29,16,56,56,40,152
355030883000104,1,13,4,95,95,8,198
355030883000105,1,68,29,139,139,72,350
355030883000106,1,53,19,101,101,43,245
355030883000107,1,29,12,48,48,30,126
355030883000108,1,108,25,182,182,76,440
355030883000109,1,29,11,91,91,35,217
355030883000110,1,39,7,75,75,27,177
355030883000111,1,25,5,100,100,26,226
355030883000112,1,72,22,85,85,63,233
355030883000113,1,66,17,79,79,55,213
355030883000114,1,30,6,69,69,33,171
355030883000115,1,40,12,67,67,35,169
355030883000116,1,63,29,117,117,77,311
355030883000117,1,27,9,82,82,45,209
355030883000118,1,30,16,89,89,33,211
355030883000119,1,33,18,85,85,41,211
355030883000120,1,25,15,32,32,39,103
355030883000121,1,67,26,83,83,75,241
355030883000122,1,1,6,30,30,21,81
355030883000123,1,38,21,41,41,63,145
355030883000124,1,22,3,50,50,24,124
355030883000125,1,49,13,56,56,58,170
355030883000126,1,57,24,157,157,73,387
355030883000127,1,63,30,97,97,54,248
355030883000128,1,38,11,75,75,31,181
355030883000129,1,27,11,56,56,39,151
355030883000130,1,65,21,91,91,71,253
355030883000131,1,34,18,49,49,59,157
355030883000132,1,49,14,92,92,36,220
355030883000133,1,57,19,79,79,53,211
355030883000134,1,20,14,29,29,52,110
355030883000135,1,113,48,78,78,52,208
355030883000136,1,200,102,153,153,118,424
355030883000137,1,25,20,91,91,58,240
355030883000138,1,51,22,123,123,73,319
355030883000139,1,63,21,138,138,87,363
355030883000140,1,337,143,348,348,94,790
355030883000141,1,399,230,348,348,169,865
355030883000142,1,532,307,557,557,159,1273
355030883000143,1,412,207,418,418,140,976
355030883000144,1,219,107,214,214,89,517
355030883000145,1,391,165,343,343,109,795
355030883000146,1,60,28,63,63,17,143
355030883000147,1,665,272,666,666,189,1521
355030883000149,1,181,52,123,123,28,274
355030883000150,1,30,5,72,72,32,176
355030883000151,1,70,32,165,165,96,426
355030883000152,1,67,13,137,137,38,312
355030883000153,1,38,20,90,90,59,239
355030883000154,1,66,24,111,111,73,295
355030883000155,1,85,19,126,126,48,300
355030883000156,1,81,24,206,206,59,471
355030883000157,1,58,30,58,58,82,198
355030883000158,1,25,15,63,63,41,167
355030883000159,1,21,15,59,59,43,161
355030883000160,1,38,22,58,58,74,190
355030883000161,1,20,15,42,42,60,144
355030883000162,1,56,22,55,55,62,172
355030883000163,1,74,43,77,77,51,205
355030883000164,1,82,31,96,96,94,286
355030883000165,1,36,12,75,75,34,184
355030883000166,1,66,43,122,122,64,308
355030883000168,1,23,10,71,71,22,164
355030883000169,1,31,22,69,69,70,208
355030883000170,1,28,24,67,67,53,187
355030883000171,1,37,33,46,46,78,170
355030883000172,1,174,35,232,232,96,560
355030883000173,1,88,25,95,95,127,317
355030883000174,1,100,31,113,113,64,290
355030883000175,1,23,11,87,87,28,202
355030883000176,1,142,50,224,224,90,538
355030883000177,1,117,56,180,180,130,490
355030883000178,1,35,15,40,40,57,137
355030883000179,1,48,16,48,48,53,149
355030883000180,1,26,15,58,58,22,138
355030883000181,1,50,17,45,45,35,125
355030883000182,1,88,31,105,105,70,280
355030883000183,1,86,18,115,115,44,274
355030883000184,1,87,20,113,113,46,272
355030883000185,1,85,19,105,105,43,253
355030883000186,1,56,18,90,90,29,209
355030883000187,1,74,39,84,84,67,235
355030883000188,1,82,20,74,74,51,199
355030883000189,1,29,10,41,41,26,108
355030883000190,1,88,19,97,97,54,248
355030883000191,1,70,18,86,86,53,225
355030883000192,1,74,28,106,106,41,253
355030883000193,1,150,80,202,202,178,582
355030883000194,1,30,13,46,46,25,117
355030883000195,1,436,186,371,371,148,890
355030883000196,1,96,45,228,228,64,520
355030883000197,1,53,12,120,120,38,278
355030883000198,1,89,41,164,164,100,428
355030883000199,1,89,48,113,113,116,342
355030883000200,1,59,21,160,160,78,398
355030883000201,1,22,20,52,52,42,146
355030883000202,1,14,8,21,21,25,67
355030883000203,1,79,48,123,123,112,358
355030883000204,1,72,35,145,145,103,393
355030883000205,1,57,22,73,73,79,225
355030883000206,1,31,14,62,62,54,178
355030883000207,1,35,12,52,52,56,160
355030883000208,1,702,308,596,596,172,1364
355030883000209,1,285,111,267,267,105,639
355030883000210,1,544,242,364,364,108,836
355030883000211,1,141,81,166,166,57,389
355030883000212,1,47,23,87,87,69,243
355030883000213,1,38,21,43,43,39,125
355030883000214,1,11,11,17,17,18,52
355030883000215,1,187,84,365,365,246,976
355030883000216,1,131,61,205,205,211,621
355030883000217,1,99,47,198,198,101,497
355030883000218,1,208,57,458,458,200,1116
355030883000219,1,148,84,130,130,51,311
355030883000221,1,45,29,138,138,74,350
355030883000222,1,179,68,144,144,38,326
355030883000223,1,27,13,32,32,19,83
355030884000001,1,246,83,245,245,147,637
355030884000002,1,206,104,192,192,162,546
355030884000003,1,153,66,149,149,95,393
355030884000004,1,265,124,256,256,175,687
355030884000005,1,203,100,177,177,118,472
355030884000006,1,205,72,138,138,80,356
355030884000007,1,147,71,158,158,98,414
355030884000008,1,135,85,158,158,104,420
355030884000009,1,123,61,132,132,98,362
355030884000010,1,118,59,121,121,87,329
355030884000011,1,109,65,100,100,69,269
355030884000012,1,198,93,212,212,139,563
355030884000013,1,98,51,121,121,63,305
355030884000014,1,174,77,202,202,115,519
355030884000015,1,206,91,169,169,105,443
355030884000016,1,122,50,114,114,61,289
355030884000017,1,168,83,166,166,126,458
355030884000018,1,163,91,188,188,114,490
355030884000019,1,179,81,207,207,117,531
355030884000020,1,180,82,171,171,115,457
355030884000021,1,159,71,185,185,139,509
355030884000022,1,242,127,264,264,191,719
355030884000023,1,191,90,242,242,119,603
355030884000024,1,213,108,231,231,147,609
355030884000025,1,28,16,37,37,36,110
355030884000026,1,323,114,473,473,207,1153
355030884000027,1,270,108,286,286,224,796
355030884000028,1,165,89,195,195,158,548
355030884000029,1,123,60,155,155,120,430
355030884000030,1,66,37,62,62,38,162
355030884000031,1,256,124,235,235,140,610
355030884000032,1,149,71,176,176,107,459
355030884000033,1,143,94,171,171,119,461
355030884000034,1,171,81,158,158,110,426
355030884000035,1,126,72,125,125,114,364
355030884000036,1,112,30,97,97,59,253
355030884000037,1,200,91,217,217,138,572
355030884000038,1,212,88,167,167,81,415
355030884000039,1,82,45,57,57,42,156
355030884000040,1,216,84,165,165,124,454
355030884000041,1,279,121,256,256,150,662
355030884000042,1,182,94,190,190,113,493
355030884000043,1,173,74,172,172,103,447
355030884000044,1,113,49,144,144,105,393
355030884000045,1,155,71,164,164,109,437
355030884000046,1,164,80,167,167,128,462
355030884000047,1,193,110,209,209,138,556
355030884000048,1,185,76,156,156,76,388
355030884000049,1,234,103,201,201,111,513
355030884000050,1,155,122,164,164,110,438
355030884000051,1,169,80,158,158,76,392
355030884000052,1,184,81,196,196,110,502
355030884000053,1,213,101,169,169,101,439
355030884000054,1,191,81,205,205,137,547
355030884000055,1,134,59,141,141,101,383
355030884000056,1,116,61,145,145,88,378
355030884000057,1,134,72,147,147,101,395
355030884000058,1,234,106,271,271,159,701
355030884000059,1,101,72,128,128,101,357
355030884000060,1,154,78,211,211,156,578
355030884000061,1,101,49,156,156,114,426
355030884000062,1,210,77,219,219,182,620
355030884000063,1,202,100,260,260,165,685
355030884000064,1,135,60,157,157,108,422
355030884000065,1,152,83,183,183,155,521
355030884000066,1,170,68,164,164,108,436
355030884000067,1,167,70,179,179,97,455
355030884000068,1,98,60,131,131,91,353
355030884000069,1,188,86,213,213,129,555
355030884000070,1,237,125,264,264,179,707
355030884000071,1,149,76,153,153,135,441
355030884000072,1,167,73,197,197,131,525
355030884000073,1,128,58,116,116,81,313
355030884000074,1,72,41,97,97,45,239
355030884000075,1,196,104,204,204,149,557
355030884000076,1,172,62,140,140,94,374
355030884000077,1,253,116,246,246,127,619
355030884000078,1,88,31,63,63,26,152
355030884000079,1,161,74,146,146,97,389
355030884000080,1,192,81,141,141,69,351
355030884000081,1,188,82,176,176,99,451
355030884000082,1,206,103,220,220,131,571
355030884000083,1,202,96,205,205,116,526
355030884000084,1,142,88,146,146,103,395
355030884000085,1,211,115,228,228,115,571
355030884000086,1,248,107,249,249,177,675
355030884000087,1,121,65,146,146,102,394
355030884000088,1,125,68,125,125,93,343
355030884000089,1,134,68,155,155,133,443
355030884000090,1,212,95,193,193,157,543
355030884000091,1,283,122,314,314,147,775
355030884000092,1,130,60,142,142,68,352
355030884000093,1,190,84,215,215,139,569
355030884000094,1,163,71,244,244,159,647
355030884000095,1,0,0,0,0,4,4
355030884000096,1,136,71,168,168,131,467
355030884000097,1,90,49,126,126,103,355
355030884000098,1,138,54,187,187,110,484
355030884000099,1,77,39,120,120,84,324
355030884000100,1,161,78,181,181,139,501
355030884000101,1,105,49,117,117,120,354
355030884000102,1,104,54,105,105,88,298
355030884000103,1,136,49,158,158,175,491
355030884000104,1,182,79,165,165,118,448
355030884000105,1,152,64,168,168,92,428
355030884000106,1,159,62,166,166,121,453
355030884000107,1,196,105,230,230,146,606
355030884000108,1,190,95,214,214,156,584
355030884000109,1,97,77,118,118,82,318
355030884000110,1,99,36,122,122,76,320
355030884000111,1,138,80,152,152,127,431
355030884000112,1,148,88,182,182,146,510
355030884000113,1,131,72,139,139,131,409
355030884000114,1,310,125,204,204,79,487
355030884000115,1,108,60,116,116,82,314
355030884000116,1,246,99,281,281,114,676
355030884000117,1,38,24,44,44,35,123
355030884000118,1,248,85,145,145,82,372
355030884000119,1,135,66,134,134,62,330
355030884000120,1,168,71,164,164,97,425
355030884000121,1,105,52,103,103,73,279
355030884000122,1,247,130,200,200,96,496
355030884000123,1,82,45,84,84,57,225
355030884000124,1,219,86,194,194,79,467
355030884000125,1,186,92,188,188,134,510
355030884000126,1,165,87,168,168,143,479
355030884000127,1,65,35,49,49,41,139
355030884000128,1,115,53,110,110,81,301
355030884000129,1,61,45,67,67,42,176
355030884000130,1,202,96,238,238,133,609
355030884000131,1,130,56,155,155,86,396
355030884000132,1,199,98,237,237,181,655
355030884000133,1,162,78,164,164,102,430
355030884000134,1,141,78,147,147,121,415
355030884000135,1,377,152,421,421,186,1028
355030884000136,1,212,78,309,309,95,713
355030884000137,1,59,13,52,52,25,129
355030884000138,1,240,121,227,227,130,584
355030884000139,1,221,122,212,212,129,553
355030884000140,1,82,35,90,90,74,254
355030884000141,1,81,46,104,104,56,264
355030884000142,1,108,36,146,146,58,350
355030884000143,1,56,23,63,63,31,157
355030884000144,1,107,47,149,149,103,401
355030884000145,1,151,83,154,154,171,479
355030884000146,1,126,57,167,167,158,492
355030884000147,1,156,76,197,197,169,563
355030884000148,1,129,65,65,65,30,160
355030884000149,1,159,73,197,197,125,519
355030884000150,1,156,66,174,174,134,482
355030884000151,1,110,51,148,148,90,386
355030884000152,1,165,103,161,161,148,470
355030884000153,1,216,78,172,172,113,457
355030884000154,1,178,85,162,162,103,427
355030884000155,1,150,77,148,148,103,399
355030884000156,1,198,78,199,199,141,539
355030884000157,1,215,109,216,216,145,577
355030884000158,1,77,58,88,88,40,216
355030884000159,1,193,86,151,151,102,404
355030884000160,1,186,76,212,212,103,527
355030884000161,1,153,45,148,148,89,385
355030884000162,1,100,61,123,123,74,320
355030884000163,1,158,92,201,201,119,521
355030884000164,1,184,75,173,173,105,451
355030884000165,1,190,88,206,206,109,521
355030884000166,1,137,60,133,133,93,359
355030884000167,1,220,110,201,201,153,555
355030884000168,1,307,166,224,224,123,571
355030884000169,1,133,89,132,132,122,386
355030884000170,1,102,43,110,110,103,323
355030884000171,1,62,32,93,93,103,289
355030884000172,1,135,86,172,172,98,442
355030884000173,1,161,81,169,169,146,484
355030884000174,1,222,109,250,250,146,646
355030884000175,1,403,210,363,363,210,936
355030884000176,1,11,12,9,9,8,26
355030884000177,1,297,147,250,250,115,615
355030884000178,1,84,49,89,89,50,228
355030884000179,1,99,52,111,111,46,268
355030884000180,1,328,129,303,303,136,742
355030884000181,1,132,50,143,143,94,380
355030884000182,1,105,52,144,144,63,351
355030884000183,1,155,56,181,181,104,466
355030884000185,1,180,70,149,149,124,422
355030884000186,1,70,38,90,90,48,228
355030884000187,1,84,27,100,100,28,228
355030884000188,1,75,35,116,116,33,265
355030884000189,1,80,38,98,98,67,263
355030884000190,1,106,74,129,129,95,353
355030884000191,1,170,90,175,175,93,443
355030884000192,1,98,55,80,80,70,230
355030884000193,1,78,37,80,80,60,220
355030884000194,1,113,46,105,105,65,275
355030884000195,1,134,69,137,137,104,378
355030884000196,1,359,117,269,269,71,609
355030884000197,1,69,41,73,73,71,217
355030884000198,1,144,65,147,147,87,381
355030884000199,1,106,40,87,87,56,230
355030884000200,1,249,127,252,252,153,657
355030884000201,1,253,134,206,206,176,588
355030884000202,1,100,53,124,124,107,355
355030884000204,1,249,106,196,196,99,491
355030884000205,1,107,53,81,81,36,198
355030884000206,1,4,1,0,0,3,3
355030884000207,1,94,42,83,83,33,199
355030884000208,1,34,16,27,27,17,71
355030884000209,1,69,29,49,49,28,126
355030884000210,1,147,63,113,113,62,288
355030884000211,1,120,55,91,91,41,223
355030884000212,1,69,23,67,67,50,184
355030884000213,1,119,56,82,82,53,217
355030884000214,1,49,32,34,34,22,90
355030884000215,1,45,17,47,47,24,118
355030885000001,1,100,51,154,154,129,437
355030885000002,1,39,30,62,62,95,219
355030885000003,1,170,87,254,254,211,719
355030885000004,1,98,57,169,169,142,480
355030885000005,1,132,78,176,176,167,519
355030885000006,1,98,52,138,138,182,458
355030885000007,1,73,45,104,104,111,319
355030885000008,1,85,61,132,132,119,383
355030885000009,1,126,73,242,242,156,640
355030885000010,1,94,40,109,109,118,336
355030885000011,1,93,40,117,117,126,360
355030885000012,1,0,1,2,2,4,8
355030885000013,1,149,69,203,203,169,575
355030885000014,1,167,99,190,190,159,539
355030885000015,1,149,78,187,187,196,570
355030885000016,1,50,31,119,119,103,341
355030885000017,1,139,66,186,186,156,528
355030885000018,1,89,45,123,123,113,359
355030885000019,1,98,48,111,111,138,360
355030885000020,1,43,31,81,81,118,280
355030885000021,1,115,70,207,207,153,567
355030885000022,1,85,39,154,154,133,441
355030885000023,1,54,23,81,81,67,229
355030885000024,1,134,76,184,184,205,573
355030885000025,1,159,75,206,206,193,605
355030885000026,1,127,49,177,177,197,551
355030885000027,1,59,47,78,78,88,244
355030885000028,1,189,79,192,192,162,546
355030885000029,1,108,63,153,153,151,457
355030885000030,1,94,61,120,120,127,367
355030885000031,1,102,58,176,176,152,504
355030885000032,1,91,55,117,117,132,366
355030885000033,1,69,48,108,108,125,341
355030885000034,1,56,38,99,99,122,320
355030885000035,1,62,41,104,104,117,325
355030885000036,1,120,56,170,170,157,497
355030885000037,1,123,85,198,198,228,624
355030885000038,1,107,58,186,186,155,527
355030885000039,1,128,71,175,175,186,536
355030885000040,1,79,44,119,119,121,359
355030885000041,1,146,73,210,210,186,606
355030885000042,1,66,45,100,100,97,297
355030885000043,1,107,75,131,131,166,428
355030885000044,1,135,78,181,181,168,530
355030885000045,1,64,39,112,112,104,328
355030885000046,1,155,79,232,232,216,680
355030885000047,1,108,67,170,170,196,536
355030885000048,1,87,57,149,149,154,452
355030885000049,1,149,76,200,200,200,600
355030885000050,1,106,71,153,153,156,462
355030885000051,1,70,54,105,105,125,335
355030885000052,1,160,93,275,275,204,754
355030885000053,1,128,74,210,210,211,631
355030885000054,1,66,35,113,113,124,350
355030885000055,1,154,71,158,158,141,457
355030885000056,1,0,0,0,0,1,1
355030885000057,1,173,83,188,188,194,570
355030885000058,1,145,78,188,188,192,568
355030885000059,1,117,61,163,163,113,439
355030885000060,1,96,53,147,147,132,426
355030885000061,1,155,62,212,212,154,578
355030885000062,1,114,61,157,157,152,466
355030885000063,1,85,46,129,129,122,380
355030885000064,1,89,46,147,147,125,419
355030885000065,1,140,59,155,155,139,449
355030885000066,1,141,93,215,215,241,671
355030885000067,1,145,88,238,238,184,660
355030885000068,1,110,57,168,168,159,495
355030885000069,1,62,33,75,75,117,267
355030885000070,1,113,63,168,168,180,516
355030885000071,1,75,35,134,134,97,365
355030885000072,1,42,21,69,69,54,192
355030885000073,1,105,52,137,137,166,440
355030885000074,1,176,84,386,386,198,970
355030885000075,1,92,56,163,163,122,448
355030885000076,1,96,41,81,81,72,234
355030885000077,1,46,29,60,60,47,167
355030885000078,1,84,37,146,146,82,374
355030885000079,1,293,137,274,274,231,779
355030885000080,1,213,115,272,272,203,747
355030885000081,1,121,46,101,101,42,244
355030885000082,1,160,72,174,174,177,525
355030885000083,1,41,26,42,42,73,157
355030885000084,1,157,79,181,181,194,556
355030885000085,1,117,59,165,165,113,443
355030885000086,1,108,66,156,156,143,455
355030885000087,1,82,55,133,133,128,394
355030885000088,1,135,86,201,201,207,609
355030885000089,1,66,50,86,86,146,318
355030885000090,1,117,61,208,208,188,604
355030885000091,1,88,60,161,161,236,558
355030885000092,1,108,54,174,174,160,508
355030885000093,1,118,61,193,193,197,583
355030885000094,1,186,114,229,229,213,671
355030885000095,1,285,137,319,319,236,874
355030885000096,1,226,113,261,261,185,707
355030885000097,1,76,60,116,116,130,362
355030885000098,1,89,30,185,185,96,466
355030885000099,1,191,117,309,309,377,995
355030885000100,1,64,52,115,115,151,381
355030885000101,1,123,53,170,170,131,471
355030885000102,1,75,40,88,88,74,250
355030885000103,1,127,52,156,156,94,406
355030885000104,1,119,68,149,149,128,426
355030885000105,1,191,119,251,251,154,656
355030885000106,1,107,54,111,111,116,338
355030885000107,1,116,55,158,158,132,448
355030885000108,1,124,63,202,202,205,609
355030885000109,1,39,29,79,79,106,264
355030885000110,1,168,78,208,208,135,551
355030885000111,1,135,74,165,165,142,472
355030885000112,1,83,47,105,105,88,298
355030885000113,1,68,39,133,133,130,396
355030885000114,1,113,53,135,135,203,473
355030885000115,1,129,63,143,143,93,379
355030885000116,1,131,72,150,150,102,402
355030885000117,1,121,71,169,169,105,443
355030885000118,1,77,69,130,130,118,378
355030885000119,1,46,33,85,85,100,270
355030885000120,1,189,109,283,283,345,911
355030885000121,1,143,89,189,189,232,610
355030885000122,1,118,63,173,173,189,535
355030885000123,1,81,51,116,116,122,354
355030885000124,1,62,22,83,83,73,239
355030885000125,1,75,30,114,114,100,328
355030885000126,1,55,54,98,98,96,292
355030885000127,1,82,44,99,99,82,280
355030885000128,1,37,21,51,51,59,161
355030885000129,1,119,44,138,138,131,407
355030885000130,1,97,49,144,144,81,369
355030885000131,1,83,15,225,225,42,492
355030885000132,1,97,36,130,130,100,360
355030885000133,1,98,33,167,167,73,407
355030885000134,1,26,6,22,22,20,64
355030886000001,1,72,40,113,113,96,322
355030886000002,1,127,72,171,171,189,531
355030886000003,1,88,49,137,137,121,395
355030886000004,1,38,23,69,69,72,210
355030886000005,1,48,31,105,105,109,319
355030886000006,1,74,39,123,123,138,384
355030886000007,1,84,66,181,181,145,507
355030886000008,1,49,24,83,83,66,232
355030886000009,1,128,53,50,50,27,127
355030886000010,1,71,52,121,121,125,367
355030886000011,1,115,64,193,193,178,564
355030886000012,1,117,65,183,183,175,541
355030886000013,1,94,58,232,232,171,635
355030886000014,1,100,55,171,171,113,455
355030886000015,1,126,51,184,184,183,551
355030886000016,1,96,56,170,170,161,501
355030886000017,1,152,64,177,177,175,529
355030886000018,1,123,63,197,197,179,573
355030886000019,1,115,65,169,169,110,448
355030886000020,1,164,68,223,223,172,618
355030886000021,1,238,112,258,258,186,702
355030886000022,1,72,39,91,91,60,242
355030886000023,1,75,28,101,101,68,270
355030886000024,1,136,103,216,216,144,576
355030886000025,1,104,80,144,144,166,454
355030886000026,1,81,35,85,85,54,224
355030886000027,1,170,64,343,343,176,862
355030886000028,1,145,75,183,183,87,453
355030886000029,1,175,65,110,110,97,317
355030886000030,1,66,30,78,78,64,220
355030886000031,1,27,26,49,49,61,159
355030886000032,1,95,53,145,145,151,441
355030886000033,1,117,63,171,171,175,517
355030886000034,1,143,59,231,231,182,644
355030886000035,1,54,35,105,105,102,312
355030886000036,1,141,65,197,197,193,587
355030886000037,1,157,76,239,239,178,656
355030886000038,1,75,50,133,133,99,365
355030886000039,1,92,40,112,112,101,325
355030886000040,1,67,28,92,92,89,273
355030886000041,1,132,52,154,154,132,440
355030886000042,1,84,44,118,118,62,298
355030886000043,1,168,66,152,152,85,389
355030886000044,1,8,4,11,11,14,36
355030886000045,1,116,68,151,151,134,436
355030886000046,1,41,21,80,80,69,229
355030886000047,1,144,68,194,194,198,586
355030886000048,1,92,56,135,135,127,397
355030886000049,1,97,48,141,141,145,427
355030886000050,1,109,60,208,208,135,551
355030886000051,1,125,83,195,195,196,586
355030886000052,1,59,33,114,114,113,341
355030886000053,1,63,45,104,104,122,330
355030886000054,1,150,79,286,286,202,774
355030886000055,1,119,71,179,179,194,552
355030886000056,1,93,57,106,106,118,330
355030886000057,1,105,54,119,119,86,324
355030886000058,1,131,74,165,165,98,428
355030886000059,1,56,39,98,98,108,304
355030886000060,1,121,65,204,204,168,576
355030886000061,1,81,37,152,152,91,395
355030886000062,1,76,43,120,120,140,380
355030886000063,1,100,54,126,126,117,369
355030886000064,1,112,57,170,170,153,493
355030886000065,1,103,66,147,147,117,411
355030886000066,1,212,124,281,281,277,839
355030886000067,1,124,61,212,212,178,602
355030886000068,1,315,120,581,581,238,1400
355030886000069,1,174,30,295,295,97,687
355030886000070,1,49,19,104,104,53,261
355030886000071,1,107,17,303,303,82,688
355030886000072,1,48,27,98,98,93,289
355030886000073,1,64,54,121,121,114,356
355030886000074,1,35,14,44,44,46,134
355030886000075,1,77,45,99,99,108,306
355030886000076,1,112,53,179,179,158,516
355030886000077,1,53,32,84,84,84,252
355030886000078,1,67,44,165,165,102,432
355030886000079,1,54,40,89,89,126,304
355030886000080,1,53,37,77,77,63,217
355030886000081,1,29,10,17,17,21,55
355030887000001,1,155,93,196,196,172,564
355030887000002,1,131,60,153,153,146,452
355030887000003,1,95,36,110,110,63,283
355030887000004,1,105,46,102,102,71,275
355030887000005,1,137,71,164,164,184,512
355030887000006,1,154,75,189,189,171,549
355030887000007,1,150,68,171,171,187,529
355030887000008,1,124,78,163,163,174,500
355030887000009,1,87,57,115,115,104,334
355030887000010,1,85,38,97,97,83,277
355030887000011,1,133,69,194,194,149,537
355030887000012,1,84,50,99,99,112,310
355030887000013,1,131,65,173,173,165,511
355030887000014,1,116,77,196,196,132,524
355030887000015,1,138,57,171,171,119,461
355030887000016,1,100,57,98,98,105,301
355030887000017,1,163,64,165,165,73,403
355030887000018,1,204,89,190,190,124,504
355030887000019,1,185,78,176,176,128,480
355030887000020,1,217,125,234,234,136,604
355030887000021,1,182,64,168,168,94,430
355030887000022,1,140,44,159,159,96,414
355030887000023,1,126,73,143,143,85,371
355030887000024,1,183,73,183,183,117,483
355030887000025,1,150,73,167,167,183,517
355030887000026,1,130,66,129,129,97,355
355030887000027,1,97,48,115,115,81,311
355030887000028,1,118,47,136,136,85,357
355030887000029,1,130,64,139,139,133,411
355030887000030,1,110,63,140,140,129,409
355030887000031,1,99,65,130,130,148,408
355030887000032,1,157,99,167,167,233,567
355030887000033,1,168,92,175,175,180,530
355030887000034,1,99,52,139,139,99,377
355030887000035,1,95,48,132,132,99,363
355030887000036,1,86,46,118,118,75,311
355030887000037,1,126,52,156,156,103,415
355030887000038,1,57,25,62,62,54,178
355030887000039,1,59,33,75,75,103,253
355030887000040,1,51,32,65,65,57,187
355030887000041,1,56,36,85,85,83,253
355030887000042,1,94,43,87,87,65,239
355030887000043,1,95,55,87,87,84,258
355030887000044,1,163,69,158,158,96,412
355030887000045,1,149,68,178,178,109,465
355030887000046,1,171,82,173,173,118,464
355030887000047,1,143,76,145,145,122,412
355030887000048,1,177,95,227,227,145,599
355030887000049,1,145,71,157,157,127,441
355030887000050,1,211,133,208,208,145,561
355030887000051,1,193,108,187,187,152,526
355030887000052,1,209,120,194,194,149,537
355030887000053,1,163,90,187,187,125,499
355030887000054,1,132,61,113,113,53,279
355030887000055,1,127,63,160,160,130,450
355030887000056,1,106,34,118,118,90,326
355030887000057,1,102,53,122,122,94,338
355030887000058,1,166,81,203,203,144,550
355030887000059,1,84,28,91,91,70,252
355030887000060,1,125,58,123,123,93,339
355030887000061,1,187,102,213,213,120,546
355030887000062,1,250,114,245,245,160,650
355030887000063,1,92,56,111,111,145,367
355030887000064,1,111,51,136,136,143,415
355030887000065,1,252,107,251,251,154,656
355030887000066,1,149,69,150,150,72,372
355030887000067,1,207,81,193,193,146,532
355030887000068,1,106,25,85,85,31,201
355030887000069,1,34,12,57,57,52,166
355030887000070,1,91,35,106,106,75,287
355030887000071,1,96,53,144,144,108,396
355030887000072,1,76,22,128,128,103,359
355030887000073,1,85,53,125,125,72,322
355030887000074,1,64,19,50,50,26,126
355030887000075,1,177,76,139,139,65,343
355030887000076,1,231,113,206,206,123,535
355030887000077,1,120,57,139,139,95,373
355030887000078,1,165,96,164,164,116,444
355030887000079,1,140,64,161,161,109,431
355030887000080,1,100,54,109,109,97,315
355030887000081,1,172,62,166,166,103,435
355030887000082,1,162,74,148,148,110,406
355030887000083,1,179,68,153,153,88,394
355030887000084,1,59,28,72,72,54,198
355030887000085,1,188,110,208,208,164,580
355030887000086,1,135,93,143,143,145,431
355030887000087,1,142,69,169,169,131,469
355030887000088,1,124,75,156,156,129,441
355030887000089,1,397,154,283,283,201,767
355030887000091,1,0,0,0,0,0,0
355030887000092,1,92,39,89,89,68,246
355030887000093,1,174,118,209,209,160,578
355030887000094,1,112,80,129,129,104,362
355030887000095,1,121,54,116,116,105,337
355030887000096,1,120,74,137,137,142,416
355030887000097,1,131,66,134,134,90,358
355030887000098,1,221,97,235,235,127,597
355030887000099,1,214,105,235,235,162,632
355030887000100,1,290,96,238,238,83,559
355030887000101,1,99,57,91,91,45,227
355030887000102,1,130,75,189,189,114,492
355030887000103,1,77,49,105,105,90,300
355030887000104,1,145,75,195,195,104,494
355030887000105,1,118,65,166,166,106,438
355030887000106,1,106,59,163,163,89,415
355030887000107,1,214,74,321,321,135,777
355030887000108,1,76,32,90,90,63,243
355030887000109,1,133,61,176,176,150,502
355030887000110,1,140,77,160,160,105,425
355030887000111,1,97,52,117,117,73,307
355030887000112,1,92,64,121,121,106,348
355030887000113,1,117,47,116,116,108,340
355030887000114,1,98,75,146,146,86,378
355030887000115,1,101,54,122,122,83,327
355030887000116,1,117,80,155,155,65,375
355030887000117,1,111,77,156,156,114,426
355030887000118,1,173,66,176,176,108,460
355030887000119,1,128,57,160,160,115,435
355030887000120,1,124,63,181,181,112,474
355030887000121,1,5,9,15,15,13,43
355030887000122,1,65,64,105,105,136,346
355030887000123,1,146,66,152,152,120,424
355030887000124,1,124,58,150,150,161,461
355030887000125,1,156,70,141,141,113,395
355030887000126,1,281,122,155,155,80,390
355030887000127,1,209,91,158,158,133,449
355030887000128,1,162,83,172,172,109,453
355030887000129,1,185,98,191,191,137,519
355030887000130,1,91,43,110,110,106,326
355030887000131,1,133,76,162,162,152,476
355030887000132,1,196,103,231,231,148,610
355030887000133,1,177,69,184,184,92,460
355030887000134,1,133,75,136,136,105,377
355030887000135,1,183,95,141,141,120,402
355030887000136,1,258,120,203,203,125,531
355030887000137,1,112,53,96,96,49,241
355030887000138,1,95,37,98,98,55,251
355030887000139,1,157,68,137,137,71,345
355030887000140,1,125,69,130,130,58,318
355030887000141,1,80,42,83,83,53,219
355030887000142,1,181,90,145,145,95,385
355030887000143,1,114,58,137,137,67,341
355030887000144,1,113,35,89,89,43,221
355030887000145,1,176,90,144,144,113,401
355030887000146,1,184,88,184,184,133,501
355030887000147,1,122,69,147,147,122,416
355030887000148,1,55,52,74,74,80,228
355030887000149,1,106,66,173,173,106,452
355030887000150,1,89,48,123,123,108,354
355030887000151,1,164,83,155,155,165,475
355030887000152,1,50,36,69,69,67,205
355030887000153,1,311,152,277,277,187,741
355030887000154,1,90,39,79,79,52,210
355030887000155,1,200,66,175,175,54,404
355030887000156,1,96,46,98,98,67,263
355030887000157,1,280,126,310,310,136,756
355030887000158,1,348,135,270,270,115,655
355030887000159,1,290,64,280,280,88,648
355030887000162,1,257,115,215,215,107,537
355030887000163,1,184,93,180,180,63,423
355030887000164,1,294,161,282,282,160,724
355030887000165,1,208,96,195,195,98,488
355030887000166,1,96,55,84,84,37,205
355030887000167,1,94,51,79,79,49,207
355030887000168,1,154,86,138,138,103,379
355030887000169,1,111,46,75,75,51,201
355030887000170,1,140,75,118,118,102,338
355030887000171,1,211,93,179,179,93,451
355030887000172,1,225,80,197,197,79,473
355030887000173,1,196,78,213,213,84,510
355030887000174,1,239,106,183,183,77,443
355030887000175,1,121,39,104,104,26,234
355030887000176,1,199,99,171,171,73,415
355030887000177,1,148,68,117,117,63,297
355030887000178,1,122,60,104,104,38,246
355030887000179,1,192,90,152,152,54,358
355030887000180,1,225,108,177,177,86,440
355030887000181,1,188,81,155,155,87,397
355030887000182,1,168,79,128,128,65,321
355030887000183,1,142,74,122,122,73,317
355030887000184,1,42,14,50,50,23,123
355030887000185,1,107,62,94,94,112,300
355030887000186,1,147,58,248,248,77,573
355030887000187,1,131,49,141,141,108,390
355030887000188,1,74,43,79,79,65,223
355030887000189,1,107,42,140,140,80,360
355030887000190,1,161,100,161,161,112,434
355030887000191,1,68,51,81,81,97,259
355030887000192,1,87,49,121,121,109,351
355030887000193,1,48,45,67,67,69,203
355030887000194,1,41,17,58,58,33,149
355030887000195,1,94,39,96,96,130,322
355030887000196,1,75,44,112,112,79,303
355030887000197,1,87,50,90,90,84,264
355030887000198,1,54,22,85,85,76,246
355030887000199,1,118,50,137,137,90,364
355030887000200,1,49,18,59,59,39,157
355030887000201,1,55,27,61,61,29,151
355030887000202,1,100,30,110,110,55,275
355030887000203,1,126,75,144,144,99,387
355030887000204,1,123,55,133,133,83,349
355030887000205,1,81,55,148,148,98,394
355030887000206,1,62,35,73,73,100,246
355030887000207,1,90,47,97,97,52,246
355030887000208,1,59,22,60,60,42,162
355030887000209,1,134,63,155,155,114,424
355030887000210,1,125,54,128,128,65,321
355030887000211,1,71,48,75,75,45,195
355030887000212,1,206,82,223,223,101,547
355030887000213,1,88,30,100,100,63,263
355030887000214,1,100,60,121,121,94,336
355030887000215,1,114,63,112,112,79,303
355030887000216,1,173,107,210,210,158,578
355030887000217,1,0,0,0,0,0,0
355030887000218,1,112,51,101,101,77,279
355030887000219,1,131,51,236,236,71,543
355030887000220,1,147,68,119,119,62,300
355030887000221,1,205,104,189,189,72,450
355030887000222,1,160,56,148,148,71,367
355030887000223,1,101,48,85,85,44,214
355030887000224,1,79,22,57,57,16,130
355030887000225,1,63,37,101,101,93,295
355030887000226,1,379,139,338,338,110,786
355030887000227,1,161,83,129,129,87,345
355030887000228,1,76,39,59,59,40,158
355030887000230,1,18,8,21,21,13,55
355030887000231,1,70,21,63,63,30,156
355030887000232,1,12,3,13,13,4,30
355030887000233,1,161,80,169,169,77,415
355030888000001,1,46,37,103,103,72,278
355030888000002,1,275,60,441,441,205,1087
355030888000003,1,64,45,122,122,139,383
355030888000004,1,103,32,152,152,120,424
355030888000005,1,70,57,132,132,136,400
355030888000006,1,32,15,75,75,91,241
355030888000007,1,49,44,87,87,161,335
355030888000008,1,44,45,104,104,130,338
355030888000009,1,65,34,147,147,118,412
355030888000010,1,79,55,197,197,197,591
355030888000011,1,71,44,160,160,99,419
355030888000012,1,166,67,219,219,209,647
355030888000013,1,52,23,179,179,68,426
355030888000014,1,55,29,109,109,100,318
355030888000015,1,179,74,121,121,47,289
355030888000016,1,203,130,193,193,101,487
355030888000017,1,269,96,160,160,60,380
355030888000018,1,46,31,92,92,87,271
355030888000019,1,90,42,168,168,112,448
355030888000020,1,51,36,124,124,119,367
355030888000021,1,38,25,58,58,101,217
355030888000022,1,90,47,143,143,147,433
355030888000023,1,57,35,129,129,164,422
355030888000024,1,67,39,111,111,140,362
355030888000025,1,28,21,50,50,53,153
355030888000026,1,76,32,155,155,104,414
355030888000027,1,35,20,78,78,71,227
355030888000028,1,60,58,150,150,121,421
355030888000029,1,77,79,159,159,171,489
355030888000030,1,161,142,233,233,175,641
355030888000031,1,98,63,181,181,131,493
355030888000032,1,80,49,180,180,169,529
355030888000033,1,39,42,82,82,115,279
355030888000034,1,15,19,52,52,38,142
355030888000035,1,35,20,72,72,76,220
355030888000036,1,64,32,101,101,114,316
355030888000037,1,114,55,159,159,196,514
355030888000038,1,71,37,126,126,88,340
355030888000039,1,122,29,260,260,91,611
355030888000040,1,92,32,304,304,73,681
355030888000041,1,151,48,273,273,100,646
355030888000042,1,31,27,178,178,80,436
355030888000043,1,108,50,295,295,116,706
355030888000044,1,23,6,168,168,26,362
355030888000045,1,89,47,204,204,114,522
355030888000046,1,49,24,124,124,75,323
355030888000047,1,86,26,117,117,65,299
355030888000049,1,90,40,227,227,143,597
355030888000050,1,68,20,278,278,64,620
355030888000051,1,114,40,260,260,98,618
355030888000052,1,202,55,291,291,185,767
355030888000053,1,84,46,124,124,105,353
355030888000054,1,33,17,135,135,45,315
355030888000055,1,62,14,241,241,57,539
355030888000056,1,93,18,301,301,71,673
355030888000057,1,107,50,163,163,136,462
355030888000058,1,72,35,102,102,92,296
355030888000059,1,54,14,235,235,52,522
355030888000060,1,73,20,223,223,61,507
355030888000064,1,23,9,165,165,28,358
355030888000065,1,165,72,177,177,87,441
355030888000066,1,29,14,134,134,26,294
355030888000067,1,33,27,82,82,74,238
355030888000068,1,147,62,114,114,28,256
355030888000069,1,87,50,124,124,113,361
355030888000070,1,1,144,504,504,94,1102
355030888000071,1,28,19,68,68,97,233
355030888000072,1,58,34,95,95,94,284
355030889000001,1,186,125,282,282,241,805
355030889000002,1,76,40,118,118,67,303
355030889000003,1,244,92,201,201,71,473
355030889000004,1,171,67,141,141,66,348
355030889000005,1,161,76,188,188,70,446
355030889000006,1,194,90,155,155,50,360
355030889000007,1,387,149,280,280,102,662
355030889000008,1,233,104,230,230,93,553
355030889000009,1,103,54,157,157,144,458
355030889000010,1,70,32,128,128,108,364
355030889000011,1,101,61,160,160,105,425
355030889000012,1,102,65,138,138,126,402
355030889000013,1,102,65,144,144,130,418
355030889000014,1,56,30,82,82,72,236
355030889000015,1,69,27,122,122,89,333
355030889000016,1,113,61,193,193,109,495
355030889000017,1,110,76,160,160,147,467
355030889000018,1,69,37,75,75,44,194
355030889000019,1,136,95,160,160,117,437
355030889000020,1,84,24,66,66,38,170
355030889000021,1,165,78,149,149,56,354
355030889000022,1,198,85,130,130,58,318
355030889000023,1,124,67,109,109,36,254
355030889000024,1,373,151,303,303,137,743
355030889000025,1,163,78,172,172,62,406
355030889000026,1,458,182,320,320,106,746
355030889000027,1,187,67,137,137,80,354
355030889000028,1,154,72,139,139,111,389
355030889000029,1,213,80,178,178,89,445
355030889000030,1,218,102,200,200,112,512
355030889000031,1,201,119,209,209,115,533
355030889000032,1,97,41,107,107,80,294
355030889000033,1,96,61,110,110,129,349
355030889000034,1,115,51,159,159,183,501
355030889000035,1,56,28,96,96,76,268
355030889000036,1,106,64,160,160,150,470
355030889000037,1,115,57,177,177,125,479
355030889000038,1,146,67,177,177,137,491
355030889000039,1,96,76,162,162,144,468
355030889000040,1,111,53,113,113,115,341
355030889000041,1,208,60,174,174,135,483
355030889000042,1,122,58,206,206,115,527
355030889000043,1,66,47,126,126,135,387
355030889000044,1,178,65,232,232,191,655
355030889000045,1,159,83,179,179,190,548
355030889000046,1,66,39,75,75,49,199
355030889000047,1,52,30,70,70,59,199
355030889000048,1,79,32,99,99,70,268
355030889000049,1,200,92,176,176,124,476
355030889000050,1,201,84,194,194,124,512
355030889000051,1,226,127,263,263,147,673
355030889000052,1,188,107,166,166,112,444
355030889000053,1,125,62,135,135,78,348
355030889000054,1,128,48,204,204,95,503
355030889000055,1,125,67,209,209,154,572
355030889000056,1,77,59,128,128,140,396
355030889000057,1,79,47,128,128,110,366
355030889000058,1,184,101,295,295,196,786
355030889000059,1,43,39,103,103,68,274
355030889000060,1,46,31,63,63,58,184
355030889000061,1,52,37,71,71,90,232
355030889000062,1,106,68,176,176,128,480
355030889000063,1,119,68,176,176,146,498
355030889000064,1,109,65,168,168,160,496
355030889000065,1,104,141,248,248,85,581
355030889000066,1,148,70,143,143,140,426
355030889000067,1,142,55,148,148,111,407
355030889000068,1,106,44,137,137,91,365
355030889000069,1,127,80,175,175,148,498
355030889000070,1,97,64,165,165,136,466
355030889000071,1,114,65,149,149,136,434
355030889000072,1,93,31,112,112,94,318
355030889000073,1,95,55,133,133,116,382
355030889000074,1,112,31,107,107,68,282
355030889000075,1,58,32,107,107,86,300
355030889000076,1,89,41,111,111,76,298
355030889000077,1,87,52,137,137,99,373
355030889000078,1,107,87,169,169,159,497
355030889000079,1,103,51,188,188,134,510
355030889000080,1,124,80,135,135,95,365
355030889000081,1,132,51,127,127,79,333
355030889000082,1,49,29,79,79,66,224
355030889000083,1,119,59,130,130,119,379
355030889000084,1,101,34,102,102,61,265
355030889000085,1,20,17,20,20,14,54
355030889000086,1,95,47,140,140,121,401
355030889000087,1,70,55,142,142,126,410
355030889000088,1,116,63,177,177,139,493
355030889000089,1,79,41,87,87,116,290
355030889000090,1,61,31,90,90,108,288
355030889000091,1,70,52,135,135,143,413
355030889000092,1,112,71,209,209,188,606
355030889000093,1,88,66,154,154,148,456
355030889000094,1,116,71,196,196,133,525
355030889000095,1,75,34,95,95,105,295
355030889000096,1,102,35,93,93,70,256
355030889000097,1,59,33,94,94,59,247
355030889000098,1,106,78,153,153,133,439
355030889000099,1,87,57,119,119,114,352
355030889000100,1,99,42,143,143,92,378
355030889000101,1,87,40,86,86,86,258
355030889000102,1,92,50,106,106,84,296
355030889000103,1,167,71,196,196,120,512
355030889000104,1,117,76,155,155,179,489
355030889000105,1,107,58,142,142,106,390
355030889000106,1,88,48,90,90,91,271
355030889000107,1,78,41,101,101,115,317
355030889000108,1,125,71,181,181,137,499
355030889000109,1,113,55,143,143,181,467
355030889000110,1,33,20,75,75,63,213
355030889000111,1,190,77,177,177,112,466
355030889000112,1,0,0,0,0,0,0
355030889000114,1,284,138,275,275,115,665
355030889000115,1,296,123,263,263,86,612
355030889000116,1,402,163,340,340,161,841
355030889000117,1,77,28,42,42,35,119
355030889000118,1,98,49,144,144,87,375
355030889000119,1,103,42,111,111,93,315
355030889000120,1,43,17,51,51,50,152
355030889000121,1,56,34,100,100,70,270
355030889000122,1,91,50,112,112,105,329
355030889000123,1,91,46,130,130,102,362
355030889000124,1,76,48,115,115,130,360
355030889000125,1,49,38,113,113,100,326
355030889000126,1,88,70,129,129,147,405
355030889000127,1,68,46,129,129,88,346
355030889000128,1,85,58,125,125,126,376
355030889000129,1,62,38,89,89,84,262
355030889000130,1,59,25,110,110,72,292
355030889000131,1,39,22,96,96,75,267
355030889000132,1,105,74,164,164,101,429
355030889000133,1,79,60,115,115,112,342
355030889000134,1,71,44,65,65,79,209
355030889000135,1,134,69,170,170,119,459
355030889000136,1,117,58,147,147,120,414
355030889000137,1,115,73,123,123,90,336
355030889000138,1,74,63,113,113,109,335
355030889000139,1,129,83,161,161,134,456
355030889000140,1,94,49,172,172,138,482
355030889000141,1,119,61,178,178,143,499
355030889000142,1,118,79,194,194,106,494
355030889000143,1,75,57,89,89,116,294
355030889000144,1,67,48,134,134,68,336
355030889000145,1,135,58,184,184,137,505
355030889000146,1,87,37,109,109,78,296
355030889000147,1,112,61,159,159,104,422
355030889000148,1,66,52,112,112,77,301
355030889000149,1,51,29,60,60,56,176
355030889000150,1,86,47,117,117,100,334
355030889000151,1,99,67,116,116,97,329
355030889000152,1,59,42,101,101,86,288
355030889000153,1,81,44,87,87,68,242
355030889000154,1,62,33,84,84,74,242
355030889000155,1,70,37,110,110,100,320
355030889000156,1,136,70,134,134,140,408
355030889000157,1,98,55,152,152,162,466
355030889000158,1,332,148,287,287,179,753
355030889000159,1,262,155,218,218,124,560
355030889000160,1,233,127,191,191,91,473
355030889000161,1,59,35,69,69,89,227
355030889000162,1,57,37,82,82,84,248
355030889000163,1,54,32,64,64,92,220
355030889000164,1,55,22,80,80,86,246
355030889000165,1,64,31,103,103,67,273
355030889000166,1,114,37,248,248,100,596
355030889000167,1,63,29,154,154,57,365
355030889000168,1,94,53,163,163,141,467
355030889000169,1,199,73,149,149,64,362
355030889000170,1,161,68,141,141,52,334
355030889000171,1,60,33,101,101,94,296
355030889000172,1,57,42,101,101,69,271
355030889000173,1,269,118,232,232,95,559
355030889000174,1,103,59,105,105,80,290
355030889000175,1,317,149,203,203,52,458
355030889000176,1,244,126,226,226,108,560
355030889000177,1,28,16,28,28,19,75
355030889000178,1,81,33,87,87,29,203
355030889000179,1,0,0,0,0,0,0
355030890000001,1,27,26,177,177,106,460
355030890000002,1,1,3,0,0,5,5
355030890000003,1,35,39,153,153,101,407
355030890000004,1,40,36,145,145,116,406
355030890000005,1,60,73,201,201,175,577
355030890000006,1,36,32,128,128,117,373
355030890000007,1,41,44,87,87,125,299
355030890000008,1,54,29,143,143,94,380
355030890000009,1,43,36,80,80,108,268
355030890000010,1,61,72,255,255,140,650
355030890000011,1,31,51,102,102,101,305
355030890000012,1,74,52,118,118,102,338
355030890000013,1,71,56,133,133,156,422
355030890000014,1,50,21,102,102,102,306
355030890000015,1,32,25,94,94,116,304
355030890000016,1,48,53,121,121,104,346
355030890000017,1,39,34,108,108,106,322
355030890000018,1,36,21,104,104,91,299
355030890000019,1,148,53,227,227,199,653
355030890000020,1,36,32,86,86,95,267
355030890000021,1,34,20,70,70,80,220
355030890000022,1,98,70,268,268,211,747
355030890000023,1,50,38,113,113,136,362
355030890000024,1,118,62,314,314,203,831
355030890000025,1,97,48,190,190,166,546
355030890000026,1,57,46,75,75,71,221
355030890000027,1,72,40,155,155,129,439
355030890000028,1,54,26,98,98,74,270
355030890000029,1,20,28,99,99,64,262
355030890000030,1,0,0,0,0,0,0
355030890000031,1,32,43,104,104,129,337
355030890000032,1,17,22,36,36,34,106
355030890000033,1,31,46,77,77,115,269
355030890000034,1,34,26,68,68,71,207
355030890000035,1,36,36,113,113,126,352
355030890000036,1,58,28,81,81,98,260
355030890000037,1,8,24,61,61,55,177
355030890000038,1,54,36,205,205,134,544
355030890000039,1,94,85,208,208,127,543
355030890000040,1,88,57,145,145,151,441
355030890000041,1,63,34,169,169,138,476
355030890000042,1,52,35,168,168,107,443
355030890000043,1,70,41,115,115,132,362
355030890000044,1,85,50,130,130,125,385
355030890000045,1,82,48,143,143,164,450
355030890000046,1,64,36,101,101,114,316
355030890000047,1,13,22,86,86,64,236
355030890000048,1,84,60,164,164,160,488
355030890000049,1,102,55,231,231,155,617
355030890000050,1,46,28,79,79,98,256
355030890000051,1,115,77,149,149,228,526
355030890000052,1,133,56,271,271,219,761
355030890000053,1,98,47,147,147,158,452
355030890000054,1,70,52,278,278,172,728
355030890000055,1,30,18,124,124,101,349
355030890000056,1,81,64,129,129,172,430
355030890000057,1,40,35,72,72,139,283
355030890000058,1,40,29,83,83,88,254
355030890000059,1,70,31,131,131,125,387
355030890000060,1,46,44,142,142,110,394
355030890000061,1,43,43,88,88,101,277
355030890000062,1,51,74,137,137,128,402
355030890000063,1,248,189,252,252,160,664
355030890000064,1,53,39,130,130,141,401
355030890000065,1,108,88,250,250,242,742
355030890000066,1,54,59,117,117,182,416
355030890000067,1,58,61,133,133,147,413
355030890000068,1,51,60,146,146,169,461
355030890000069,1,46,53,109,109,120,338
355030890000070,1,26,12,68,68,97,233
355030890000071,1,52,31,119,119,100,338
355030890000072,1,12,27,45,45,53,143
355030890000073,1,40,21,97,97,81,275
355030890000074,1,43,30,80,80,106,266
355030890000075,1,23,26,89,89,50,228
355030890000076,1,31,41,101,101,89,291
355030890000077,1,28,35,111,111,113,335
355030890000078,1,40,30,145,145,177,467
355030890000079,1,21,18,90,90,68,248
355030890000080,1,60,35,125,125,146,396
355030890000081,1,27,11,59,59,57,175
355030890000082,1,63,46,163,163,166,492
355030890000083,1,42,20,75,75,94,244
355030890000084,1,43,36,85,85,109,279
355030890000085,1,97,48,254,254,159,667
355030890000086,1,80,57,151,151,151,453
355030890000087,1,101,54,131,131,163,425
355030890000088,1,139,44,284,284,154,722
355030890000089,1,60,31,79,79,120,278
355030890000090,1,65,53,186,186,232,604
355030890000091,1,37,36,115,115,103,333
355030890000092,1,10,6,26,26,27,79
355030890000093,1,23,33,161,161,101,423
355030890000094,1,50,39,94,94,134,322
355030890000095,1,33,21,62,62,91,215
355030890000096,1,56,41,92,92,148,332
355030890000097,1,90,45,200,200,158,558
355030890000098,1,56,34,106,106,124,336
355030890000099,1,50,49,135,135,167,437
355030890000100,1,50,32,112,112,87,311
355030890000101,1,69,46,148,148,139,435
355030890000102,1,76,48,198,198,150,546
355030890000103,1,52,37,202,202,127,531
355030890000104,1,74,54,112,112,137,361
355030890000105,1,9,6,39,39,27,105
355030890000106,1,19,19,51,51,71,173
355030890000107,1,42,41,127,127,123,377
355030890000108,1,54,34,197,197,129,523
355030890000109,1,38,42,143,143,148,434
355030890000110,1,53,32,131,131,132,394
355030890000111,1,78,55,174,174,173,521
355030890000112,1,100,76,167,167,208,542
355030890000113,1,93,47,132,132,126,390
355030890000114,1,102,64,154,154,161,469
355030890000115,1,58,48,114,114,101,329
355030890000116,1,113,63,346,346,204,896
355030890000117,1,56,56,110,110,170,390
355030890000118,1,128,94,226,226,218,670
355030890000119,1,40,34,91,91,117,299
355030890000120,1,9,8,31,31,24,86
355030890000121,1,53,28,105,105,101,311
355030890000122,1,17,20,78,78,33,189
355030890000123,1,71,42,183,183,97,463
355030890000124,1,49,52,145,145,161,451
355030890000125,1,31,12,91,91,79,261
355030890000126,1,57,50,139,139,183,461
355030890000127,1,39,20,129,129,108,366
355030890000128,1,104,67,233,233,246,712
355030890000129,1,55,30,104,104,105,313
355030890000130,1,37,16,67,67,84,218
355030890000131,1,6,9,16,16,17,49
355030890000132,1,92,54,156,156,207,519
355030890000133,1,72,33,180,180,152,512
355030890000134,1,53,41,125,125,136,386
355030890000135,1,34,32,94,94,78,266
355030890000136,1,75,51,196,196,165,557
355030890000137,1,34,41,149,149,105,403
355030890000138,1,13,34,96,96,104,296
355030890000139,1,21,15,87,87,80,254
355030890000140,1,10,19,75,75,76,226
355030890000141,1,74,62,168,168,203,539
355030890000142,1,26,44,78,78,116,272
355030890000143,1,38,21,92,92,72,256
355030890000144,1,95,43,129,129,96,354
355030890000145,1,77,54,138,138,165,441
355030890000146,1,75,48,168,168,168,504
355030890000147,1,64,33,78,78,104,260
355030890000148,1,18,25,108,108,89,305
355030890000149,1,86,45,218,218,173,609
355030890000150,1,53,32,133,133,121,387
355030890000151,1,44,40,92,92,87,271
355030890000152,1,68,31,161,161,157,479
355030890000153,1,58,16,145,145,132,422
355030890000154,1,64,60,123,123,157,403
355030890000155,1,85,54,221,221,143,585
355030890000156,1,38,34,113,113,134,360
355030890000157,1,16,36,97,97,94,288
355030890000158,1,32,17,60,60,73,193
355030890000159,1,30,24,87,87,71,245
355030890000160,1,16,23,95,95,64,254
355030890000161,1,70,103,308,308,205,821
355030890000162,1,54,42,148,148,103,399
355030890000163,1,27,17,77,77,84,238
355030890000164,1,79,35,159,159,150,468
355030890000165,1,11,14,50,50,49,149
355030890000166,1,21,22,53,53,59,165
355030890000167,1,80,37,271,271,162,704
355030890000168,1,73,36,143,143,157,443
355030890000169,1,31,19,54,54,86,194
355030890000170,1,24,23,84,84,66,234
355030890000171,1,39,24,124,124,75,323
355030890000172,1,41,34,72,72,87,231
355030890000173,1,43,30,97,97,89,283
355030890000174,1,50,41,118,118,87,323
355030890000175,1,99,52,153,153,191,497
355030890000176,1,18,10,67,67,52,186
355030890000177,1,34,21,104,104,153,361
355030890000178,1,37,34,102,102,119,323
355030890000179,1,70,27,130,130,113,373
355030890000180,1,132,59,269,269,205,743
355030890000181,1,32,27,76,76,103,255
355030890000182,1,35,48,97,97,140,334
355030890000183,1,23,39,95,95,116,306
355030890000184,1,53,31,136,136,129,401
355030890000185,1,89,45,178,178,145,501
355030890000186,1,79,34,167,167,117,451
355030890000187,1,37,34,135,135,103,373
355030890000188,1,68,34,134,134,145,413
355030890000189,1,46,19,94,94,73,261
355030890000190,1,54,42,148,148,149,445
355030890000191,1,47,36,108,108,95,311
355030890000192,1,23,16,60,60,64,184
355030890000193,1,33,41,90,90,91,271
355030890000194,1,4,8,37,37,45,119
355030890000195,1,112,60,292,292,220,804
355030890000196,1,37,31,91,91,75,257
355030890000197,1,13,15,37,37,45,119
355030890000198,1,87,40,206,206,161,573
355030890000199,1,210,81,410,410,274,1094
355030890000200,1,67,42,122,122,150,394
355030890000201,1,41,31,121,121,100,342
355030890000202,1,11,11,50,50,48,148
355030890000203,1,38,24,103,103,101,307
355030890000204,1,29,19,83,83,89,255
355030890000205,1,28,32,96,96,105,297
355030890000206,1,7,8,46,46,49,141
355030890000207,1,51,31,147,147,137,431
355030890000208,1,29,37,78,78,55,211
355030890000209,1,77,48,168,168,179,515
355030890000210,1,38,20,108,108,111,327
355030890000211,1,63,68,182,182,129,493
355030890000212,1,52,27,152,152,121,425
355030890000213,1,13,19,104,104,66,274
355030890000214,1,40,44,134,134,148,416
355030890000215,1,78,41,177,177,135,489
355030890000216,1,38,33,113,113,78,304
355030890000217,1,45,29,116,116,93,325
355030890000218,1,41,31,125,125,86,336
355030890000219,1,36,37,89,89,106,284
355030890000220,1,105,33,190,190,116,496
355030890000221,1,33,11,101,101,90,292
355030890000222,1,158,85,272,272,278,822
355030890000223,1,55,38,114,114,156,384
355030890000224,1,69,33,128,128,126,382
355030890000225,1,1,0,2,2,1,5
355030890000226,1,90,57,137,137,165,439
355030890000227,1,149,75,210,210,220,640
355030890000228,1,85,75,119,119,190,428
355030890000229,1,9,7,17,17,10,44
355030890000230,1,21,49,61,61,48,170
355030890000231,1,0,0,0,0,0,0
355030891000001,1,204,103,267,267,203,737
355030891000002,1,133,71,215,215,159,589
355030891000003,1,112,61,197,197,175,569
355030891000004,1,66,47,104,104,89,297
355030891000005,1,130,86,200,200,193,593
355030891000006,1,88,42,105,105,107,317
355030891000007,1,106,72,166,166,164,496
355030891000008,1,100,49,150,150,131,431
355030891000009,1,68,34,103,103,94,300
355030891000010,1,92,34,149,149,126,424
355030891000011,1,103,61,109,109,68,286
355030891000012,1,154,87,200,200,155,555
355030891000013,1,83,71,147,147,115,409
355030891000014,1,100,53,147,147,123,417
355030891000015,1,163,88,234,234,220,688
355030891000016,1,102,61,151,151,121,423
355030891000017,1,114,56,148,148,125,421
355030891000018,1,101,56,125,125,156,406
355030891000019,1,125,52,141,141,139,421
355030891000020,1,187,103,210,210,199,619
355030891000021,1,225,135,245,245,204,694
355030891000022,1,134,73,148,148,144,440
355030891000023,1,67,52,127,127,132,386
355030891000024,1,73,42,95,95,94,284
355030891000025,1,146,83,198,198,141,537
355030891000026,1,199,97,290,290,171,751
355030891000027,1,189,113,351,351,213,915
355030891000028,1,88,61,139,139,109,387
355030891000029,1,127,54,158,158,109,425
355030891000030,1,77,52,107,107,90,304
355030891000031,1,78,32,115,115,108,338
355030891000032,1,122,70,148,148,178,474
355030891000033,1,133,57,164,164,136,464
355030891000034,1,127,84,175,175,166,516
355030891000035,1,178,97,196,196,158,550
355030891000036,1,128,59,172,172,135,479
355030891000037,1,84,51,206,206,149,561
355030891000038,1,59,46,132,132,80,344
355030891000039,1,120,80,176,176,174,526
355030891000040,1,119,57,210,210,162,582
355030891000041,1,86,53,107,107,85,299
355030891000042,1,231,116,238,238,205,681
355030891000043,1,133,73,173,173,146,492
355030891000044,1,180,100,207,207,147,561
355030891000045,1,90,47,113,113,114,340
355030891000046,1,90,46,88,88,79,255
355030891000047,1,124,79,187,187,197,571
355030891000048,1,109,48,156,156,144,456
355030891000049,1,116,63,134,134,124,392
355030891000050,1,227,129,237,237,204,678
355030891000051,1,138,80,190,190,176,556
355030891000052,1,163,89,199,199,140,538
355030891000053,1,147,92,205,205,194,604
355030891000054,1,95,47,132,132,122,386
355030891000055,1,126,48,160,160,140,460
355030891000056,1,72,34,108,108,85,301
355030891000057,1,57,36,98,98,138,334
355030891000058,1,155,89,289,289,224,802
355030891000059,1,127,60,194,194,150,538
355030891000060,1,48,17,63,63,53,179
355030891000061,1,129,79,200,200,179,579
355030891000062,1,164,87,222,222,192,636
355030891000063,1,109,80,189,189,217,595
355030891000064,1,129,49,173,173,151,497
355030891000065,1,79,49,151,151,132,434
355030891000066,1,122,62,180,180,142,502
355030891000067,1,225,96,272,272,210,754
355030891000068,1,100,63,166,166,146,478
355030891000069,1,142,77,149,149,106,404
355030891000070,1,158,82,200,200,163,563
355030891000071,1,112,50,132,132,96,360
355030891000072,1,151,68,192,192,171,555
355030891000073,1,104,48,130,130,103,363
355030891000074,1,105,81,153,153,174,480
355030891000075,1,116,82,183,183,166,532
355030891000076,1,136,63,186,186,182,554
355030891000077,1,48,29,86,86,95,267
355030891000078,1,113,50,181,181,162,524
355030891000079,1,80,59,120,120,112,352
355030891000080,1,110,68,128,128,119,375
355030891000081,1,175,58,175,175,140,490
355030891000082,1,83,47,118,118,120,356
355030891000083,1,140,68,218,218,165,601
355030891000084,1,130,69,200,200,170,570
355030891000085,1,72,59,120,120,128,368
355030891000086,1,100,53,158,158,153,469
355030891000087,1,116,59,172,172,120,464
355030891000088,1,79,50,122,122,97,341
355030891000089,1,63,34,124,124,100,348
355030891000090,1,78,63,110,110,132,352
355030891000091,1,150,80,234,234,169,637
355030891000092,1,144,78,179,179,181,539
355030891000093,1,76,35,79,79,84,242
355030891000094,1,178,95,226,226,149,601
355030891000095,1,108,66,147,147,154,448
355030891000096,1,129,53,152,152,129,433
355030891000097,1,53,45,91,91,118,300
355030891000098,1,78,47,135,135,120,390
355030891000099,1,89,42,129,129,127,385
355030891000100,1,90,40,132,132,101,365
355030891000101,1,120,53,164,164,143,471
355030891000102,1,86,54,146,146,116,408
355030891000103,1,147,78,205,205,221,631
355030891000104,1,106,57,144,144,182,470
355030891000105,1,79,48,128,128,121,377
355030891000106,1,74,42,105,105,115,325
355030891000107,1,122,90,204,204,181,589
355030891000108,1,201,89,232,232,173,637
355030891000109,1,121,68,117,117,106,340
355030891000110,1,114,67,146,146,150,442
355030891000111,1,169,95,266,266,213,745
355030891000112,1,99,44,132,132,118,382
355030891000113,1,110,77,163,163,151,477
355030891000114,1,79,33,88,88,86,262
355030891000115,1,195,109,242,242,217,701
355030891000116,1,78,28,100,100,84,284
355030891000117,1,161,68,172,172,131,475
355030891000118,1,152,79,183,183,140,506
355030891000119,1,92,54,151,151,112,414
355030891000120,1,114,53,169,169,132,470
355030891000121,1,59,35,112,112,79,303
355030891000122,1,96,63,152,152,153,457
355030891000123,1,67,40,96,96,85,277
355030891000124,1,87,50,170,170,129,469
355030891000125,1,183,104,205,205,181,591
355030891000126,1,190,98,352,352,255,959
355030891000127,1,157,54,228,228,159,615
355030891000128,1,53,29,87,87,78,252
355030891000129,1,84,39,126,126,81,333
355030891000130,1,112,64,210,210,180,600
355030891000131,1,46,25,83,83,55,221
355030891000132,1,213,66,410,410,106,926
355030891000133,1,168,82,214,214,162,590
355030891000134,1,162,88,236,236,150,622
355030891000135,1,120,21,266,266,54,586
355030891000136,1,93,43,129,129,107,365
355030891000137,1,82,53,104,104,101,309
355030891000138,1,55,35,83,83,113,279
355030891000139,1,55,36,87,87,68,242
355030891000140,1,104,44,121,121,80,322
355030891000141,1,65,31,61,61,66,188
355030891000142,1,66,37,108,108,91,307
355030891000143,1,56,16,78,78,70,226
355030891000144,1,34,13,82,82,19,183
355030891000145,1,50,13,82,82,20,184
355030891000146,1,84,35,185,185,51,421
355030891000147,1,161,47,75,75,29,179
355030892000001,1,80,49,115,115,89,319
355030892000002,1,111,58,155,155,94,404
355030892000003,1,89,47,94,94,102,290
355030892000004,1,75,59,141,141,134,416
355030892000005,1,102,48,116,116,93,325
355030892000006,1,108,55,130,130,94,354
355030892000007,1,151,63,176,176,96,448
355030892000008,1,178,86,184,184,130,498
355030892000009,1,98,70,101,101,83,285
355030892000010,1,152,68,179,179,112,470
355030892000011,1,77,52,106,106,90,302
355030892000012,1,144,68,172,172,149,493
355030892000013,1,124,64,175,175,149,499
355030892000014,1,131,85,199,199,167,565
355030892000015,1,117,74,150,150,133,433
355030892000016,1,142,74,158,158,144,460
355030892000017,1,63,34,81,81,66,228
355030892000018,1,104,52,137,137,89,363
355030892000019,1,153,77,159,159,146,464
355030892000020,1,135,60,143,143,117,403
355030892000021,1,122,62,166,166,112,444
355030892000022,1,73,56,112,112,131,355
355030892000023,1,113,51,143,143,113,399
355030892000024,1,63,40,92,92,83,267
355030892000025,1,109,62,130,130,126,386
355030892000026,1,119,63,165,165,156,486
355030892000027,1,67,42,95,95,104,294
355030892000028,1,74,54,115,115,123,353
355030892000029,1,136,62,137,137,151,425
355030892000030,1,160,91,252,252,177,681
355030892000031,1,105,55,149,149,139,437
355030892000032,1,90,45,124,124,89,337
355030892000033,1,72,36,109,109,92,310
355030892000034,1,61,50,80,80,99,259
355030892000035,1,103,77,132,132,156,420
355030892000036,1,47,17,44,44,56,144
355030892000037,1,96,50,105,105,72,282
355030892000038,1,122,50,123,123,78,324
355030892000039,1,99,51,114,114,86,314
355030892000040,1,82,44,133,133,87,353
355030892000041,1,119,47,139,139,76,354
355030892000042,1,145,70,168,168,121,457
355030892000043,1,119,64,145,145,79,369
355030892000044,1,96,61,139,139,115,393
355030892000045,1,153,60,212,212,186,610
355030892000046,1,97,54,143,143,162,448
355030892000047,1,145,79,209,209,224,642
355030892000048,1,233,80,175,175,55,405
355030892000049,1,162,83,152,152,106,410
355030892000050,1,85,42,118,118,115,351
355030892000051,1,34,20,35,35,48,118
355030892000052,1,87,55,126,126,118,370
355030892000053,1,98,71,131,131,110,372
355030892000054,1,100,50,118,118,110,346
355030892000055,1,83,43,100,100,110,310
355030892000056,1,85,47,130,130,115,375
355030892000057,1,91,49,125,125,102,352
355030892000058,1,136,91,196,196,181,573
355030892000059,1,106,62,122,122,123,367
355030892000060,1,116,71,143,143,159,445
355030892000061,1,144,58,177,177,144,498
355030892000062,1,69,37,133,133,117,383
355030892000063,1,111,77,151,151,136,438
355030892000064,1,149,84,198,198,182,578
355030892000065,1,86,43,97,97,77,271
355030892000066,1,98,56,142,142,147,431
355030892000067,1,124,69,179,179,97,455
355030892000068,1,73,47,97,97,98,292
355030892000069,1,96,57,105,105,83,293
355030892000070,1,98,49,123,123,90,336
355030892000071,1,129,82,178,178,155,511
355030892000072,1,90,29,95,95,75,265
355030892000073,1,91,32,105,105,49,259
355030892000074,1,158,98,155,155,125,435
355030892000075,1,163,87,177,177,128,482
355030892000076,1,152,78,173,173,128,474
355030892000077,1,148,62,144,144,100,388
355030892000078,1,150,46,121,121,96,338
355030892000079,1,115,63,135,135,127,397
355030892000080,1,40,23,71,71,40,182
355030892000081,1,0,0,0,0,0,0
355030892000082,1,224,79,182,182,124,488
355030892000083,1,113,64,133,133,114,380
355030892000084,1,72,47,92,92,87,271
355030892000085,1,125,62,184,184,166,534
355030892000086,1,110,41,143,143,109,395
355030892000087,1,79,45,151,151,134,436
355030892000088,1,63,51,105,105,101,311
355030892000089,1,118,49,161,161,168,490
355030892000090,1,107,62,144,144,174,462
355030892000091,1,99,60,171,171,156,498
355030892000092,1,103,71,138,138,148,424
355030892000093,1,93,41,122,122,86,330
355030892000094,1,129,74,152,152,146,450
355030892000095,1,131,86,151,151,117,419
355030892000096,1,114,60,116,116,107,339
355030892000097,1,100,49,179,179,141,499
355030892000098,1,163,91,207,207,188,602
355030892000099,1,126,55,159,159,149,467
355030892000100,1,99,47,118,118,99,335
355030892000101,1,83,49,117,117,118,352
355030892000102,1,146,80,197,197,184,578
355030892000103,1,99,52,141,141,79,361
355030892000104,1,205,81,193,193,135,521
355030892000105,1,147,64,161,161,109,431
355030892000106,1,76,38,98,98,91,287
355030892000107,1,144,83,187,187,143,517
355030892000108,1,121,64,144,144,144,432
355030892000109,1,97,72,149,149,143,441
355030892000110,1,64,28,103,103,80,286
355030892000111,1,133,64,169,169,106,444
355030892000112,1,138,66,141,141,105,387
355030892000113,1,142,55,142,142,99,383
355030892000114,1,216,113,266,266,159,691
355030892000115,1,61,22,69,69,47,185
355030892000116,1,64,34,58,58,32,148
355030892000117,1,134,87,135,135,104,374
355030892000118,1,177,63,182,182,103,467
355030892000119,1,103,30,119,119,92,330
355030892000120,1,216,101,147,147,95,389
355030892000121,1,60,30,87,87,94,268
355030892000122,1,58,35,82,82,67,231
355030892000123,1,72,37,118,118,90,326
355030892000124,1,50,19,62,62,62,186
355030892000125,1,71,48,91,91,108,290
355030892000126,1,81,34,106,106,110,322
355030892000127,1,86,50,126,126,121,373
355030892000128,1,85,60,113,113,127,353
355030892000129,1,64,37,102,102,117,321
355030892000130,1,55,35,104,104,97,305
355030892000131,1,55,26,100,100,44,244
355030892000132,1,122,68,167,167,148,482
355030892000133,1,54,32,71,71,82,224
355030892000134,1,117,80,165,165,183,513
355030892000135,1,67,32,102,102,66,270
355030892000136,1,100,40,149,149,96,394
355030892000137,1,155,71,270,270,189,729
355030892000138,1,115,62,154,154,168,476
355030892000139,1,50,37,79,79,69,227
355030892000140,1,84,46,105,105,73,283
355030892000141,1,163,92,169,169,164,502
355030892000142,1,98,73,117,117,94,328
355030892000143,1,81,59,123,123,125,371
355030892000144,1,176,80,230,230,162,622
355030892000145,1,83,59,120,120,133,373
355030892000146,1,69,33,119,119,146,384
355030892000147,1,69,40,105,105,83,293
355030892000148,1,150,93,197,197,194,588
355030892000149,1,76,46,113,113,77,303
355030892000150,1,105,54,119,119,125,363
355030892000151,1,131,76,186,186,132,504
355030892000152,1,76,36,68,68,52,188
355030892000153,1,181,109,285,285,182,752
355030892000154,1,44,26,86,86,64,236
355030892000155,1,86,38,105,105,103,313
355030892000156,1,106,60,149,149,120,418
355030892000157,1,130,62,171,171,130,472
355030892000158,1,77,50,101,101,88,290
355030892000159,1,76,29,103,103,70,276
355030892000160,1,115,76,178,178,157,513
355030892000161,1,89,40,106,106,109,321
355030892000162,1,128,74,183,183,164,530
355030892000163,1,114,43,136,136,102,374
355030892000164,1,84,65,107,107,111,325
355030892000165,1,108,43,119,119,107,345
355030892000166,1,105,68,122,122,97,341
355030892000167,1,70,36,123,123,106,352
355030892000168,1,76,39,109,109,95,313
355030892000169,1,109,71,142,142,131,415
355030892000170,1,135,72,149,149,103,401
355030892000171,1,62,48,113,113,98,324
355030892000172,1,71,43,84,84,82,250
355030892000173,1,66,44,95,95,104,294
355030892000174,1,103,52,114,114,103,331
355030892000175,1,39,32,62,62,52,176
355030892000176,1,54,18,87,87,71,245
355030892000177,1,65,43,89,89,96,274
355030892000178,1,117,58,151,151,121,423
355030892000179,1,121,66,129,129,82,340
355030892000180,1,59,27,96,96,74,266
355030892000181,1,70,29,89,89,58,236
355030892000182,1,36,17,66,66,49,181
355030892000183,1,98,69,117,117,119,353
355030892000184,1,68,26,86,86,72,244
355030892000185,1,63,39,98,98,70,266
355030892000186,1,47,25,61,61,59,181
355030892000187,1,61,28,104,104,63,271
355030892000188,1,0,0,0,0,0,0
355030892000189,1,84,40,110,110,84,304
355030892000190,1,95,32,98,98,89,285
355030892000191,1,90,51,116,116,67,299
355030892000192,1,26,12,29,29,36,94
355030892000193,1,70,26,84,84,54,222
355030892000194,1,96,44,121,121,104,346
355030892000195,1,117,71,148,148,137,433
355030892000196,1,91,41,103,103,98,304
355030892000197,1,95,60,111,111,107,329
355030892000198,1,90,47,116,116,115,347
355030892000199,1,63,37,95,95,88,278
355030892000200,1,45,22,66,66,70,202
355030892000201,1,93,51,127,127,116,370
355030892000202,1,79,33,102,102,89,293
355030892000203,1,67,65,114,114,100,328
355030892000204,1,45,41,99,99,79,277
355030892000205,1,80,47,100,100,111,311
355030892000206,1,65,29,88,88,80,256
355030892000207,1,76,43,81,81,57,219
355030892000208,1,77,38,91,91,85,267
355030892000209,1,77,39,83,83,89,255
355030892000210,1,82,34,101,101,75,277
355030892000211,1,49,21,60,60,71,191
355030892000212,1,115,50,154,154,105,413
355030892000213,1,37,27,56,56,46,158
355030892000214,1,135,75,139,139,117,395
355030892000215,1,68,34,38,38,29,105
355030892000216,1,182,76,165,165,116,446
355030892000217,1,55,37,65,65,29,159
355030892000218,1,63,32,51,51,30,132
355030892000219,1,20,9,23,23,14,60
355030892000220,1,150,81,129,129,63,321
355030892000221,1,259,130,207,207,117,531
355030893000001,1,68,46,106,106,118,330
355030893000002,1,104,63,126,126,162,414
355030893000003,1,94,48,148,148,136,432
355030893000004,1,91,67,163,163,153,479
355030893000005,1,90,53,138,138,123,399
355030893000006,1,138,63,207,207,183,597
355030893000007,1,66,58,133,133,147,413
355030893000008,1,86,65,141,141,145,427
355030893000009,1,133,71,227,227,227,681
355030893000010,1,113,68,164,164,132,460
355030893000011,1,77,48,142,142,140,424
355030893000012,1,73,59,127,127,148,402
355030893000013,1,114,59,263,263,167,693
355030893000014,1,130,61,184,184,202,570
355030893000015,1,104,64,177,177,187,541
355030893000016,1,83,64,118,118,166,402
355030893000017,1,63,57,109,109,134,352
355030893000018,1,70,40,107,107,140,354
355030893000019,1,141,67,261,261,148,670
355030893000020,1,112,87,175,175,177,527
355030893000021,1,100,41,183,183,129,495
355030893000022,1,144,102,213,213,207,633
355030893000023,1,84,63,111,111,127,349
355030893000024,1,122,79,209,209,146,564
355030893000025,1,82,63,165,165,186,516
355030893000026,1,44,33,103,103,139,345
355030893000027,1,49,40,94,94,132,320
355030893000028,1,79,38,131,131,123,385
355030893000029,1,95,49,137,137,147,421
355030893000030,1,108,66,202,202,191,595
355030893000031,1,68,48,115,115,125,355
355030893000032,1,124,58,180,180,141,501
355030893000033,1,160,79,301,301,181,783
355030893000034,1,107,40,125,125,127,377
355030893000035,1,70,31,120,120,117,357
355030893000036,1,113,52,173,173,178,524
355030893000037,1,42,38,79,79,92,250
355030893000038,1,63,28,96,96,89,281
355030893000039,1,93,61,186,186,113,485
355030893000040,1,123,48,169,169,123,461
355030893000041,1,121,63,228,228,163,619
355030893000042,1,89,46,113,113,93,319
355030893000043,1,81,47,151,151,152,454
355030893000044,1,104,59,170,170,141,481
355030893000045,1,85,52,128,128,123,379
355030893000046,1,115,61,185,185,148,518
355030893000047,1,135,68,201,201,119,521
355030893000048,1,98,57,132,132,136,400
355030893000049,1,65,25,155,155,63,373
355030893000050,1,108,56,150,150,129,429
355030893000051,1,140,62,197,197,166,560
355030893000052,1,116,86,166,166,103,435
355030893000053,1,112,61,199,199,217,615
355030893000054,1,117,67,186,186,210,582
355030893000055,1,172,101,193,193,145,531
355030893000056,1,57,41,109,109,99,317
355030893000057,1,44,26,100,100,75,275
355030893000058,1,138,74,283,283,196,762
355030893000059,1,85,59,147,147,171,465
355030893000060,1,304,177,240,240,140,620
355030893000061,1,95,50,129,129,133,391
355030893000062,1,89,36,137,137,119,393
355030893000063,1,99,48,140,140,111,391
355030893000064,1,46,14,69,69,50,188
355030893000065,1,100,64,156,156,150,462
355030893000066,1,66,50,119,119,136,374
355030893000067,1,99,51,174,174,144,492
355030893000068,1,63,55,93,93,94,280
355030893000069,1,109,70,161,161,117,439
355030893000070,1,123,58,240,240,130,610
355030893000071,1,102,49,181,181,176,538
355030893000072,1,106,58,154,154,182,490
355030893000073,1,124,59,152,152,135,439
355030893000074,1,101,62,169,169,104,442
355030893000075,1,103,87,176,176,207,559
355030893000076,1,113,43,162,162,109,433
355030893000077,1,87,52,132,132,139,403
355030893000078,1,55,47,114,114,128,356
355030893000079,1,102,55,143,143,121,407
355030893000080,1,133,77,192,192,123,507
355030893000081,1,42,19,53,53,53,159
355030893000082,1,76,39,135,135,138,408
355030893000083,1,56,39,129,129,84,342
355030893000084,1,294,143,236,236,118,590
355030893000085,1,271,142,223,223,142,588
355030893000086,1,119,65,97,97,48,242
355030893000087,1,208,119,188,188,79,455
355030893000088,1,88,40,75,75,35,185
355030893000089,1,119,50,131,131,130,392
355030893000090,1,50,25,79,79,107,265
355030893000091,1,107,30,243,243,113,599
355030893000092,1,80,44,133,133,122,388
355030893000093,1,62,36,107,107,105,319
355030893000094,1,96,50,135,135,126,396
355030893000095,1,86,42,114,114,142,370
355030893000096,1,100,40,161,161,137,459
355030893000097,1,62,51,108,108,152,368
355030893000098,1,67,48,121,121,108,350
355030893000099,1,110,60,155,155,127,437
355030893000100,1,160,77,219,219,194,632
355030893000101,1,76,43,107,107,113,327
355030893000102,1,98,54,117,117,100,334
355030893000103,1,123,63,170,170,188,528
355030893000104,1,76,39,95,95,109,299
355030893000105,1,94,62,136,136,123,395
355030893000106,1,104,47,145,145,111,401
355030893000107,1,57,35,90,90,74,254
355030893000108,1,48,30,77,77,84,238
355030893000109,1,57,37,107,107,148,362
355030893000110,1,15,23,47,47,75,169
355030893000111,1,55,54,100,100,158,358
355030893000112,1,39,16,86,86,72,244
355030893000113,1,60,36,97,97,142,336
355030893000114,1,115,56,147,147,117,411
355030893000115,1,104,66,194,194,141,529
355030893000116,1,110,63,149,149,131,429
355030893000117,1,65,50,87,87,88,262
355030893000118,1,92,48,125,125,87,337
355030893000119,1,52,28,103,103,60,266
355030893000120,1,98,55,173,173,138,484
355030893000121,1,78,57,135,135,223,493
355030893000122,1,87,48,120,120,204,444
355030893000123,1,98,51,139,139,133,411
355030893000124,1,241,134,307,307,303,917
355030893000125,1,103,54,164,164,120,448
355030893000126,1,101,47,155,155,150,460
355030893000127,1,72,45,134,134,122,390
355030893000128,1,63,46,142,142,121,405
355030893000129,1,77,66,143,143,140,426
355030893000130,1,81,66,138,138,93,369
355030893000131,1,102,49,131,131,153,415
355030893000132,1,72,47,115,115,150,380
355030893000133,1,55,37,100,100,129,329
355030893000134,1,56,42,104,104,117,325
355030893000135,1,151,59,174,174,116,464
355030893000136,1,101,60,155,155,160,470
355030893000137,1,122,48,139,139,128,406
355030893000138,1,94,40,180,180,149,509
355030893000139,1,170,77,203,203,151,557
355030893000140,1,149,82,202,202,163,567
355030893000141,1,210,70,337,337,181,855
355030893000142,1,44,15,183,183,39,405
355030893000143,1,79,51,109,109,165,383
355030893000144,1,13,17,33,33,62,128
355030893000145,1,57,15,94,94,25,213
355030893000146,1,62,17,78,78,36,192
355030893000147,1,47,19,79,79,77,235
355030893000148,1,43,10,144,144,44,332
355030893000149,1,124,50,236,236,104,576
355030893000150,1,53,9,154,154,29,337
355030893000151,1,100,34,156,156,56,368
355030893000152,1,53,19,144,144,40,328
355030893000153,1,13,5,42,42,10,94
355030893000154,1,48,20,147,147,56,350
355030893000155,1,32,5,73,73,17,163
355030893000157,1,97,37,197,197,169,563
355030893000158,1,0,133,135,135,23,293
355030893000159,1,93,38,124,124,124,372
355030893000160,1,40,26,74,74,82,230
355030893000161,1,50,23,108,108,94,310
355030893000162,1,74,52,62,62,32,156
355030894000001,1,29,22,44,44,51,139
355030894000002,1,27,15,43,43,33,119
355030894000003,1,43,27,65,65,59,189
355030894000004,1,46,25,75,75,54,204
355030894000005,1,38,12,61,61,50,172
355030894000006,1,45,14,73,73,61,207
355030894000007,1,85,37,130,130,98,358
355030894000008,1,42,34,76,76,68,220
355030894000009,1,53,27,69,69,82,220
355030894000010,1,63,35,112,112,89,313
355030894000011,1,51,28,122,122,88,332
355030894000012,1,31,37,66,66,80,212
355030894000013,1,49,46,100,100,86,286
355030894000014,1,22,17,61,61,48,170
355030894000015,1,60,30,108,108,59,275
355030894000016,1,94,33,114,114,66,294
355030894000017,1,53,33,107,107,65,279
355030894000018,1,78,40,120,120,104,344
355030894000019,1,39,25,67,67,83,217
355030894000020,1,75,40,119,119,111,349
355030894000021,1,33,32,71,71,82,224
355030894000022,1,51,25,89,89,98,276
355030894000023,1,57,44,94,94,102,290
355030894000024,1,69,28,66,66,65,197
355030894000025,1,59,35,88,88,70,246
355030894000026,1,50,24,80,80,67,227
355030894000027,1,64,35,89,89,80,258
355030894000028,1,76,53,140,140,127,407
355030894000029,1,72,24,82,82,90,254
355030894000030,1,52,39,89,89,88,266
355030894000031,1,28,18,60,60,70,190
355030894000032,1,17,8,23,23,22,68
355030894000033,1,81,44,110,110,104,324
355030894000034,1,87,41,121,121,112,354
355030894000035,1,56,44,110,110,73,293
355030894000036,1,142,68,171,171,92,434
355030894000037,1,104,52,128,128,112,368
355030894000038,1,54,23,61,61,68,190
355030894000039,1,45,23,68,68,70,206
355030894000040,1,14,11,34,34,26,94
355030894000041,1,36,28,72,72,88,232
355030894000042,1,79,56,128,128,114,370
355030894000043,1,15,8,49,49,46,144
355030894000044,1,33,26,47,47,58,152
355030894000045,1,64,38,100,100,110,310
355030894000046,1,81,40,126,126,114,366
355030894000047,1,56,29,78,78,113,269
355030894000048,1,68,59,85,85,64,234
355030894000049,1,167,90,161,161,77,399
355030894000050,1,119,59,120,120,43,283
355030894000051,1,217,110,197,197,61,455
355030894000052,1,243,124,185,185,70,440
355030894000053,1,256,127,198,198,86,482
355030894000054,1,60,33,118,118,129,365
355030894000056,1,115,36,157,157,121,435
355030894000057,1,101,34,152,152,105,409
355030894000058,1,97,48,123,123,80,326
355030894000059,1,80,29,118,118,80,316
355030894000060,1,95,41,119,119,110,348
355030894000061,1,46,20,83,83,65,231
355030894000062,1,35,21,81,81,64,226
355030894000063,1,68,35,96,96,87,279
355030894000064,1,27,5,33,33,30,96
355030894000065,1,65,31,112,112,97,321
355030894000066,1,16,9,31,31,36,98
355030894000067,1,91,38,107,107,115,329
355030894000068,1,56,28,82,82,90,254
355030894000069,1,75,43,107,107,120,334
355030894000070,1,96,53,107,107,122,336
355030894000071,1,143,72,133,133,68,334
355030894000072,1,69,45,64,64,65,193
355030894000073,1,120,67,104,104,38,246
355030894000074,1,124,64,160,160,98,418
355030894000075,1,15,19,32,32,68,132
355030894000076,1,24,15,67,67,56,190
355030894000077,1,28,16,62,62,67,191
355030894000078,1,21,12,60,60,71,191
355030894000079,1,37,23,56,56,87,199
355030894000080,1,45,25,79,79,73,231
355030894000081,1,44,22,83,83,94,260
355030894000082,1,28,14,69,69,44,182
355030894000083,1,39,21,70,70,58,198
355030894000084,1,35,16,57,57,58,172
355030894000085,1,98,38,147,147,124,418
355030894000086,1,28,13,48,48,57,153
355030894000087,1,65,28,87,87,89,263
355030894000088,1,131,56,142,142,159,443
355030894000089,1,109,45,130,130,110,370
355030894000090,1,97,54,173,173,126,472
355030894000091,1,50,35,112,112,107,331
355030894000092,1,24,15,50,50,66,166
355030894000093,1,8,12,16,16,16,48
355030894000094,1,30,17,51,51,59,161
355030894000095,1,52,28,84,84,71,239
355030894000096,1,52,34,77,77,144,298
355030894000097,1,39,24,67,67,88,222
355030894000098,1,59,47,99,99,123,321
355030894000099,1,39,20,56,56,68,180
355030894000100,1,69,35,138,138,107,383
355030894000101,1,161,60,137,137,54,328
355030894000102,1,329,393,252,252,45,549
355030894000103,1,21,12,24,24,5,53
355030894000104,1,174,128,204,204,52,460
355030894000105,1,23,10,31,31,29,91
355030894000106,1,46,18,69,69,45,183
355030894000107,1,33,13,47,47,34,128
355030894000110,1,57,30,110,110,69,289
355030894000111,1,63,40,134,134,73,341
355030894000112,1,64,33,140,140,91,371
355030894000113,1,45,30,76,76,73,225
355030894000114,1,35,16,67,67,55,189
355030894000115,1,44,28,66,66,100,232
355030894000116,1,36,21,57,57,61,175
355030894000117,1,84,47,121,121,100,342
355030894000118,1,64,33,93,93,84,270
355030894000119,1,66,39,105,105,91,301
355030894000120,1,43,24,107,107,79,293
355030894000121,1,42,22,107,107,59,273
355030894000122,1,33,8,83,83,36,202
355030894000123,1,66,40,102,102,74,278
355030894000125,1,58,39,74,74,86,234
355030894000126,1,115,80,166,166,133,465
355030894000127,1,22,12,69,69,39,177
355030894000128,1,53,35,83,83,93,259
355030894000129,1,62,30,76,76,87,239
355030894000130,1,60,32,95,95,87,277
355030894000131,1,78,35,102,102,71,275
355030894000132,1,106,43,130,130,121,381
355030894000133,1,64,35,85,85,80,250
355030894000134,1,58,28,80,80,58,218
355030894000135,1,44,17,108,108,47,263
355030894000136,1,80,48,126,126,106,358
355030894000137,1,50,13,76,76,56,208
355030894000138,1,46,20,68,68,53,189
355030894000139,1,35,22,74,74,49,197
355030894000140,1,44,19,88,88,61,237
355030894000141,1,59,39,107,107,93,307
355030894000142,1,55,23,98,98,86,282
355030894000143,1,31,33,102,102,69,273
355030894000144,1,36,12,31,31,22,84
355030894000145,1,25,23,64,64,51,179
355030894000147,1,70,24,191,191,35,417
355030894000148,1,78,18,191,191,38,420
355030894000149,1,85,41,127,127,119,373
355030894000152,1,66,44,125,125,79,329
355030894000153,1,0,0,0,0,0,0
355030894000155,1,11,3,33,33,13,79
355030894000156,1,323,139,308,308,230,846
355030894000157,1,113,39,176,176,77,429
355030894000158,1,21,4,77,77,8,162
355030894000160,1,131,78,136,136,79,351
355030894000161,1,173,81,257,257,185,699
355030894000162,1,50,16,72,72,78,222
355030894000163,1,54,42,86,86,83,255
355030894000164,1,34,37,73,73,69,215
355030894000165,1,44,24,55,55,51,161
355030894000166,1,37,30,77,77,73,227
355030894000167,1,59,47,124,124,140,388
355030894000168,1,78,43,104,104,116,324
355030894000169,1,33,17,89,89,61,239
355030894000170,1,21,17,58,58,57,173
355030894000171,1,24,26,60,60,62,182
355030894000172,1,68,33,132,132,85,349
355030894000173,1,50,23,50,50,11,111
355030894000174,1,140,62,119,119,53,291
355030894000175,1,97,57,96,96,58,250
355030894000176,1,130,58,121,121,56,298
355030894000177,1,115,53,96,96,49,241
355030894000178,1,75,44,77,77,17,171
355030894000179,1,164,76,187,187,65,439
355030894000180,1,80,31,84,84,17,185
355030894000181,1,40,30,99,99,71,269
355030894000182,1,52,51,101,101,79,281
355030894000183,1,4,16,4,4,17,25
355030894000184,1,80,40,129,129,111,369
355030894000185,1,106,37,188,188,105,481
355030894000186,1,57,23,142,142,45,329
355030894000187,1,30,12,108,108,29,245
355030894000188,1,234,111,215,215,81,511
355030894000189,1,41,22,84,84,62,230
355030894000190,1,75,32,160,160,106,426
355030894000191,1,42,16,82,82,39,203
355030894000192,1,165,86,282,282,195,759
355030894000193,1,55,20,161,161,65,387
355030894000194,1,60,27,162,162,79,403
355030894000195,1,72,41,118,118,84,320
355030894000196,1,34,25,70,70,59,199
355030894000197,1,48,42,91,91,68,250
355030894000198,1,34,32,82,82,82,246
355030894000199,1,61,32,81,81,65,227
355030894000200,1,465,452,451,451,96,998
355030894000201,1,97,61,134,134,119,387
355030894000202,1,35,24,61,61,80,202
355030894000203,1,87,52,134,134,88,356
355030894000204,1,64,18,109,109,32,250
355030894000205,1,131,42,88,88,22,198
355030894000206,1,66,21,82,82,73,237
355030894000207,1,102,52,117,117,46,280
355030894000208,1,106,63,136,136,94,366
355030894000209,1,214,85,180,180,38,398
355030894000210,1,99,41,102,102,17,221
355030894000211,1,145,74,140,140,78,358
355030894000212,1,236,94,205,205,64,474
355030894000213,1,209,106,194,194,78,466
355030894000215,1,55,39,93,93,137,323
355030894000216,1,29,11,81,81,54,216
355030894000217,1,29,27,71,71,76,218
355030894000218,1,38,11,82,82,50,214
355030894000219,1,28,18,88,88,51,227
355030894000220,1,64,33,103,103,143,349
355030894000221,1,34,11,138,138,24,300
355030894000222,1,19,6,66,66,18,150
355030894000223,1,39,10,132,132,17,281
355030894000224,1,46,14,121,121,36,278
355030894000225,1,53,24,89,89,65,243
355030894000226,1,53,24,76,76,56,208
355030894000227,1,20,8,103,103,16,222
355030894000228,1,58,10,191,191,35,417
355030894000229,1,60,9,130,130,39,299
355030894000230,1,17,7,110,110,16,236
355030894000232,1,31,30,90,90,110,290
355030894000233,1,69,19,150,150,72,372
355030894000234,1,23,14,55,55,24,134
355030894000235,1,27,29,63,63,78,204
355030894000236,1,60,19,96,96,75,267
355030894000237,1,23,18,57,57,66,180
355030894000238,1,26,23,35,35,56,126
355030894000239,1,51,19,112,112,46,270
355030894000240,1,50,15,92,92,50,234
355030894000241,1,45,23,78,78,63,219
355030894000242,1,45,21,72,72,94,238
355030894000243,1,70,35,69,69,95,233
355030894000244,1,116,38,156,156,113,425
355030894000245,1,51,19,109,109,42,260
355030894000246,1,37,7,49,49,27,125
355030894000247,1,72,47,130,130,113,373
355030894000248,1,45,28,85,85,81,251
355030894000249,1,201,84,199,199,80,478
355030894000250,1,86,36,118,118,104,340
355030894000251,1,48,33,106,106,83,295
355030894000252,1,36,23,70,70,96,236
355030894000253,1,41,35,77,77,101,255
355030894000254,1,50,37,76,76,108,260
355030894000255,1,95,36,104,104,85,293
355030894000256,1,202,73,163,163,70,396
355030894000257,1,117,52,98,98,39,235
355030894000258,1,172,79,117,117,49,283
355030894000259,1,95,27,58,58,11,127
355030894000260,1,127,67,164,164,49,377
355030894000261,1,46,31,85,85,118,288
355030894000262,1,95,37,110,110,107,327
355030894000263,1,23,13,22,22,29,73
355030894000264,1,25,12,35,35,24,94
355030894000266,1,58,12,81,81,57,219
355030894000267,1,8,1,9,9,4,22
355030894000268,1,0,0,0,0,0,0
355030894000269,1,80,38,62,62,25,149
355030894000270,1,86,31,73,73,27,173
355030895000001,1,145,63,186,186,170,542
355030895000002,1,62,33,120,120,84,324
355030895000003,1,161,76,236,236,182,654
355030895000004,1,120,67,257,257,161,675
355030895000005,1,121,87,189,189,153,531
355030895000006,1,39,23,64,64,34,162
355030895000007,1,84,48,118,118,145,381
355030895000008,1,95,43,156,156,122,434
355030895000009,1,30,15,58,58,43,159
355030895000010,1,137,60,229,229,156,614
355030895000011,1,108,66,146,146,157,449
355030895000013,1,133,56,130,130,83,343
355030895000014,1,57,22,73,73,67,213
355030895000015,1,158,89,214,214,225,653
355030895000016,1,324,130,623,623,318,1564
355030895000017,1,133,71,183,183,131,497
355030895000018,1,65,35,93,93,84,270
355030895000019,1,119,75,197,197,142,536
355030895000020,1,33,18,35,35,52,122
355030895000021,1,91,56,142,142,163,447
355030895000022,1,70,38,123,123,126,372
355030895000023,1,107,55,150,150,139,439
355030895000024,1,133,73,189,189,180,558
355030895000025,1,78,66,123,123,105,351
355030895000026,1,155,58,165,165,71,401
355030895000027,1,90,32,142,142,68,352
355030895000028,1,71,35,143,143,147,433
355030895000029,1,139,64,198,198,174,570
355030895000030,1,95,75,173,173,159,505
355030895000031,1,49,20,84,84,64,232
355030895000032,1,86,62,173,173,167,513
355030895000033,1,156,88,218,218,187,623
355030895000034,1,124,52,192,192,155,539
355030895000035,1,299,113,513,513,259,1285
355030895000036,1,146,76,224,224,141,589
355030895000037,1,84,56,135,135,171,441
355030895000038,1,117,82,207,207,205,619
355030895000039,1,109,40,166,166,169,501
355030895000040,1,82,45,103,103,91,297
355030895000041,1,124,56,177,177,133,487
355030895000042,1,92,47,109,109,114,332
355030895000043,1,66,50,123,123,124,370
355030895000044,1,149,83,192,192,176,560
355030895000045,1,252,105,278,278,221,777
355030895000046,1,85,43,96,96,77,269
355030895000047,1,72,56,89,89,58,236
355030895000048,1,168,85,234,234,199,667
355030895000049,1,46,20,71,71,63,205
355030895000050,1,186,90,145,145,98,388
355030895000051,1,220,134,314,314,265,893
355030895000052,1,100,65,140,140,129,409
355030895000053,1,139,71,207,207,179,593
355030895000054,1,90,64,156,156,188,500
355030895000055,1,135,70,235,235,190,660
355030895000056,1,89,50,135,135,122,392
355030895000057,1,148,85,180,180,134,494
355030895000058,1,104,78,150,150,125,425
355030895000059,1,122,76,117,117,86,320
355030895000060,1,57,38,77,77,64,218
355030895000061,1,55,48,78,78,69,225
355030895000062,1,327,167,369,369,261,999
355030895000063,1,166,89,197,197,117,511
355030895000064,1,106,54,118,118,88,324
355030895000065,1,136,67,216,216,162,594
355030895000066,1,133,61,259,259,190,708
355030895000067,1,128,73,177,177,148,502
355030895000068,1,43,11,35,35,11,81
355030895000069,1,242,114,221,221,98,540
355030895000070,1,508,182,361,361,186,908
355030895000071,1,155,75,144,144,112,400
355030895000072,1,158,91,169,169,92,430
355030895000073,1,147,88,227,227,242,696
355030895000074,1,69,36,158,158,99,415
355030895000075,1,117,61,160,160,147,467
355030895000076,1,235,113,358,358,436,1152
355030895000077,1,242,109,254,254,163,671
355030895000078,1,55,35,100,100,119,319
355030895000079,1,48,42,122,122,130,374
355030895000080,1,106,66,128,128,102,358
355030895000081,1,365,176,313,313,109,735
355030895000082,1,65,40,108,108,73,289
355030895000083,1,55,25,62,62,60,184
355030895000084,1,383,169,326,326,102,754
355030895000085,1,66,46,107,107,115,329
355030895000086,2,38,26,65,65,26,156
355030895000087,2,0,0,0,0,0,0
355030895000088,1,59,32,89,89,108,286
355030895000089,1,48,20,73,73,77,223
355030895000090,1,69,46,75,75,73,223
355030895000092,1,20,24,34,34,48,116
355030895000093,1,18,6,23,23,24,70
355030895000094,1,82,38,113,113,92,318
355030895000095,1,127,56,217,217,131,565
355030895000096,1,44,16,61,61,55,177
355030895000097,1,31,16,52,52,48,152
355030895000098,1,63,38,109,109,96,314
355030895000099,1,82,47,122,122,111,355
355030895000100,1,199,94,186,186,136,508
355030895000101,1,46,22,32,32,25,89
355030895000102,1,70,49,164,164,117,445
355030895000103,1,139,38,153,153,74,380
355030895000104,1,45,24,65,65,44,174
355030895000105,1,88,49,112,112,100,324
355030895000106,1,225,91,211,211,127,549
355030895000107,1,38,18,56,56,23,135
355030895000108,1,200,81,197,197,127,521
355030895000109,1,181,63,129,129,58,316
355030895000110,2,0,0,0,0,0,0
355030895000111,1,132,84,174,174,121,469
355030895000112,1,149,50,291,291,161,743
355030895000113,1,189,88,198,198,154,550
355030895000114,1,129,73,197,197,138,532
355030895000115,1,396,178,487,487,231,1205
355030895000116,1,605,303,745,745,405,1895
355030895000117,1,26,16,53,53,49,155
355030895000118,1,63,17,97,97,42,236
355030895000119,1,42,33,108,108,102,318
355030895000120,1,68,51,98,98,116,312
355030895000121,1,66,23,37,37,22,96
355030895000122,1,101,43,104,104,71,279
355030895000123,1,8,4,11,11,7,29
355030895000124,1,97,37,108,108,64,280
355030895000125,1,136,71,128,128,43,299
355030896000001,1,159,65,154,154,99,407
355030896000002,1,150,81,133,133,107,373
355030896000003,1,145,78,175,175,155,505
355030896000004,1,60,31,77,77,51,205
355030896000005,1,151,83,182,182,149,513
355030896000006,1,91,57,108,108,89,305
355030896000007,1,103,56,112,112,67,291
355030896000008,1,187,89,173,173,145,491
355030896000009,1,231,84,211,211,104,526
355030896000010,1,232,89,270,270,136,676
355030896000011,1,142,83,193,193,116,502
355030896000012,1,128,65,122,122,120,364
355030896000013,1,131,79,132,132,88,352
355030896000014,1,153,103,170,170,144,484
355030896000015,1,43,29,54,54,59,167
355030896000016,1,130,53,145,145,117,407
355030896000017,1,106,63,125,125,107,357
355030896000018,1,137,58,109,109,103,321
355030896000019,1,123,66,119,119,123,361
355030896000020,1,147,85,160,160,93,413
355030896000021,1,258,119,218,218,123,559
355030896000022,1,222,132,245,245,159,649
355030896000023,1,60,36,60,60,30,150
355030896000024,1,134,69,158,158,81,397
355030896000025,1,181,123,154,154,155,463
355030896000026,1,198,87,193,193,114,500
355030896000027,1,217,126,215,215,168,598
355030896000028,1,150,76,171,171,87,429
355030896000029,1,130,63,133,133,106,372
355030896000030,1,146,77,119,119,56,294
355030896000031,1,151,75,139,139,90,368
355030896000032,1,201,77,190,190,107,487
355030896000033,1,159,65,209,209,105,523
355030896000034,1,98,51,95,95,75,265
355030896000035,1,137,65,150,150,100,400
355030896000036,1,230,95,195,195,88,478
355030896000037,1,141,71,152,152,122,426
355030896000038,1,249,134,231,231,134,596
355030896000039,1,198,74,167,167,89,423
355030896000040,1,134,66,143,143,93,379
355030896000041,1,111,72,124,124,94,342
355030896000042,1,247,129,215,215,112,542
355030896000043,1,134,56,140,140,92,372
355030896000044,1,118,65,127,127,69,323
355030896000045,1,121,89,143,143,119,405
355030896000046,1,236,97,225,225,168,618
355030896000047,1,273,134,263,263,112,638
355030896000048,1,172,80,194,194,98,486
355030896000049,1,152,65,142,142,87,371
355030896000050,1,105,58,139,139,93,371
355030896000051,1,132,76,151,151,118,420
355030896000052,1,139,75,146,146,121,413
355030896000053,1,255,135,222,222,123,567
355030896000054,1,269,115,244,244,133,621
355030896000055,1,154,91,125,125,106,356
355030896000056,1,101,47,120,120,98,338
355030896000057,1,102,59,88,88,74,250
355030896000058,1,201,98,153,153,141,447
355030896000059,1,140,72,144,144,102,390
355030896000060,1,198,107,174,174,81,429
355030896000061,1,410,154,364,364,129,857
355030896000062,1,37,18,35,35,10,80
355030896000063,1,333,155,302,302,163,767
355030896000064,1,256,128,258,258,139,655
355030896000065,1,185,84,162,162,107,431
355030896000066,1,83,45,85,85,100,270
355030896000067,1,143,77,164,164,106,434
355030896000068,1,35,25,46,46,19,111
355030896000069,1,93,40,101,101,55,257
355030896000070,1,81,35,110,110,62,282
355030896000071,1,128,70,124,124,73,321
355030896000072,1,126,64,135,135,75,345
355030896000073,1,200,86,188,188,112,488
355030896000074,1,143,84,189,189,95,473
355030896000075,1,205,118,178,178,105,461
355030896000076,1,220,99,189,189,154,532
355030896000077,1,223,96,177,177,138,492
355030896000078,1,150,77,138,138,128,404
355030896000079,1,253,120,263,263,113,639
355030896000080,1,151,65,143,143,94,380
355030896000081,1,93,49,93,93,93,279
355030896000082,1,150,84,134,134,86,354
355030896000083,1,260,137,208,208,133,549
355030896000084,1,117,55,111,111,58,280
355030896000085,1,265,134,231,231,153,615
355030896000086,1,270,132,240,240,152,632
355030896000087,1,170,88,147,147,85,379
355030896000088,1,230,114,233,233,117,583
355030896000089,1,134,71,141,141,113,395
355030896000090,1,15,11,28,28,21,77
355030896000091,1,114,51,73,73,81,227
355030896000092,1,90,34,57,57,39,153
355030896000093,1,149,71,144,144,77,365
355030896000094,1,226,89,209,209,101,519
355030896000095,1,236,116,255,255,169,679
355030896000096,1,129,73,95,95,66,256
355030896000097,1,172,81,160,160,86,406
355030896000098,1,184,85,140,140,107,387
355030896000099,1,165,80,193,193,104,490
355030896000100,1,92,40,104,104,76,284
355030896000101,1,87,38,85,85,69,239
355030896000102,1,39,21,44,44,24,112
355030896000103,1,209,103,199,199,122,520
355030896000104,1,224,94,218,218,114,550
355030896000105,1,193,81,144,144,120,408
355030896000106,1,122,71,101,101,82,284
355030896000107,1,124,51,128,128,77,333
355030896000108,1,237,113,189,189,133,511
355030896000109,1,179,108,143,143,126,412
355030896000110,1,173,65,155,155,114,424
355030896000111,1,147,77,171,171,98,440
355030896000112,1,241,111,224,224,133,581
355030896000113,1,118,66,99,99,78,276
355030896000114,1,167,92,151,151,130,432
355030896000115,1,207,109,172,172,132,476
355030896000116,1,191,100,171,171,139,481
355030896000117,1,301,139,274,274,140,688
355030896000118,1,264,140,267,267,130,664
355030896000119,1,176,72,166,166,83,415
355030896000120,1,234,114,253,253,133,639
355030896000121,1,335,45,199,199,38,436
355030896000122,1,220,101,174,174,90,438
355030896000123,1,207,81,186,186,95,467
355030896000124,1,233,104,191,191,90,472
355030896000125,1,341,136,208,208,102,518
355030896000126,1,191,86,156,156,70,382
355030896000127,1,215,84,152,152,55,359
355030896000128,1,317,123,241,241,118,600
355030896000129,1,115,46,148,148,84,380
355030896000130,1,110,64,127,127,87,341
355030896000131,1,133,53,125,125,66,316
355030896000132,1,195,95,182,182,110,474
355030896000133,1,168,83,157,157,126,440
355030896000134,1,331,152,337,337,119,793
355030896000135,1,198,69,166,166,77,409
355030896000136,1,175,64,145,145,79,369
355030896000137,1,167,99,169,169,109,447
355030896000138,1,197,145,174,174,135,483
355030896000139,1,166,89,146,146,76,368
355030896000140,1,100,66,104,104,78,286
355030896000141,1,170,108,163,163,133,459
355030896000142,1,135,51,138,138,75,351
355030896000143,1,144,87,166,166,117,449
355030896000144,1,130,81,144,144,104,392
355030896000145,1,214,104,193,193,117,503
355030896000146,1,103,47,98,98,71,267
355030896000147,1,90,44,116,116,83,315
355030896000148,1,29,18,23,23,22,68
355030896000149,1,173,85,172,172,126,470
355030896000150,1,110,54,117,117,86,320
355030896000151,1,154,87,179,179,91,449
355030896000152,1,186,61,213,213,81,507
355030896000153,1,134,59,150,150,74,374
355030896000154,1,178,83,209,209,107,525
355030896000155,1,106,59,151,151,93,395
355030896000156,1,164,67,155,155,108,418
355030896000157,1,272,130,218,218,138,574
355030896000158,1,144,58,142,142,67,351
355030896000159,1,171,63,158,158,75,391
355030896000160,1,98,47,90,90,109,289
355030896000161,1,179,86,206,206,118,530
355030896000162,1,134,73,147,147,105,399
355030896000163,1,244,97,252,252,172,676
355030896000164,1,233,112,185,185,158,528
355030896000165,1,197,73,174,174,97,445
355030896000166,1,295,143,295,295,141,731
355030896000167,1,446,164,402,402,160,964
355030896000168,1,162,107,149,149,77,375
355030896000169,1,122,76,95,95,74,264
355030896000170,1,348,139,248,248,111,607
355030896000171,1,106,46,101,101,56,258
355030896000172,1,276,140,258,258,99,615
355030896000173,1,45,22,34,34,30,98
355030896000174,1,144,70,123,123,81,327
355030896000175,1,153,75,149,149,107,405
355030896000176,1,158,108,171,171,95,437
355030896000177,1,150,88,148,148,133,429
355030896000178,1,190,91,185,185,103,473
355030896000179,1,218,99,214,214,199,627
355030896000180,1,22,21,21,21,22,64
355030896000181,1,120,62,135,135,115,385
355030896000182,1,124,52,110,110,113,333
355030896000183,1,202,74,182,182,87,451
355030896000184,1,208,102,206,206,99,511
355030896000185,1,188,109,178,178,107,463
355030896000186,1,81,34,79,79,83,241
355030896000187,1,356,177,288,288,201,777
355030896000188,1,77,43,67,67,33,167
355030896000189,1,260,109,251,251,105,607
355030896000190,1,226,104,266,266,102,634
355030896000191,1,128,77,144,144,100,388
355030896000192,1,159,73,151,151,78,380
355030896000193,1,65,61,82,82,56,220
355030896000194,1,160,91,137,137,99,373
355030896000195,1,74,54,79,79,63,221
355030896000196,1,137,70,126,126,95,347
355030896000197,1,54,15,36,36,17,89
355030896000198,1,82,22,62,62,23,147
355030896000199,1,93,37,75,75,56,206
355030896000200,1,115,46,105,105,97,307
355030896000201,1,202,57,222,222,60,504
355030896000202,1,163,73,256,256,69,581
355030896000203,1,120,52,111,111,67,289
355030896000204,1,123,72,124,124,92,340
355030896000205,1,54,18,59,59,49,167
355030896000206,1,106,65,98,98,80,276
355030896000207,1,147,76,153,153,98,404
355030896000208,1,103,62,149,149,117,415
355030896000209,1,108,50,104,104,60,268
355030896000210,1,101,45,114,114,65,293
355030896000211,1,112,62,111,111,68,290
355030896000212,1,136,55,139,139,60,338
355030896000213,1,106,61,123,123,75,321
355030896000214,1,320,135,288,288,128,704
355030896000215,1,79,44,87,87,79,253
355030896000216,1,145,66,108,108,73,289
355030896000217,1,107,53,86,86,80,252
355030896000218,1,106,35,94,94,45,233
355030896000219,1,139,74,133,133,95,361
355030896000220,1,173,89,147,147,79,373
355030896000221,1,140,53,134,134,94,362
355030896000222,1,111,57,119,119,112,350
355030896000223,1,191,87,191,191,78,460
355030896000224,1,123,57,148,148,84,380
355030896000225,1,280,131,247,247,103,597
355030896000226,1,122,38,177,177,77,431
355030896000227,1,91,50,112,112,43,267
355030896000228,1,160,70,146,146,51,343
355030896000229,1,130,49,140,140,65,345
355030896000230,1,121,42,115,115,63,293
355030896000231,1,28,32,44,44,33,121
355030896000233,1,52,28,54,54,35,143
355030896000234,1,40,14,33,33,17,83
355030896000235,1,48,21,34,34,26,94
355030896000236,1,416,174,377,377,149,903
355030896000237,1,126,63,119,119,44,282
355030896000238,1,98,45,111,111,46,268
355030896000239,1,91,52,69,69,43,181
355030896000240,1,73,33,56,56,43,155
355030896000241,1,46,25,50,50,30,130
355030896000242,1,51,21,39,39,23,101
355030896000243,1,78,45,75,75,44,194
355030896000244,1,52,22,44,44,28,116
355030896000245,1,108,36,91,91,39,221
355030896000246,1,47,15,37,37,29,103
355030896000247,1,120,65,103,103,68,274
